year,Month Week,region,AveragePrice,4046,4225,4770,Small Bags,Large Bags,XLarge Bags,Season,Total Small Avocados,Total Large Avocados,Total XLarge Avocados,type_organic
2015,12/27,Albany,1.33,1036,54454,48,8603,93,0,Winter,9639,54547,48,False
2015,12/20,Albany,1.35,674,44638,58,9408,97,0,Winter,10082,44735,58,False
2015,12/13,Albany,0.93,794,109149,130,8042,103,0,Winter,8836,109252,130,False
2015,12/06,Albany,1.08,1132,71976,72,5677,133,0,Winter,6809,72109,72,False
2015,11/29,Albany,1.28,941,43838,75,5986,197,0,Fall,6927,44035,75,False
2015,11/22,Albany,1.26,1184,48067,43,6556,127,0,Fall,7740,48194,43,False
2015,11/15,Albany,0.99,1368,73672,93,8196,122,0,Fall,9564,73794,93,False
2015,11/08,Albany,0.98,703,101815,80,6266,562,0,Fall,6969,102377,80,False
2015,11/01,Albany,1.02,1022,87315,85,11104,283,0,Fall,12126,87598,85,False
2015,10/25,Albany,1.07,842,64757,113,8061,564,0,Fall,8903,65321,113,False
2015,10/18,Albany,1.12,924,75595,117,7877,327,0,Fall,8801,75922,117,False
2015,10/11,Albany,1.28,1582,52677,105,9866,257,0,Fall,11448,52934,105,False
2015,10/04,Albany,1.31,2268,49880,101,8379,376,0,Fall,10647,50256,101,False
2015,09/27,Albany,0.99,1204,99409,154,5888,145,0,Fall,7092,99554,154,False
2015,09/20,Albany,1.33,1028,59313,150,8489,778,0,Fall,9517,60091,150,False
2015,09/13,Albany,1.28,985,65696,142,8665,621,0,Fall,9650,66317,142,False
2015,09/06,Albany,1.11,879,90062,240,7762,227,0,Fall,8641,90289,240,False
2015,08/30,Albany,1.07,689,94362,335,10218,87,0,Summer,10907,94449,335,False
2015,08/23,Albany,1.34,733,67933,444,10745,134,0,Summer,11478,68067,444,False
2015,08/16,Albany,1.33,539,68666,394,10297,145,0,Summer,10836,68811,394,False
2015,08/09,Albany,1.12,584,100961,368,9116,109,0,Summer,9700,101070,368,False
2015,08/02,Albany,1.45,509,62035,741,11768,78,0,Summer,12277,62113,741,False
2015,07/26,Albany,1.11,648,91949,966,13061,131,0,Summer,13709,92080,966,False
2015,07/19,Albany,1.26,1042,82049,2238,11103,183,0,Summer,12145,82232,2238,False
2015,07/12,Albany,1.05,672,94693,4257,24290,108,33,Summer,24962,94801,4290,False
2015,07/05,Albany,1.35,869,72600,5883,29663,235,0,Summer,30532,72835,5883,False
2015,06/28,Albany,1.37,664,57545,4662,26311,350,0,Summer,26975,57895,4662,False
2015,06/21,Albany,1.27,804,76688,5481,21662,213,0,Summer,22466,76901,5481,False
2015,06/14,Albany,1.32,850,55400,4377,28343,659,0,Summer,29193,56059,4377,False
2015,06/07,Albany,1.07,656,99220,90,22314,460,0,Summer,22970,99680,90,False
2015,05/31,Albany,1.23,922,70469,50,23222,458,0,Spring,24144,70927,50,False
2015,05/24,Albany,1.19,680,71376,58,28761,593,0,Spring,29441,71969,58,False
2015,05/17,Albany,1.43,1150,81955,94,26285,372,0,Spring,27435,82327,94,False
2015,05/10,Albany,1.26,1420,102000,185,16535,285,0,Spring,17955,102285,185,False
2015,05/03,Albany,1.2,919,45490,217,12201,368,0,Spring,13120,45858,217,False
2015,04/26,Albany,1.22,875,35841,89,12076,701,0,Spring,12951,36542,89,False
2015,04/19,Albany,1.19,774,33941,47,13602,698,0,Spring,14376,34639,47,False
2015,04/12,Albany,1.13,864,30374,21,16438,665,0,Spring,17302,31039,21,False
2015,04/05,Albany,1.16,961,35577,93,9869,755,104,Spring,10830,36332,197,False
2015,03/29,Albany,1.02,1402,58623,89,7208,475,0,Spring,8610,59098,89,False
2015,03/22,Albany,1.12,2141,34313,141,9252,497,0,Spring,11393,34810,141,False
2015,03/15,Albany,1.11,2128,30447,99,9989,381,0,Spring,12117,30828,99,False
2015,03/08,Albany,1.07,795,30370,159,8827,354,0,Spring,9622,30724,159,False
2015,03/01,Albany,0.99,629,45633,181,8986,165,0,Spring,9615,45798,181,False
2015,02/22,Albany,1.07,1088,35056,151,9000,379,0,Winter,10088,35435,151,False
2015,02/15,Albany,1.06,986,30045,222,9979,333,0,Winter,10965,30378,222,False
2015,02/08,Albany,0.99,1357,39111,163,10113,508,0,Winter,11470,39619,163,False
2015,02/01,Albany,0.99,1353,60017,179,9170,152,0,Winter,10523,60169,179,False
2015,01/25,Albany,1.06,941,33196,164,10103,742,0,Winter,11044,33938,164,False
2015,01/18,Albany,1.17,914,31540,135,11651,269,0,Winter,12565,31809,135,False
2015,01/11,Albany,1.24,1002,31640,127,8036,388,0,Winter,9038,32028,127,False
2015,01/04,Albany,1.22,2819,28287,49,9186,529,0,Winter,12005,28816,49,False
2015,12/27,Atlanta,0.99,292097,27350,297,48605,17748,0,Winter,340702,45098,297,False
2015,12/20,Atlanta,1.08,251774,20702,103,46930,11867,0,Winter,298704,32569,103,False
2015,12/13,Atlanta,0.96,324932,31019,275,38903,22628,13,Winter,363835,53647,288,False
2015,12/06,Atlanta,1.07,283024,23740,181,37032,13654,2,Winter,320056,37394,183,False
2015,11/29,Atlanta,0.99,250288,28889,307,33031,20738,24,Fall,283319,49627,331,False
2015,11/22,Atlanta,1.0,269799,29732,501,36992,19389,0,Fall,306791,49121,501,False
2015,11/15,Atlanta,1.13,263915,28442,455,33656,13390,0,Fall,297571,41832,455,False
2015,11/08,Atlanta,1.12,250441,34483,488,35662,12941,24,Fall,286103,47424,512,False
2015,11/01,Atlanta,0.99,290457,62980,252,39460,25929,8,Fall,329917,88909,260,False
2015,10/25,Atlanta,1.09,236814,64607,304,31826,24924,0,Fall,268640,89531,304,False
2015,10/18,Atlanta,1.09,228710,59731,291,36884,23454,0,Fall,265594,83185,291,False
2015,10/11,Atlanta,0.95,255933,91047,599,41159,45134,0,Fall,297092,136181,599,False
2015,10/04,Atlanta,0.96,265797,92780,644,14875,44584,0,Fall,280672,137364,644,False
2015,09/27,Atlanta,1.07,262107,61870,680,20533,25125,2,Fall,282640,86995,682,False
2015,09/20,Atlanta,0.93,346118,82762,1349,33698,52442,61,Fall,379816,135204,1410,False
2015,09/13,Atlanta,1.07,278048,62485,714,46290,29678,13,Fall,324338,92163,727,False
2015,09/06,Atlanta,0.97,303113,73675,911,49833,44549,52,Fall,352946,118224,963,False
2015,08/30,Atlanta,1.15,275818,44839,1034,47138,14112,30,Summer,322956,58951,1064,False
2015,08/23,Atlanta,1.12,274462,46223,950,45534,11883,0,Summer,319996,58106,950,False
2015,08/16,Atlanta,1.09,362579,41992,1424,45068,14148,0,Summer,407647,56140,1424,False
2015,08/09,Atlanta,1.01,385027,47040,4251,45820,21568,83,Summer,430847,68608,4334,False
2015,08/02,Atlanta,1.15,306587,41906,3515,42126,11720,41,Summer,348713,53626,3556,False
2015,07/26,Atlanta,1.08,335372,44087,708,45114,12096,0,Summer,380486,56183,708,False
2015,07/19,Atlanta,0.97,446100,47838,1982,45099,16192,0,Summer,491199,64030,1982,False
2015,07/12,Atlanta,1.14,310080,37953,867,46023,12280,0,Summer,356103,50233,867,False
2015,07/05,Atlanta,1.01,436377,54675,848,50684,19851,24,Summer,487061,74526,872,False
2015,06/28,Atlanta,1.13,331353,37698,816,52099,13108,134,Summer,383452,50806,950,False
2015,06/21,Atlanta,0.99,449311,30231,678,55484,19010,46,Summer,504795,49241,724,False
2015,06/14,Atlanta,1.1,386370,17701,471,48612,12578,71,Summer,434982,30279,542,False
2015,06/07,Atlanta,0.99,455565,22414,738,50954,21329,5,Summer,506519,43743,743,False
2015,05/31,Atlanta,1.1,382900,19543,522,40505,11199,29,Spring,423405,30742,551,False
2015,05/24,Atlanta,0.96,538126,27284,1260,33867,22651,21,Spring,571993,49935,1281,False
2015,05/17,Atlanta,1.11,386400,18618,838,33710,11682,0,Spring,420110,30300,838,False
2015,05/10,Atlanta,1.1,413452,18860,1089,34108,12559,0,Spring,447560,31419,1089,False
2015,05/03,Atlanta,1.0,538403,28568,1059,32520,33660,0,Spring,570923,62228,1059,False
2015,04/26,Atlanta,1.12,387676,18366,1041,31315,10196,0,Spring,418991,28562,1041,False
2015,04/19,Atlanta,1.12,368709,18040,873,29661,13680,0,Spring,398370,31720,873,False
2015,04/12,Atlanta,0.99,377578,22419,219,25833,25051,0,Spring,403411,47470,219,False
2015,04/05,Atlanta,1.04,318473,19254,374,28612,16289,134,Spring,347085,35543,508,False
2015,03/29,Atlanta,1.11,305028,16651,261,29313,14466,0,Spring,334341,31117,261,False
2015,03/22,Atlanta,1.0,393591,23419,304,40495,21766,13,Spring,434086,45185,317,False
2015,03/15,Atlanta,1.12,336172,16508,310,34911,11625,37,Spring,371083,28133,347,False
2015,03/08,Atlanta,1.1,361559,15788,236,33847,9394,0,Spring,395406,25182,236,False
2015,03/01,Atlanta,0.99,441544,21183,347,32180,17273,2,Spring,473724,38456,349,False
2015,02/22,Atlanta,1.1,369316,18324,237,33423,10006,0,Winter,402739,28330,237,False
2015,02/15,Atlanta,1.06,364446,17420,638,26727,18158,0,Winter,391173,35578,638,False
2015,02/08,Atlanta,1.03,377256,17162,524,18044,20895,0,Winter,395300,38057,524,False
2015,02/01,Atlanta,0.96,553198,31583,294,10553,41140,0,Winter,563751,72723,294,False
2015,01/25,Atlanta,1.1,393408,18718,594,13176,23435,0,Winter,406584,42153,594,False
2015,01/18,Atlanta,1.11,372236,18701,511,16782,23257,0,Winter,389018,41958,511,False
2015,01/11,Atlanta,1.11,330411,18958,1135,21309,25728,0,Winter,351720,44686,1135,False
2015,01/04,Atlanta,1.0,364302,23821,82,16707,30108,0,Winter,381009,53929,82,False
2015,12/27,BaltimoreWashington,1.17,40450,394104,17353,142543,2367,0,Winter,182993,396471,17353,False
2015,12/20,BaltimoreWashington,1.11,44741,434590,19112,141751,2486,0,Winter,186492,437076,19112,False
2015,12/13,BaltimoreWashington,1.15,44400,399851,24291,149070,1895,0,Winter,193470,401746,24291,False
2015,12/06,BaltimoreWashington,1.04,51129,453586,25760,117112,1552,0,Winter,168241,455138,25760,False
2015,11/29,BaltimoreWashington,1.16,41028,379156,20147,103615,1852,0,Fall,144643,381008,20147,False
2015,11/22,BaltimoreWashington,1.12,40867,386137,23343,119007,2663,0,Fall,159874,388800,23343,False
2015,11/15,BaltimoreWashington,1.04,47109,503470,37990,125297,4462,0,Fall,172406,507932,37990,False
2015,11/08,BaltimoreWashington,1.05,58579,576512,51035,138777,6062,0,Fall,197356,582574,51035,False
2015,11/01,BaltimoreWashington,1.12,51860,473819,58615,152716,5209,0,Fall,204576,479028,58615,False
2015,10/25,BaltimoreWashington,1.19,53766,397911,49085,149987,6141,0,Fall,203753,404052,49085,False
2015,10/18,BaltimoreWashington,0.99,59121,745385,49171,146421,5504,0,Fall,205542,750889,49171,False
2015,10/11,BaltimoreWashington,1.24,34707,392008,58490,163669,4685,0,Fall,198376,396693,58490,False
2015,10/04,BaltimoreWashington,1.28,35342,407609,42257,167494,4739,0,Fall,202836,412348,42257,False
2015,09/27,BaltimoreWashington,1.19,34309,451061,59018,146792,5100,0,Fall,181101,456161,59018,False
2015,09/20,BaltimoreWashington,1.17,39619,450283,45336,168889,5139,0,Fall,208508,455422,45336,False
2015,09/13,BaltimoreWashington,1.09,55699,675524,42270,145686,5813,0,Fall,201385,681337,42270,False
2015,09/06,BaltimoreWashington,1.18,63903,522568,68180,165696,3268,5,Fall,229599,525836,68185,False
2015,08/30,BaltimoreWashington,1.24,48455,458207,42754,181968,3158,176,Summer,230423,461365,42930,False
2015,08/23,BaltimoreWashington,1.16,59242,499100,47216,175047,3060,269,Summer,234289,502160,47485,False
2015,08/16,BaltimoreWashington,1.14,86492,597184,43102,153156,2796,21,Summer,239648,599980,43123,False
2015,08/09,BaltimoreWashington,1.16,56362,557363,42933,161564,3298,0,Summer,217926,560661,42933,False
2015,08/02,BaltimoreWashington,1.17,53957,535167,44749,163667,3061,0,Summer,217624,538228,44749,False
2015,07/26,BaltimoreWashington,1.2,52746,496508,45010,174774,3880,5,Summer,227520,500388,45015,False
2015,07/19,BaltimoreWashington,1.18,52954,496206,50319,196837,3862,13,Summer,249791,500068,50332,False
2015,07/12,BaltimoreWashington,1.1,58827,547537,50679,189236,4406,244,Summer,248063,551943,50923,False
2015,07/05,BaltimoreWashington,1.16,66504,567640,56044,200097,5890,120,Summer,266601,573530,56164,False
2015,06/28,BaltimoreWashington,1.15,65051,534535,51109,207378,4022,164,Summer,272429,538557,51273,False
2015,06/21,BaltimoreWashington,1.16,58398,527866,51952,220904,3488,230,Summer,279302,531354,52182,False
2015,06/14,BaltimoreWashington,1.09,64005,593499,48344,244982,3668,546,Summer,308987,597167,48890,False
2015,06/07,BaltimoreWashington,1.26,62585,462951,43720,221165,3626,260,Summer,283750,466577,43980,False
2015,05/31,BaltimoreWashington,1.19,67744,617813,45832,211787,5730,268,Spring,279531,623543,46100,False
2015,05/24,BaltimoreWashington,1.18,63610,560740,49808,228842,5548,111,Spring,292452,566288,49919,False
2015,05/17,BaltimoreWashington,1.27,63515,455166,44840,222163,5152,15,Spring,285678,460318,44855,False
2015,05/10,BaltimoreWashington,1.26,79192,507104,44390,215572,8947,0,Spring,294764,516051,44390,False
2015,05/03,BaltimoreWashington,1.17,73038,536709,77537,201874,7767,44,Spring,274912,544476,77581,False
2015,04/26,BaltimoreWashington,1.29,58013,431532,39942,212064,6184,102,Spring,270077,437716,40044,False
2015,04/19,BaltimoreWashington,1.28,67486,427623,42125,219885,5741,0,Spring,287371,433364,42125,False
2015,04/12,BaltimoreWashington,1.15,70796,523170,42270,196076,5315,0,Spring,266872,528485,42270,False
2015,04/05,BaltimoreWashington,1.29,53579,401279,41867,184109,6357,873,Spring,237688,407636,42740,False
2015,03/29,BaltimoreWashington,1.25,58098,398050,43759,158964,4804,0,Spring,217062,402854,43759,False
2015,03/22,BaltimoreWashington,1.1,65158,524971,42381,171699,4685,0,Spring,236857,529656,42381,False
2015,03/15,BaltimoreWashington,1.24,53400,395837,46596,193130,4733,0,Spring,246530,400570,46596,False
2015,03/08,BaltimoreWashington,1.26,55284,367670,42267,188374,4147,0,Spring,243658,371817,42267,False
2015,03/01,BaltimoreWashington,1.16,59039,498872,40241,168224,3736,0,Spring,227263,502608,40241,False
2015,02/22,BaltimoreWashington,1.11,50501,445970,62611,186976,3785,0,Winter,237477,449755,62611,False
2015,02/15,BaltimoreWashington,1.25,49751,361677,45900,174864,5125,0,Winter,224615,366802,45900,False
2015,02/08,BaltimoreWashington,1.09,71703,554857,37437,175771,5161,0,Winter,247474,560018,37437,False
2015,02/01,BaltimoreWashington,1.06,93166,666010,83652,159916,4672,0,Winter,253082,670682,83652,False
2015,01/25,BaltimoreWashington,1.2,49696,386398,39488,209761,7588,0,Winter,259457,393986,39488,False
2015,01/18,BaltimoreWashington,1.23,49947,393359,40576,169390,4467,0,Winter,219337,397826,40576,False
2015,01/11,BaltimoreWashington,1.17,51460,420837,42526,151330,4075,0,Winter,202790,424912,42526,False
2015,01/04,BaltimoreWashington,1.08,53987,552906,39995,137146,3990,0,Winter,191133,556896,39995,False
2015,12/27,Boise,0.97,30482,2971,5894,23520,5,35,Winter,54002,2976,5929,False
2015,12/20,Boise,1.03,25628,2546,7393,21900,11,24,Winter,47528,2557,7417,False
2015,12/13,Boise,0.99,27148,2985,6458,21842,4,20,Winter,48990,2989,6478,False
2015,12/06,Boise,0.71,35590,12526,4086,42734,0,357,Winter,78324,12526,4443,False
2015,11/29,Boise,1.06,24189,2789,6031,15860,0,197,Fall,40049,2789,6228,False
2015,11/22,Boise,1.09,25408,3255,6662,17530,4,12,Fall,42938,3259,6674,False
2015,11/15,Boise,1.01,24424,12085,6502,25200,8,426,Fall,49624,12093,6928,False
2015,11/08,Boise,1.11,31910,4651,6285,12777,119,102,Fall,44687,4770,6387,False
2015,11/01,Boise,1.14,30434,4359,6428,12331,0,30,Fall,42765,4359,6458,False
2015,10/25,Boise,1.11,29521,10089,6551,13660,0,50,Fall,43181,10089,6601,False
2015,10/18,Boise,1.16,29614,9069,6586,8918,0,3,Fall,38532,9069,6589,False
2015,10/11,Boise,0.94,26114,33415,7604,13543,185,40,Fall,39657,33600,7644,False
2015,10/04,Boise,1.12,35154,10821,7551,5462,504,1,Fall,40616,11325,7552,False
2015,09/27,Boise,0.99,47007,5754,3663,7596,160,6,Fall,54603,5914,3669,False
2015,09/20,Boise,1.03,34826,21592,6640,10601,273,19,Fall,45427,21865,6659,False
2015,09/13,Boise,1.08,45738,4393,6593,7482,0,0,Fall,53220,4393,6593,False
2015,09/06,Boise,1.16,44134,5402,7991,6934,0,1,Fall,51068,5402,7992,False
2015,08/30,Boise,1.19,40926,5809,7922,5440,0,0,Summer,46366,5809,7922,False
2015,08/23,Boise,1.05,44059,14861,4433,7420,0,0,Summer,51479,14861,4433,False
2015,08/16,Boise,1.12,46189,5258,6457,6090,0,6,Summer,52279,5258,6463,False
2015,08/09,Boise,1.1,44739,5034,3931,7568,13,0,Summer,52307,5047,3931,False
2015,08/02,Boise,1.07,51151,5140,5435,5987,48,0,Summer,57138,5188,5435,False
2015,07/26,Boise,1.07,50978,4856,5479,6358,153,0,Summer,57336,5009,5479,False
2015,07/19,Boise,1.09,45921,5300,5565,6354,816,0,Summer,52275,6116,5565,False
2015,07/12,Boise,1.05,51828,5802,7474,8335,1236,0,Summer,60163,7038,7474,False
2015,07/05,Boise,1.15,61949,8022,8434,6557,80,0,Summer,68506,8102,8434,False
2015,06/28,Boise,1.04,59111,6573,3974,5619,0,1,Summer,64730,6573,3975,False
2015,06/21,Boise,1.06,52790,15444,5875,7021,0,264,Summer,59811,15444,6139,False
2015,06/14,Boise,0.99,58791,17880,3135,7800,0,0,Summer,66591,17880,3135,False
2015,06/07,Boise,1.12,61245,7237,6655,5603,8,0,Summer,66848,7245,6655,False
2015,05/31,Boise,0.97,57373,7421,4028,7860,5,0,Spring,65233,7426,4028,False
2015,05/24,Boise,1.03,54825,14839,6037,7469,0,37,Spring,62294,14839,6074,False
2015,05/17,Boise,0.96,61319,7393,2919,6345,0,8,Spring,67664,7393,2927,False
2015,05/10,Boise,1.06,62505,15896,7891,9453,0,42,Spring,71958,15896,7933,False
2015,05/03,Boise,1.0,66880,7942,4289,6349,0,4,Spring,73229,7942,4293,False
2015,04/26,Boise,0.96,69544,7985,3401,7174,0,4,Spring,76718,7985,3405,False
2015,04/19,Boise,0.99,56843,21630,3260,7953,0,6,Spring,64796,21630,3266,False
2015,04/12,Boise,1.19,44469,8506,7523,5747,0,0,Spring,50216,8506,7523,False
2015,04/05,Boise,1.09,57339,9060,3790,6510,0,3,Spring,63849,9060,3793,False
2015,03/29,Boise,0.98,59532,7119,3101,4789,0,0,Spring,64321,7119,3101,False
2015,03/22,Boise,1.17,44227,6589,7290,3311,0,0,Spring,47538,6589,7290,False
2015,03/15,Boise,1.0,51472,7018,2981,4445,0,0,Spring,55917,7018,2981,False
2015,03/08,Boise,1.14,45879,7206,7403,4860,0,0,Spring,50739,7206,7403,False
2015,03/01,Boise,1.06,40578,23738,3491,6478,759,0,Spring,47056,24497,3491,False
2015,02/22,Boise,0.99,50872,16374,2122,7235,232,0,Winter,58107,16606,2122,False
2015,02/15,Boise,1.14,41547,7840,6492,3647,1693,0,Winter,45194,9533,6492,False
2015,02/08,Boise,1.07,54229,9647,3047,1373,1673,0,Winter,55602,11320,3047,False
2015,02/01,Boise,0.91,67496,36532,2904,4867,1777,0,Winter,72363,38309,2904,False
2015,01/25,Boise,1.03,51922,7555,2061,2009,2520,0,Winter,53931,10075,2061,False
2015,01/18,Boise,1.08,50354,6342,2257,1119,2796,0,Winter,51473,9138,2257,False
2015,01/11,Boise,1.18,38112,10997,3321,3295,1628,0,Winter,41407,12625,3321,False
2015,01/04,Boise,1.01,44562,24964,2752,6064,1691,0,Winter,50626,26655,2752,False
2015,12/27,Boston,1.13,3886,346964,13952,85913,99,0,Winter,89799,347063,13952,False
2015,12/20,Boston,1.07,4912,390100,5887,88768,133,0,Winter,93680,390233,5887,False
2015,12/13,Boston,1.01,4641,455362,219,89523,199,0,Winter,94164,455561,219,False
2015,12/06,Boston,1.02,5126,407520,142,75666,223,0,Winter,80792,407743,142,False
2015,11/29,Boston,1.19,3609,272719,105,73864,261,0,Fall,77473,272980,105,False
2015,11/22,Boston,1.07,4457,383420,233,78161,486,0,Fall,82618,383906,233,False
2015,11/15,Boston,1.05,5310,420936,139,85604,1747,0,Fall,90914,422683,139,False
2015,11/08,Boston,1.04,5304,542880,231,88265,5077,0,Fall,93569,547957,231,False
2015,11/01,Boston,1.06,4886,449532,170,93443,5064,0,Fall,98329,454596,170,False
2015,10/25,Boston,1.02,4005,430725,191,94581,4745,0,Fall,98586,435470,191,False
2015,10/18,Boston,0.94,6409,627503,332,86046,5003,0,Fall,92455,632506,332,False
2015,10/11,Boston,1.14,5145,378295,355,97513,4396,0,Fall,102658,382691,355,False
2015,10/04,Boston,1.07,5804,427358,277,97207,5831,0,Fall,103011,433189,277,False
2015,09/27,Boston,1.07,5210,463079,289,82123,2603,0,Fall,87333,465682,289,False
2015,09/20,Boston,1.15,4376,398673,418,91612,3558,0,Fall,95988,402231,418,False
2015,09/13,Boston,1.03,5422,560792,353,84843,4271,0,Fall,90265,565063,353,False
2015,09/06,Boston,1.11,4237,477867,496,94558,614,0,Fall,98795,478481,496,False
2015,08/30,Boston,1.13,4177,438502,554,83242,188,0,Summer,87419,438690,554,False
2015,08/23,Boston,1.07,4744,488292,608,95585,241,0,Summer,100329,488533,608,False
2015,08/16,Boston,1.15,4460,464476,748,95887,222,0,Summer,100347,464698,748,False
2015,08/09,Boston,1.07,4173,590998,827,94287,231,0,Summer,98460,591229,827,False
2015,08/02,Boston,1.17,4442,468591,1451,97214,294,0,Summer,101656,468885,1451,False
2015,07/26,Boston,1.28,4299,393281,1957,100466,228,0,Summer,104765,393509,1957,False
2015,07/19,Boston,1.18,4720,477629,5071,109519,227,0,Summer,114239,477856,5071,False
2015,07/12,Boston,1.14,5332,471639,9361,146946,1236,0,Summer,152278,472875,9361,False
2015,07/05,Boston,1.27,4743,418251,11053,145982,2878,0,Summer,150725,421129,11053,False
2015,06/28,Boston,1.25,4688,403230,9120,142574,881,0,Summer,147262,404111,9120,False
2015,06/21,Boston,1.24,3582,404908,8899,125821,293,0,Summer,129403,405201,8899,False
2015,06/14,Boston,1.08,5104,521254,6545,151258,183,0,Summer,156362,521437,6545,False
2015,06/07,Boston,1.25,4034,421007,93,137224,183,0,Summer,141258,421190,93,False
2015,05/31,Boston,1.26,4128,418105,108,142515,303,0,Spring,146643,418408,108,False
2015,05/24,Boston,1.14,4601,490485,276,137769,388,0,Spring,142370,490873,276,False
2015,05/17,Boston,1.26,4285,380514,162,147667,1858,0,Spring,151952,382372,162,False
2015,05/10,Boston,1.14,4601,476827,131,141309,2688,0,Spring,145910,479515,131,False
2015,05/03,Boston,1.17,3828,429586,239,115148,3565,0,Spring,118976,433151,239,False
2015,04/26,Boston,1.28,3915,352464,131,106866,2533,0,Spring,110781,354997,131,False
2015,04/19,Boston,1.15,4013,384880,162,114562,1000,0,Spring,118575,385880,162,False
2015,04/12,Boston,1.26,3575,294164,106,108644,1994,0,Spring,112219,296158,106,False
2015,04/05,Boston,1.27,3657,330424,99,113541,1948,145,Spring,117198,332372,244,False
2015,03/29,Boston,1.19,3619,339299,151,108838,1723,0,Spring,112457,341022,151,False
2015,03/22,Boston,1.18,5956,344396,155,102204,460,0,Spring,108160,344856,155,False
2015,03/15,Boston,1.25,6085,308996,111,101931,624,0,Spring,108016,309620,111,False
2015,03/08,Boston,1.17,3425,290512,78,113811,575,0,Spring,117236,291087,78,False
2015,03/01,Boston,1.11,4106,383573,192,97423,439,0,Spring,101529,384012,192,False
2015,02/22,Boston,1.23,3232,251341,142,100498,217,0,Winter,103730,251558,142,False
2015,02/15,Boston,1.2,3794,281106,143,114283,555,0,Winter,118077,281661,143,False
2015,02/08,Boston,1.04,7653,495731,383,105403,813,0,Winter,113056,496544,383,False
2015,02/01,Boston,1.22,6082,373452,272,109900,313,0,Winter,115982,373765,272,False
2015,01/25,Boston,1.17,4730,288094,45,115538,934,0,Winter,120268,289028,45,False
2015,01/18,Boston,1.23,4383,287778,132,108668,367,0,Winter,113051,288145,132,False
2015,01/11,Boston,1.1,5548,320577,121,111192,331,0,Winter,116740,320908,121,False
2015,01/04,Boston,1.02,7193,396752,128,87406,256,0,Winter,94599,397008,128,False
2015,12/27,BuffaloRochester,1.35,1367,39542,85,55236,0,0,Winter,56603,39542,85,False
2015,12/20,BuffaloRochester,1.37,1164,38430,106,51165,0,0,Winter,52329,38430,106,False
2015,12/13,BuffaloRochester,1.35,1421,40783,66,56202,0,0,Winter,57623,40783,66,False
2015,12/06,BuffaloRochester,1.23,1737,58197,167,48355,0,0,Winter,50092,58197,167,False
2015,11/29,BuffaloRochester,1.39,1514,35682,113,42662,0,0,Fall,44176,35682,113,False
2015,11/22,BuffaloRochester,1.4,1711,38780,107,49642,0,0,Fall,51353,38780,107,False
2015,11/15,BuffaloRochester,1.36,1803,41457,107,55593,742,0,Fall,57396,42199,107,False
2015,11/08,BuffaloRochester,1.3,1288,49507,55,58885,1302,0,Fall,60173,50809,55,False
2015,11/01,BuffaloRochester,1.23,2181,61874,186,52956,1342,0,Fall,55137,63216,186,False
2015,10/25,BuffaloRochester,1.36,1545,36645,79,59381,1902,0,Fall,60926,38547,79,False
2015,10/18,BuffaloRochester,1.29,1536,40701,58,62627,1160,0,Fall,64163,41861,58,False
2015,10/11,BuffaloRochester,1.3,2170,50862,96,54829,1195,0,Fall,56999,52057,96,False
2015,10/04,BuffaloRochester,1.33,3020,38353,101,56141,1284,0,Fall,59161,39637,101,False
2015,09/27,BuffaloRochester,1.31,1908,60292,106,27767,671,0,Fall,29675,60963,106,False
2015,09/20,BuffaloRochester,1.54,1445,39831,88,18437,821,0,Fall,19882,40652,88,False
2015,09/13,BuffaloRochester,1.59,1572,48468,134,22421,445,0,Fall,23993,48913,134,False
2015,09/06,BuffaloRochester,1.56,1471,49388,173,25092,13,0,Fall,26563,49401,173,False
2015,08/30,BuffaloRochester,1.38,1406,61600,241,20483,0,0,Summer,21889,61600,241,False
2015,08/23,BuffaloRochester,1.49,1287,43655,170,23840,0,0,Summer,25127,43655,170,False
2015,08/16,BuffaloRochester,1.5,1230,45937,258,22371,0,0,Summer,23601,45937,258,False
2015,08/09,BuffaloRochester,1.47,1139,56289,349,24051,0,0,Summer,25190,56289,349,False
2015,08/02,BuffaloRochester,1.47,1447,44620,471,31622,0,0,Summer,33069,44620,471,False
2015,07/26,BuffaloRochester,1.39,1679,45615,741,43788,0,0,Summer,45467,45615,741,False
2015,07/19,BuffaloRochester,1.36,1165,54492,2205,70982,0,0,Summer,72147,54492,2205,False
2015,07/12,BuffaloRochester,1.45,1119,47294,4714,73796,426,0,Summer,74915,47720,4714,False
2015,07/05,BuffaloRochester,1.47,1503,56925,6707,74370,906,0,Summer,75873,57831,6707,False
2015,06/28,BuffaloRochester,1.36,1235,51801,5397,78749,62,0,Summer,79984,51863,5397,False
2015,06/21,BuffaloRochester,1.5,1254,47845,5424,54130,0,0,Summer,55384,47845,5424,False
2015,06/14,BuffaloRochester,1.34,1183,48286,4432,95473,0,0,Summer,96656,48286,4432,False
2015,06/07,BuffaloRochester,1.38,779,57999,138,71990,0,0,Summer,72769,57999,138,False
2015,05/31,BuffaloRochester,1.4,1039,54249,79,75473,0,0,Spring,76512,54249,79,False
2015,05/24,BuffaloRochester,1.43,1033,55018,103,65741,44,0,Spring,66774,55062,103,False
2015,05/17,BuffaloRochester,1.35,932,61668,56,73414,977,0,Spring,74346,62645,56,False
2015,05/10,BuffaloRochester,1.33,1321,73754,185,94832,453,0,Spring,96153,74207,185,False
2015,05/03,BuffaloRochester,1.42,946,50266,81,84332,1102,43,Spring,85278,51368,124,False
2015,04/26,BuffaloRochester,1.41,1117,49556,106,85503,640,40,Spring,86620,50196,146,False
2015,04/19,BuffaloRochester,1.42,1021,52954,59,85056,519,0,Spring,86077,53473,59,False
2015,04/12,BuffaloRochester,1.42,884,45443,92,70938,813,0,Spring,71822,46256,92,False
2015,04/05,BuffaloRochester,1.44,969,51023,95,71408,597,50,Spring,72377,51620,145,False
2015,03/29,BuffaloRochester,1.39,1352,48430,80,69919,108,0,Spring,71271,48538,80,False
2015,03/22,BuffaloRochester,1.4,3090,45420,48,71288,55,0,Spring,74378,45475,48,False
2015,03/15,BuffaloRochester,1.47,3500,45688,66,54046,111,0,Spring,57546,45799,66,False
2015,03/08,BuffaloRochester,1.35,1072,61973,102,62216,360,0,Spring,63288,62333,102,False
2015,03/01,BuffaloRochester,1.43,1032,41685,104,69479,62,0,Spring,70511,41747,104,False
2015,02/22,BuffaloRochester,1.41,1709,45393,131,61765,546,0,Winter,63474,45939,131,False
2015,02/15,BuffaloRochester,1.44,1520,43271,57,55232,124,0,Winter,56752,43395,57,False
2015,02/08,BuffaloRochester,1.36,1822,66261,161,63918,595,0,Winter,65740,66856,161,False
2015,02/01,BuffaloRochester,1.33,2117,64770,112,86848,71,0,Winter,88965,64841,112,False
2015,01/25,BuffaloRochester,1.5,1321,54007,74,57909,740,0,Winter,59230,54747,74,False
2015,01/18,BuffaloRochester,1.52,1625,61859,133,43419,2,0,Winter,45044,61861,133,False
2015,01/11,BuffaloRochester,1.54,1642,50985,79,53514,0,0,Winter,55156,50985,79,False
2015,01/04,BuffaloRochester,1.4,3267,55693,109,57182,0,0,Winter,60449,55693,109,False
2015,12/27,Charlotte,0.96,33070,62956,23041,35130,2499,0,Winter,68200,65455,23041,False
2015,12/20,Charlotte,0.98,29500,55520,19842,33273,1781,0,Winter,62773,57301,19842,False
2015,12/13,Charlotte,0.95,31727,62544,23842,35793,3238,0,Winter,67520,65782,23842,False
2015,12/06,Charlotte,0.99,34117,63074,28482,28181,2257,0,Winter,62298,65331,28482,False
2015,11/29,Charlotte,0.95,31911,53470,22685,27376,3415,0,Fall,59287,56885,22685,False
2015,11/22,Charlotte,1.0,30028,53644,24221,22228,3494,0,Fall,52256,57138,24221,False
2015,11/15,Charlotte,1.01,28543,80244,36860,21132,2500,0,Fall,49675,82744,36860,False
2015,11/08,Charlotte,1.03,30860,54456,49282,28076,1647,0,Fall,58936,56103,49282,False
2015,11/01,Charlotte,1.11,33371,47079,53968,32848,4525,0,Fall,66219,51604,53968,False
2015,10/25,Charlotte,1.27,23093,38356,44882,30219,4368,0,Fall,53312,42724,44882,False
2015,10/18,Charlotte,1.26,22805,54518,44707,31176,3358,0,Fall,53981,57876,44707,False
2015,10/11,Charlotte,1.14,22941,45669,58989,33103,6692,0,Fall,56044,52361,58989,False
2015,10/04,Charlotte,1.22,23648,44671,40366,30388,7661,0,Fall,54036,52332,40366,False
2015,09/27,Charlotte,1.09,24397,54210,58551,27053,4567,0,Fall,51450,58777,58551,False
2015,09/20,Charlotte,1.2,25922,46906,41261,38940,8412,0,Fall,64862,55318,41261,False
2015,09/13,Charlotte,1.19,30122,41616,36469,56910,5958,0,Fall,87032,47574,36469,False
2015,09/06,Charlotte,1.01,35126,62187,64372,59197,6844,0,Fall,94323,69031,64372,False
2015,08/30,Charlotte,1.2,33511,41700,38130,63371,2312,0,Summer,96882,44012,38130,False
2015,08/23,Charlotte,1.15,32280,50475,41677,76846,2018,0,Summer,109126,52493,41677,False
2015,08/16,Charlotte,1.24,32128,42068,41343,60769,2216,0,Summer,92897,44284,41343,False
2015,08/09,Charlotte,1.21,29915,43782,37614,57783,3963,0,Summer,87698,47745,37614,False
2015,08/02,Charlotte,1.24,30200,48686,39734,58627,2072,0,Summer,88827,50758,39734,False
2015,07/26,Charlotte,1.23,30901,39607,39260,62053,2073,0,Summer,92954,41680,39260,False
2015,07/19,Charlotte,1.19,33382,49072,39515,62470,3134,0,Summer,95852,52206,39515,False
2015,07/12,Charlotte,1.18,23580,56317,35107,65681,2170,0,Summer,89261,58487,35107,False
2015,07/05,Charlotte,1.18,30803,73470,40602,67865,3377,0,Summer,98668,76847,40602,False
2015,06/28,Charlotte,1.17,23693,58162,42044,67989,1764,0,Summer,91682,59926,42044,False
2015,06/21,Charlotte,1.17,30951,58913,38260,69426,3622,0,Summer,100377,62535,38260,False
2015,06/14,Charlotte,1.15,31247,64828,41193,67842,1981,0,Summer,99089,66809,41193,False
2015,06/07,Charlotte,1.15,43524,45226,38578,69123,3526,0,Summer,112647,48752,38578,False
2015,05/31,Charlotte,1.19,45688,43259,44529,58990,2162,0,Spring,104678,45421,44529,False
2015,05/24,Charlotte,1.2,43628,59207,46014,59663,4013,0,Spring,103291,63220,46014,False
2015,05/17,Charlotte,1.21,44340,46424,40248,57583,2202,0,Spring,101923,48626,40248,False
2015,05/10,Charlotte,1.19,47626,42863,38370,61759,2147,0,Spring,109385,45010,38370,False
2015,05/03,Charlotte,1.0,50203,69446,77627,58626,5588,0,Spring,108829,75034,77627,False
2015,04/26,Charlotte,1.2,39481,44796,37961,58701,1201,0,Spring,98182,45997,37961,False
2015,04/19,Charlotte,1.18,38330,41954,36041,63182,1436,0,Spring,101512,43390,36041,False
2015,04/12,Charlotte,1.17,48793,50390,39638,61787,3396,0,Spring,110580,53786,39638,False
2015,04/05,Charlotte,1.19,43112,40448,36210,56450,1599,98,Spring,99562,42047,36308,False
2015,03/29,Charlotte,1.23,34498,50741,40688,51856,1004,0,Spring,86354,51745,40688,False
2015,03/22,Charlotte,1.19,41638,44726,37099,56443,2967,0,Spring,98081,47693,37099,False
2015,03/15,Charlotte,1.19,39138,48595,43739,51028,1442,0,Spring,90166,50037,43739,False
2015,03/08,Charlotte,1.25,29980,39244,36249,52537,1374,0,Spring,82517,40618,36249,False
2015,03/01,Charlotte,1.18,45465,40006,34948,52873,2851,0,Spring,98338,42857,34948,False
2015,02/22,Charlotte,1.08,44679,48498,61590,44919,2053,0,Winter,89598,50551,61590,False
2015,02/15,Charlotte,1.22,28227,38591,40430,40419,9128,0,Winter,68646,47719,40430,False
2015,02/08,Charlotte,1.17,31509,35566,31778,41921,9363,0,Winter,73430,44929,31778,False
2015,02/01,Charlotte,0.98,52915,71209,80813,33450,15620,0,Winter,86365,86829,80813,False
2015,01/25,Charlotte,1.18,37383,44000,31576,41623,12686,0,Winter,79006,56686,31576,False
2015,01/18,Charlotte,1.25,26462,40475,38677,33996,13058,0,Winter,60458,53533,38677,False
2015,01/11,Charlotte,1.26,31586,38118,40801,38822,10613,0,Winter,70408,48731,40801,False
2015,01/04,Charlotte,1.19,29419,47220,38568,44329,6468,0,Winter,73748,53688,38568,False
2015,12/27,Chicago,0.93,42799,445218,78378,83066,1617,10056,Winter,125865,446835,88434,False
2015,12/20,Chicago,0.91,35724,464574,96306,76241,9592,8230,Winter,111965,474166,104536,False
2015,12/13,Chicago,1.07,40380,451470,94162,76829,5693,65,Winter,117209,457163,94227,False
2015,12/06,Chicago,1.14,53173,455048,92888,62473,420,16,Winter,115646,455468,92904,False
2015,11/29,Chicago,1.11,42851,422479,74988,61862,298,0,Fall,104713,422777,74988,False
2015,11/22,Chicago,0.94,34868,553545,89732,73457,294,0,Fall,108325,553839,89732,False
2015,11/15,Chicago,1.17,31286,441753,93857,74723,261,0,Fall,106009,442014,93857,False
2015,11/08,Chicago,1.01,44528,498562,101889,65842,324,0,Fall,110370,498886,101889,False
2015,11/01,Chicago,1.0,69420,562214,106536,68447,422,0,Fall,137867,562636,106536,False
2015,10/25,Chicago,1.12,59161,454352,108012,65795,323,5,Fall,124956,454675,108017,False
2015,10/18,Chicago,1.15,25883,482992,118311,62076,285,753,Fall,87959,483277,119064,False
2015,10/11,Chicago,1.08,16455,503813,119996,65144,528,2974,Fall,81599,504341,122970,False
2015,10/04,Chicago,1.18,14268,485262,105711,66015,2240,1674,Fall,80283,487502,107385,False
2015,09/27,Chicago,1.15,16483,532028,101193,63370,2923,4501,Fall,79853,534951,105694,False
2015,09/20,Chicago,1.19,16477,534644,103103,71195,3316,379,Fall,87672,537960,103482,False
2015,09/13,Chicago,1.19,17172,546965,128619,78368,3809,736,Fall,95540,550774,129355,False
2015,09/06,Chicago,1.11,17595,581941,122938,82905,3289,7,Fall,100500,585230,122945,False
2015,08/30,Chicago,1.12,17363,570147,112344,71627,2205,86,Summer,88990,572352,112430,False
2015,08/23,Chicago,1.2,17595,550359,103622,77073,2759,438,Summer,94668,553118,104060,False
2015,08/16,Chicago,1.16,19193,609692,104997,80018,3447,340,Summer,99211,613139,105337,False
2015,08/09,Chicago,1.25,18237,526303,104796,79510,1904,372,Summer,97747,528207,105168,False
2015,08/02,Chicago,1.27,21607,559825,97419,79197,2476,501,Summer,100804,562301,97920,False
2015,07/26,Chicago,1.12,26653,577460,99066,83728,3516,907,Summer,110381,580976,99973,False
2015,07/19,Chicago,1.24,20534,560871,116910,92362,3531,2849,Summer,112896,564402,119759,False
2015,07/12,Chicago,1.26,22933,545739,109149,90428,2536,1363,Summer,113361,548275,110512,False
2015,07/05,Chicago,1.24,28422,661207,118634,126579,2236,237,Summer,155001,663443,118871,False
2015,06/28,Chicago,1.21,27391,524476,104595,126835,1896,1054,Summer,154226,526372,105649,False
2015,06/21,Chicago,1.24,34715,536926,122239,107242,1658,2120,Summer,141957,538584,124359,False
2015,06/14,Chicago,1.21,55227,586037,107908,116318,2618,87,Summer,171545,588655,107995,False
2015,06/07,Chicago,1.24,51410,544663,122929,99942,4693,576,Summer,151352,549356,123505,False
2015,05/31,Chicago,1.26,50563,518850,132732,99122,2299,3,Spring,149685,521149,132735,False
2015,05/24,Chicago,1.23,57568,611797,113475,101615,2639,9,Spring,159183,614436,113484,False
2015,05/17,Chicago,1.23,54087,569043,109205,82689,2813,30,Spring,136776,571856,109235,False
2015,05/10,Chicago,1.23,55587,545784,141250,88847,4468,0,Spring,144434,550252,141250,False
2015,05/03,Chicago,1.04,64798,690167,129694,89297,4414,3,Spring,154095,694581,129697,False
2015,04/26,Chicago,1.24,46749,543002,97410,88341,3573,790,Spring,135090,546575,98200,False
2015,04/19,Chicago,1.24,52850,594214,93303,89276,2780,103,Spring,142126,596994,93406,False
2015,04/12,Chicago,1.24,45103,488323,83137,91664,2475,14,Spring,136767,490798,83151,False
2015,04/05,Chicago,1.27,38641,530946,90801,87170,3422,829,Spring,125811,534368,91630,False
2015,03/29,Chicago,1.22,25629,545317,84865,97284,4163,10,Spring,122913,549480,84875,False
2015,03/22,Chicago,1.21,29308,596341,83937,87394,2925,39,Spring,116702,599266,83976,False
2015,03/15,Chicago,1.09,30100,600833,98822,93312,3914,26,Spring,123412,604747,98848,False
2015,03/08,Chicago,1.18,27489,523118,112934,107215,2234,5,Spring,134704,525352,112939,False
2015,03/01,Chicago,1.09,24137,637043,111791,88092,2289,38,Spring,112229,639332,111829,False
2015,02/22,Chicago,1.18,39072,533387,106178,90447,3976,15,Winter,129519,537363,106193,False
2015,02/15,Chicago,1.17,29711,488591,110446,92518,5112,19,Winter,122229,493703,110465,False
2015,02/08,Chicago,1.13,28216,499138,119634,78980,3273,81,Winter,107196,502411,119715,False
2015,02/01,Chicago,0.91,50783,824745,164884,89516,3448,112,Winter,140299,828193,164996,False
2015,01/25,Chicago,1.22,26117,488218,145882,75867,9265,87,Winter,101984,497483,145969,False
2015,01/18,Chicago,1.14,24917,533717,140239,95516,3311,37,Winter,120433,537028,140276,False
2015,01/11,Chicago,1.15,31239,558487,133848,74716,4539,42,Winter,105955,563026,133890,False
2015,01/04,Chicago,1.11,30270,550752,124506,72888,4651,0,Winter,103158,555403,124506,False
2015,12/27,CincinnatiDayton,0.87,2633,100444,9546,14050,30968,5350,Winter,16683,131412,14896,False
2015,12/20,CincinnatiDayton,0.85,2732,108930,7517,12118,39679,4447,Winter,14850,148609,11964,False
2015,12/13,CincinnatiDayton,0.79,3802,123544,4574,15835,58783,846,Winter,19637,182327,5420,False
2015,12/06,CincinnatiDayton,0.83,2914,129978,15475,13539,42885,2718,Winter,16453,172863,18193,False
2015,11/29,CincinnatiDayton,0.88,2399,94093,5885,12785,24850,1342,Fall,15184,118943,7227,False
2015,11/22,CincinnatiDayton,0.89,2565,115591,9595,13804,31446,1888,Fall,16369,147037,11483,False
2015,11/15,CincinnatiDayton,0.88,2680,129291,4905,15733,40083,1028,Fall,18413,169374,5933,False
2015,11/08,CincinnatiDayton,0.87,2979,156267,19577,12989,42509,4746,Fall,15968,198776,24323,False
2015,11/01,CincinnatiDayton,0.93,2998,166867,13267,14831,53584,3210,Fall,17829,220451,16477,False
2015,10/25,CincinnatiDayton,1.01,2264,132625,9187,12423,45209,1971,Fall,14687,177834,11158,False
2015,10/18,CincinnatiDayton,0.98,2297,131737,8931,17414,24553,1110,Fall,19711,156290,10041,False
2015,10/11,CincinnatiDayton,0.91,2251,146962,13777,16191,31742,2601,Fall,18442,178704,16378,False
2015,10/04,CincinnatiDayton,0.93,2132,157237,11767,16488,45980,1637,Fall,18620,203217,13404,False
2015,09/27,CincinnatiDayton,1.08,2220,138937,11725,12344,34341,2442,Fall,14564,173278,14167,False
2015,09/20,CincinnatiDayton,1.05,3127,139042,21179,12353,29601,5140,Fall,15480,168643,26319,False
2015,09/13,CincinnatiDayton,1.05,2195,139863,18310,17271,34690,4218,Fall,19466,174553,22528,False
2015,09/06,CincinnatiDayton,1.02,2462,154106,8956,19499,45312,1819,Fall,21961,199418,10775,False
2015,08/30,CincinnatiDayton,1.01,2623,153832,14357,17804,42734,2780,Summer,20427,196566,17137,False
2015,08/23,CincinnatiDayton,1.05,2750,141969,5299,15961,41548,1079,Summer,18711,183517,6378,False
2015,08/16,CincinnatiDayton,1.01,2472,146747,21571,16806,41442,5308,Summer,19278,188189,26879,False
2015,08/09,CincinnatiDayton,1.08,2357,144957,10921,19933,34194,2008,Summer,22290,179151,12929,False
2015,08/02,CincinnatiDayton,1.09,2443,142847,9778,16179,33163,1708,Summer,18622,176010,11486,False
2015,07/26,CincinnatiDayton,1.03,2474,139527,5691,24769,43020,1127,Summer,27243,182547,6818,False
2015,07/19,CincinnatiDayton,1.06,3726,146965,14449,21470,33782,3084,Summer,25196,180747,17533,False
2015,07/12,CincinnatiDayton,1.03,3503,148642,4243,23225,37926,629,Summer,26728,186568,4872,False
2015,07/05,CincinnatiDayton,1.03,3238,165479,10201,27500,43026,1179,Summer,30738,208505,11380,False
2015,06/28,CincinnatiDayton,1.01,3691,144983,3666,34098,38098,626,Summer,37789,183081,4292,False
2015,06/21,CincinnatiDayton,1.02,3795,158957,15259,25431,37441,2126,Summer,29226,196398,17385,False
2015,06/14,CincinnatiDayton,1.05,6856,145975,10046,30258,34920,1307,Summer,37114,180895,11353,False
2015,06/07,CincinnatiDayton,1.07,10630,146360,14601,23651,36952,2785,Summer,34281,183312,17386,False
2015,05/31,CincinnatiDayton,1.06,10459,143893,4652,20976,41425,975,Spring,31435,185318,5627,False
2015,05/24,CincinnatiDayton,1.1,10258,152036,4490,24486,30170,947,Spring,34744,182206,5437,False
2015,05/17,CincinnatiDayton,1.04,10239,150323,14523,18091,38536,2863,Spring,28330,188859,17386,False
2015,05/10,CincinnatiDayton,1.06,11982,172173,2408,22506,50265,262,Spring,34488,222438,2670,False
2015,05/03,CincinnatiDayton,1.08,11468,162213,7282,18315,37361,1499,Spring,29783,199574,8781,False
2015,04/26,CincinnatiDayton,1.06,8217,138764,6904,21522,37783,1278,Spring,29739,176547,8182,False
2015,04/19,CincinnatiDayton,1.02,8229,144900,12959,35196,23101,2591,Spring,43425,168001,15550,False
2015,04/12,CincinnatiDayton,1.02,11176,120830,1306,38219,17270,135,Spring,49395,138100,1441,False
2015,04/05,CincinnatiDayton,1.06,7516,135093,2508,36567,14361,121,Spring,44083,149454,2629,False
2015,03/29,CincinnatiDayton,0.95,3014,122178,2448,46587,23745,391,Spring,49601,145923,2839,False
2015,03/22,CincinnatiDayton,0.98,2968,137560,23368,11317,31773,5732,Spring,14285,169333,29100,False
2015,03/15,CincinnatiDayton,0.94,3550,131234,3387,19570,37402,863,Spring,23120,168636,4250,False
2015,03/08,CincinnatiDayton,0.87,3470,147536,3678,30834,32786,805,Spring,34304,180322,4483,False
2015,03/01,CincinnatiDayton,0.89,3610,157400,18680,14963,28229,4065,Spring,18573,185629,22745,False
2015,02/22,CincinnatiDayton,0.93,4431,134258,3240,18685,21703,752,Winter,23116,155961,3992,False
2015,02/15,CincinnatiDayton,0.94,4399,122866,3067,21356,17556,705,Winter,25755,140422,3772,False
2015,02/08,CincinnatiDayton,0.93,4246,140926,4185,17773,18571,913,Winter,22019,159497,5098,False
2015,02/01,CincinnatiDayton,0.86,4665,224967,19442,15335,31756,4737,Winter,20000,256723,24179,False
2015,01/25,CincinnatiDayton,0.93,3617,162644,656,20650,25970,16,Winter,24267,188614,672,False
2015,01/18,CincinnatiDayton,0.93,3333,128858,1086,24024,18264,114,Winter,27357,147122,1200,False
2015,01/11,CincinnatiDayton,0.92,3612,153100,1203,17035,26345,94,Winter,20647,179445,1297,False
2015,01/04,CincinnatiDayton,0.88,3274,168764,1447,17525,37445,112,Winter,20799,206209,1559,False
2015,12/27,Columbus,0.99,41808,27120,15564,15032,3874,4164,Winter,56840,30994,19728,False
2015,12/20,Columbus,1.03,57557,23198,16370,11760,4248,4257,Winter,69317,27446,20627,False
2015,12/13,Columbus,1.03,69742,21750,12957,14642,4307,1216,Winter,84384,26057,14173,False
2015,12/06,Columbus,0.99,60376,33565,24435,12451,3866,2500,Winter,72827,37431,26935,False
2015,11/29,Columbus,1.03,40352,22858,16653,12106,4115,1149,Fall,52458,26973,17802,False
2015,11/22,Columbus,1.04,50334,25643,20730,13855,2827,1698,Fall,64189,28470,22428,False
2015,11/15,Columbus,0.99,52474,26705,15258,19594,2618,810,Fall,72068,29323,16068,False
2015,11/08,Columbus,0.95,61494,35336,29583,14899,6935,3834,Fall,76393,42271,33417,False
2015,11/01,Columbus,0.99,58162,31821,23764,14668,3691,3129,Fall,72830,35512,26893,False
2015,10/25,Columbus,1.04,59745,23351,19024,11461,3925,1702,Fall,71206,27276,20726,False
2015,10/18,Columbus,0.98,62590,33116,18606,18601,4384,473,Fall,81191,37500,19079,False
2015,10/11,Columbus,0.9,57480,39207,24724,16946,4765,2179,Fall,74426,43972,26903,False
2015,10/04,Columbus,0.93,53606,38396,23069,14952,2202,2099,Fall,68558,40598,25168,False
2015,09/27,Columbus,1.02,66587,33743,18527,10970,5538,1931,Fall,77557,39281,20458,False
2015,09/20,Columbus,1.0,86031,31599,26200,12029,4671,4535,Fall,98060,36270,30735,False
2015,09/13,Columbus,1.02,86159,31464,26703,17099,4201,3397,Fall,103258,35665,30100,False
2015,09/06,Columbus,1.04,61052,40880,20842,16533,3611,1641,Fall,77585,44491,22483,False
2015,08/30,Columbus,1.03,64531,32172,25751,16928,4937,2909,Summer,81459,37109,28660,False
2015,08/23,Columbus,1.08,64597,29728,15723,14961,5010,899,Summer,79558,34738,16622,False
2015,08/16,Columbus,1.03,63291,36257,32383,15230,4314,4404,Summer,78521,40571,36787,False
2015,08/09,Columbus,1.0,64121,52440,20857,20668,7460,1840,Summer,84789,59900,22697,False
2015,08/02,Columbus,1.05,77973,30063,17344,17997,3281,1936,Summer,95970,33344,19280,False
2015,07/26,Columbus,1.02,91758,25540,13557,23981,3986,1023,Summer,115739,29526,14580,False
2015,07/19,Columbus,1.05,75080,33397,24209,21845,2442,2161,Summer,96925,35839,26370,False
2015,07/12,Columbus,1.04,69964,32449,16034,22605,2366,572,Summer,92569,34815,16606,False
2015,07/05,Columbus,0.98,79063,39343,24674,24909,4244,1134,Summer,103972,43587,25808,False
2015,06/28,Columbus,0.94,72752,38877,12796,29338,5683,521,Summer,102090,44560,13317,False
2015,06/21,Columbus,0.99,67311,40382,24529,24969,4739,2229,Summer,92280,45121,26758,False
2015,06/14,Columbus,1.01,83138,33535,20023,27204,6030,1421,Summer,110342,39565,21444,False
2015,06/07,Columbus,1.03,92110,33225,29167,23654,5888,3937,Summer,115764,39113,33104,False
2015,05/31,Columbus,1.1,80729,21813,13935,21434,4733,1340,Spring,102163,26546,15275,False
2015,05/24,Columbus,1.01,85510,37314,14261,22680,10832,1280,Spring,108190,48146,15541,False
2015,05/17,Columbus,1.0,97341,38624,22934,15997,2463,3150,Spring,113338,41087,26084,False
2015,05/10,Columbus,1.1,97879,27581,10126,23689,2796,729,Spring,121568,30377,10855,False
2015,05/03,Columbus,0.99,79998,53621,15882,16302,9726,1206,Spring,96300,63347,17088,False
2015,04/26,Columbus,1.02,87214,28964,16624,22384,4959,1291,Spring,109598,33923,17915,False
2015,04/19,Columbus,1.0,80303,40370,26369,20819,1861,3189,Spring,101122,42231,29558,False
2015,04/12,Columbus,1.07,66513,28065,9955,23837,840,184,Spring,90350,28905,10139,False
2015,04/05,Columbus,1.09,67298,30313,9926,17853,642,75,Spring,85151,30955,10001,False
2015,03/29,Columbus,0.96,72473,25151,8711,31416,937,375,Spring,103889,26088,9086,False
2015,03/22,Columbus,0.94,101143,40165,24995,9158,2691,4470,Spring,110301,42856,29465,False
2015,03/15,Columbus,1.01,90582,27040,9632,18487,3462,679,Spring,109069,30502,10311,False
2015,03/08,Columbus,0.95,56323,37382,11404,29553,5482,1134,Spring,85876,42864,12538,False
2015,03/01,Columbus,1.03,55610,36034,25775,13297,1837,4240,Spring,68907,37871,30015,False
2015,02/22,Columbus,1.09,56131,26134,10603,18266,2275,869,Winter,74397,28409,11472,False
2015,02/15,Columbus,1.05,52221,20939,8939,22104,1860,597,Winter,74325,22799,9536,False
2015,02/08,Columbus,0.96,76792,23238,7652,17859,1970,563,Winter,94651,25208,8215,False
2015,02/01,Columbus,0.87,111171,59739,21795,16360,3422,4163,Winter,127531,63161,25958,False
2015,01/25,Columbus,1.08,53201,32775,7822,21117,2057,21,Winter,74318,34832,7843,False
2015,01/18,Columbus,1.02,55532,26458,7040,24386,2962,68,Winter,79918,29420,7108,False
2015,01/11,Columbus,0.97,64726,34844,7190,16400,2458,122,Winter,81126,37302,7312,False
2015,01/04,Columbus,0.89,80298,51860,7609,16518,2132,219,Winter,96816,53992,7828,False
2015,12/27,DallasFtWorth,0.8,494425,276556,84912,136560,12277,15657,Winter,630985,288833,100569,False
2015,12/20,DallasFtWorth,0.82,439792,257532,91158,103511,10331,25724,Winter,543303,267863,116882,False
2015,12/13,DallasFtWorth,0.79,476178,319789,62436,114978,7472,34,Winter,591156,327261,62470,False
2015,12/06,DallasFtWorth,0.74,514160,412692,8533,108772,10525,166,Winter,622932,423217,8699,False
2015,11/29,DallasFtWorth,0.8,477944,244879,6211,96799,13967,16,Fall,574743,258846,6227,False
2015,11/22,DallasFtWorth,0.78,494872,264820,9913,102317,13138,3,Fall,597189,277958,9916,False
2015,11/15,DallasFtWorth,0.71,642897,263132,10305,109552,14527,24,Fall,752449,277659,10329,False
2015,11/08,DallasFtWorth,0.8,563069,278244,33026,92853,10364,158,Fall,655922,288608,33184,False
2015,11/01,DallasFtWorth,0.78,546040,376913,85323,98097,7644,158,Fall,644137,384557,85481,False
2015,10/25,DallasFtWorth,0.86,557469,301143,49959,96417,5279,125,Fall,653886,306422,50084,False
2015,10/18,DallasFtWorth,0.83,570732,266044,61892,87201,7044,69,Fall,657933,273088,61961,False
2015,10/11,DallasFtWorth,0.81,543166,349743,99900,101828,5967,72,Fall,644994,355710,99972,False
2015,10/04,DallasFtWorth,0.82,491729,439095,50993,107305,15396,82,Fall,599034,454491,51075,False
2015,09/27,DallasFtWorth,0.84,533088,390554,25647,101477,12776,39,Fall,634565,403330,25686,False
2015,09/20,DallasFtWorth,0.77,606586,425539,10973,99272,12833,7,Fall,705858,438372,10980,False
2015,09/13,DallasFtWorth,0.86,564967,494078,9094,119755,24666,22,Fall,684722,518744,9116,False
2015,09/06,DallasFtWorth,0.84,626166,505568,9815,120588,8581,18,Fall,746754,514149,9833,False
2015,08/30,DallasFtWorth,0.82,674670,309275,7468,101093,9171,1,Summer,775763,318446,7469,False
2015,08/23,DallasFtWorth,0.85,679440,321325,8261,102621,8502,20,Summer,782061,329827,8281,False
2015,08/16,DallasFtWorth,0.88,718594,287298,7090,100806,8864,13,Summer,819400,296162,7103,False
2015,08/09,DallasFtWorth,0.85,674531,332173,7793,101618,8139,3,Summer,776149,340312,7796,False
2015,08/02,DallasFtWorth,0.87,705846,253860,4688,91893,11209,0,Summer,797739,265069,4688,False
2015,07/26,DallasFtWorth,0.8,661845,406523,6417,97727,18793,3,Summer,759572,425316,6420,False
2015,07/19,DallasFtWorth,0.82,684455,364124,4970,115942,17379,7,Summer,800397,381503,4977,False
2015,07/12,DallasFtWorth,0.82,713425,319277,4382,102573,4008,779,Summer,815998,323285,5161,False
2015,07/05,DallasFtWorth,0.83,835215,334916,5388,139670,5497,7,Summer,974885,340413,5395,False
2015,06/28,DallasFtWorth,0.77,760374,302577,7191,125900,7499,10,Summer,886274,310076,7201,False
2015,06/21,DallasFtWorth,0.75,755351,375820,8600,134708,9013,8,Summer,890059,384833,8608,False
2015,06/14,DallasFtWorth,0.65,1013252,353165,7557,130578,4187,8,Summer,1143830,357352,7565,False
2015,06/07,DallasFtWorth,0.73,788982,319283,13350,126849,7102,7,Summer,915831,326385,13357,False
2015,05/31,DallasFtWorth,0.68,941838,315653,7287,99456,13421,14,Spring,1041294,329074,7301,False
2015,05/24,DallasFtWorth,0.81,775365,299938,6833,96860,5117,15,Spring,872225,305055,6848,False
2015,05/17,DallasFtWorth,0.73,855871,261026,6382,88480,7628,8,Spring,944351,268654,6390,False
2015,05/10,DallasFtWorth,0.75,817727,357330,7803,107302,8644,17,Spring,925029,365974,7820,False
2015,05/03,DallasFtWorth,0.77,652304,509069,9753,104797,6148,778,Spring,757101,515217,10531,False
2015,04/26,DallasFtWorth,0.81,717960,270228,12091,91505,10463,389,Spring,809465,280691,12480,False
2015,04/19,DallasFtWorth,0.8,735235,284292,16013,89209,13055,5,Spring,824444,297347,16018,False
2015,04/12,DallasFtWorth,0.72,871511,288420,12596,85100,9261,8,Spring,956611,297681,12604,False
2015,04/05,DallasFtWorth,0.77,802917,387745,13592,105522,13748,822,Spring,908439,401493,14414,False
2015,03/29,DallasFtWorth,0.79,645523,396361,13339,95894,13670,19,Spring,741417,410031,13358,False
2015,03/22,DallasFtWorth,0.67,925527,297656,11678,88559,9991,11,Spring,1014086,307647,11689,False
2015,03/15,DallasFtWorth,0.72,726176,368421,14065,90708,11780,7,Spring,816884,380201,14072,False
2015,03/08,DallasFtWorth,0.75,724775,371564,11201,97450,13677,14,Spring,822225,385241,11215,False
2015,03/01,DallasFtWorth,0.82,665032,358628,12398,95284,12675,12,Spring,760316,371303,12410,False
2015,02/22,DallasFtWorth,0.8,695493,305788,12580,85321,17416,0,Winter,780814,323204,12580,False
2015,02/15,DallasFtWorth,0.77,625813,299799,12656,67518,15061,6,Winter,693331,314860,12662,False
2015,02/08,DallasFtWorth,0.67,737968,376914,12106,67959,12176,42,Winter,805927,389090,12148,False
2015,02/01,DallasFtWorth,0.68,786166,495262,18855,79314,11474,16,Winter,865480,506736,18871,False
2015,01/25,DallasFtWorth,0.8,649344,271152,9610,60158,18029,0,Winter,709502,289181,9610,False
2015,01/18,DallasFtWorth,0.76,627090,374230,15550,62375,12416,12,Winter,689465,386646,15562,False
2015,01/11,DallasFtWorth,0.76,680572,348535,11900,67857,19801,25,Winter,748429,368336,11925,False
2015,01/04,DallasFtWorth,0.74,612795,374420,9817,54563,34760,6,Winter,667358,409180,9823,False
2015,12/27,Denver,0.98,93034,246747,19103,38620,227884,85,Winter,131654,474631,19188,False
2015,12/20,Denver,1.05,113403,188263,24477,34993,167806,0,Winter,148396,356069,24477,False
2015,12/13,Denver,0.83,96222,321764,29349,34244,260040,81,Winter,130466,581804,29430,False
2015,12/06,Denver,0.76,111259,378124,8807,35086,304844,103,Winter,146345,682968,8910,False
2015,11/29,Denver,1.12,85241,179982,14146,31920,117819,0,Fall,117161,297801,14146,False
2015,11/22,Denver,0.85,100047,323796,18215,31358,251447,0,Fall,131405,575243,18215,False
2015,11/15,Denver,0.82,98269,428998,20029,36279,342040,0,Fall,134548,771038,20029,False
2015,11/08,Denver,0.93,113964,354454,12294,39635,170279,5,Fall,153599,524733,12299,False
2015,11/01,Denver,0.82,140330,446007,8551,41633,195471,0,Fall,181963,641478,8551,False
2015,10/25,Denver,0.93,106239,393920,11222,39914,183910,0,Fall,146153,577830,11222,False
2015,10/18,Denver,0.87,117059,435491,13693,41688,197487,17,Fall,158747,632978,13710,False
2015,10/11,Denver,0.9,108538,432102,18840,40462,176032,0,Fall,149000,608134,18840,False
2015,10/04,Denver,1.02,101712,364774,27621,41345,143474,7,Fall,143057,508248,27628,False
2015,09/27,Denver,0.97,119089,386987,15285,43108,130401,0,Fall,162197,517388,15285,False
2015,09/20,Denver,0.98,85382,461272,25529,40644,147253,0,Fall,126026,608525,25529,False
2015,09/13,Denver,1.01,115935,451936,17938,47733,101892,0,Fall,163668,553828,17938,False
2015,09/06,Denver,1.09,138154,420365,19090,47833,103601,0,Fall,185987,523966,19090,False
2015,08/30,Denver,1.14,119849,421032,19353,43991,117475,0,Summer,163840,538507,19353,False
2015,08/23,Denver,1.2,135261,318115,21420,45407,77989,0,Summer,180668,396104,21420,False
2015,08/16,Denver,1.17,157630,348863,18154,46710,76789,0,Summer,204340,425652,18154,False
2015,08/09,Denver,1.09,131770,377129,24025,46596,89855,0,Summer,178366,466984,24025,False
2015,08/02,Denver,1.05,153498,423519,16711,45644,88542,0,Summer,199142,512061,16711,False
2015,07/26,Denver,1.18,138942,376355,25777,58753,103843,0,Summer,197695,480198,25777,False
2015,07/19,Denver,1.1,119266,513055,17089,68585,139859,17,Summer,187851,652914,17106,False
2015,07/12,Denver,1.18,123673,423853,22068,66816,101611,910,Summer,190489,525464,22978,False
2015,07/05,Denver,1.19,146171,428389,19546,88349,54456,0,Summer,234520,482845,19546,False
2015,06/28,Denver,1.2,162885,362226,18449,93206,59917,12,Summer,256091,422143,18461,False
2015,06/21,Denver,1.16,184206,405469,12854,83581,44715,0,Summer,267787,450184,12854,False
2015,06/14,Denver,1.16,194447,401133,17694,79508,50222,0,Summer,273955,451355,17694,False
2015,06/07,Denver,1.11,167992,439309,17507,70061,88016,0,Summer,238053,527325,17507,False
2015,05/31,Denver,1.26,127747,365471,18725,52816,35618,0,Spring,180563,401089,18725,False
2015,05/24,Denver,1.16,198187,369924,18817,50060,20603,0,Spring,248247,390527,18817,False
2015,05/17,Denver,1.21,156010,305200,17377,50687,63311,0,Spring,206697,368511,17377,False
2015,05/10,Denver,1.08,148762,454026,16724,49343,66285,2,Spring,198105,520311,16726,False
2015,05/03,Denver,1.01,182975,485743,14810,45163,52803,0,Spring,228138,538546,14810,False
2015,04/26,Denver,1.19,160372,381779,5981,44469,27221,1004,Spring,204841,409000,6985,False
2015,04/19,Denver,1.08,129744,544167,6231,44279,72598,0,Spring,174023,616765,6231,False
2015,04/12,Denver,1.05,176304,574793,8603,42716,56263,0,Spring,219020,631056,8603,False
2015,04/05,Denver,1.19,156966,396449,6308,53589,31483,929,Spring,210555,427932,7237,False
2015,03/29,Denver,1.11,160679,371990,4760,55936,34180,0,Spring,216615,406170,4760,False
2015,03/22,Denver,1.15,131881,380284,8461,47368,35116,0,Spring,179249,415400,8461,False
2015,03/15,Denver,1.03,160422,403060,5122,50621,42905,0,Spring,211043,445965,5122,False
2015,03/08,Denver,1.03,118578,491584,7264,54092,48272,0,Spring,172670,539856,7264,False
2015,03/01,Denver,1.03,101528,487873,5507,38246,37664,0,Spring,139774,525537,5507,False
2015,02/22,Denver,1.0,153410,584093,5686,62564,93534,14,Winter,215974,677627,5700,False
2015,02/15,Denver,1.12,116907,404107,7797,80270,19965,25,Winter,197177,424072,7822,False
2015,02/08,Denver,0.95,153584,466313,5420,92800,48427,30,Winter,246384,514740,5450,False
2015,02/01,Denver,0.93,217715,608156,5736,90555,68006,40,Winter,308270,676162,5776,False
2015,01/25,Denver,1.02,140914,422434,4944,74743,52611,9,Winter,215657,475045,4953,False
2015,01/18,Denver,0.99,151976,500683,4225,77528,73764,16,Winter,229504,574447,4241,False
2015,01/11,Denver,1.09,110974,427723,5357,85793,36703,26,Winter,196767,464426,5383,False
2015,01/04,Denver,0.99,117454,429518,5553,67894,47661,4,Winter,185348,477179,5557,False
2015,12/27,Detroit,1.08,83097,50545,59789,48936,762,12368,Winter,132033,51307,72157,False
2015,12/20,Detroit,1.1,110507,42663,45459,40496,2931,8377,Winter,151003,45594,53836,False
2015,12/13,Detroit,1.05,132206,38088,47788,48318,2843,6342,Winter,180524,40931,54130,False
2015,12/06,Detroit,0.98,92957,78805,113791,30612,885,22744,Winter,123569,79690,136535,False
2015,11/29,Detroit,1.11,84236,38244,63664,31628,920,9733,Fall,115864,39164,73397,False
2015,11/22,Detroit,1.09,95526,55945,63404,47388,1257,7007,Fall,142914,57202,70411,False
2015,11/15,Detroit,1.1,88132,35472,52490,65345,1141,6350,Fall,153477,36613,58840,False
2015,11/08,Detroit,1.03,103367,72647,113928,30614,734,22353,Fall,133981,73381,136281,False
2015,11/01,Detroit,1.04,112432,67252,104529,35176,1106,20249,Fall,147608,68358,124778,False
2015,10/25,Detroit,1.17,84318,49927,74327,30131,727,11902,Fall,114449,50654,86229,False
2015,10/18,Detroit,0.97,117479,97788,72553,63143,823,6354,Fall,180622,98611,78907,False
2015,10/11,Detroit,0.99,110374,105188,72960,68721,1222,3933,Fall,179095,106410,76893,False
2015,10/04,Detroit,1.1,81617,60336,90271,40779,1039,12357,Fall,122396,61375,102628,False
2015,09/27,Detroit,1.17,88573,43702,78776,33816,1081,11521,Fall,122389,44783,90297,False
2015,09/20,Detroit,1.0,129945,71335,111298,38180,839,21946,Fall,168125,72174,133244,False
2015,09/13,Detroit,1.03,151274,73572,106452,51456,1329,17386,Fall,202730,74901,123838,False
2015,09/06,Detroit,1.09,143927,51351,79770,49676,1237,11018,Fall,193603,52588,90788,False
2015,08/30,Detroit,0.96,177827,75478,100520,52515,1066,15355,Summer,230342,76544,115875,False
2015,08/23,Detroit,1.11,114208,36663,61914,45741,2154,7286,Summer,159949,38817,69200,False
2015,08/16,Detroit,0.97,113822,86783,125069,53326,1573,19675,Summer,167148,88356,144744,False
2015,08/09,Detroit,1.07,136799,56896,80145,54938,1471,11038,Summer,191737,58367,91183,False
2015,08/02,Detroit,1.04,157018,58592,76533,63454,1676,7460,Summer,220472,60268,83993,False
2015,07/26,Detroit,0.99,119084,38501,63099,98037,2518,4992,Summer,217121,41019,68091,False
2015,07/19,Detroit,1.04,125844,66223,105281,61402,2038,10040,Summer,187246,68261,115321,False
2015,07/12,Detroit,1.02,127995,36569,62708,76701,1977,4098,Summer,204696,38546,66806,False
2015,07/05,Detroit,1.06,140339,62718,96051,66416,1849,6316,Summer,206755,64567,102367,False
2015,06/28,Detroit,1.0,135230,30175,48618,111301,2126,2300,Summer,246531,32301,50918,False
2015,06/21,Detroit,0.97,133405,87075,121664,70155,2831,9447,Summer,203560,89906,131111,False
2015,06/14,Detroit,1.04,136802,58418,90747,80661,1786,3997,Summer,217463,60204,94744,False
2015,06/07,Detroit,0.97,153214,87106,131114,61921,1180,13275,Summer,215135,88286,144389,False
2015,05/31,Detroit,1.09,162243,28903,53233,74758,797,4464,Spring,237001,29700,57697,False
2015,05/24,Detroit,1.03,193348,34774,46503,94585,715,3318,Spring,287933,35489,49821,False
2015,05/17,Detroit,0.95,214237,98513,116503,53494,591,11815,Spring,267731,99104,128318,False
2015,05/10,Detroit,1.11,177872,42422,48825,87986,1880,1930,Spring,265858,44302,50755,False
2015,05/03,Detroit,1.06,161288,71919,74593,60634,785,5438,Spring,221922,72704,80031,False
2015,04/26,Detroit,1.01,133322,61051,66651,93903,1475,4838,Spring,227225,62526,71489,False
2015,04/19,Detroit,0.96,140434,139016,107930,68265,4057,8939,Spring,208699,143073,116869,False
2015,04/12,Detroit,1.02,96441,24663,43008,101770,2451,2846,Spring,198211,27114,45854,False
2015,04/05,Detroit,1.11,113210,62859,49925,65997,1999,1392,Spring,179207,64858,51317,False
2015,03/29,Detroit,0.97,120782,28182,38352,113016,2415,1298,Spring,233798,30597,39650,False
2015,03/22,Detroit,0.97,138397,109057,144745,44419,754,17997,Spring,182816,109811,162742,False
2015,03/15,Detroit,1.13,107980,31613,48302,62158,1375,3543,Spring,170138,32988,51845,False
2015,03/08,Detroit,1.01,97420,29942,46763,99704,473,4391,Spring,197124,30415,51154,False
2015,03/01,Detroit,0.97,97605,101935,129285,50732,1144,17195,Spring,148337,103079,146480,False
2015,02/22,Detroit,1.15,99207,34703,46471,66789,267,3449,Winter,165996,34970,49920,False
2015,02/15,Detroit,1.16,100594,31170,41639,78474,676,3042,Winter,179068,31846,44681,False
2015,02/08,Detroit,1.11,129910,35996,40515,57777,1023,2972,Winter,187687,37019,43487,False
2015,02/01,Detroit,0.92,205775,136119,127173,54003,688,15989,Winter,259778,136807,143162,False
2015,01/25,Detroit,1.19,110113,47558,45889,69311,1280,3172,Winter,179424,48838,49061,False
2015,01/18,Detroit,1.1,113616,45446,37740,92319,1066,1599,Winter,205935,46512,39339,False
2015,01/11,Detroit,1.08,108378,90104,76985,48639,620,7436,Winter,157017,90724,84421,False
2015,01/04,Detroit,1.01,121634,117865,74062,46679,1060,8391,Winter,168313,118925,82453,False
2015,12/27,GrandRapids,1.13,2992,101109,5754,30738,2919,4199,Winter,33730,104028,9953,False
2015,12/20,GrandRapids,1.13,2630,85259,3211,30547,2288,2324,Winter,33177,87547,5535,False
2015,12/13,GrandRapids,1.24,3809,69582,3264,38257,2231,500,Winter,42066,71813,3764,False
2015,12/06,GrandRapids,0.93,4026,165454,15635,26570,1560,3926,Winter,30596,167014,19561,False
2015,11/29,GrandRapids,1.12,3726,82760,3336,27835,2816,76,Fall,31561,85576,3412,False
2015,11/22,GrandRapids,1.11,3734,94794,5725,33606,2327,791,Fall,37340,97121,6516,False
2015,11/15,GrandRapids,1.2,3490,74695,2506,47301,1427,27,Fall,50791,76122,2533,False
2015,11/08,GrandRapids,0.93,3970,149876,7556,34956,1819,77,Fall,38926,151695,7633,False
2015,11/01,GrandRapids,0.91,3731,147281,8605,43392,1757,823,Fall,47123,149038,9428,False
2015,10/25,GrandRapids,1.14,3899,86434,9431,30487,3036,1631,Fall,34386,89470,11062,False
2015,10/18,GrandRapids,0.94,3821,118521,17329,40257,1830,3046,Fall,44078,120351,20375,False
2015,10/11,GrandRapids,0.97,3638,106363,49279,21799,2155,15532,Fall,25437,108518,64811,False
2015,10/04,GrandRapids,0.99,3241,102316,18103,29446,2198,5014,Fall,32687,104514,23117,False
2015,09/27,GrandRapids,1.15,2977,87274,13024,28888,1913,3770,Fall,31865,89187,16794,False
2015,09/20,GrandRapids,0.88,3612,177686,9651,51686,1815,243,Fall,55298,179501,9894,False
2015,09/13,GrandRapids,0.95,4113,143018,20439,43865,2851,5091,Fall,47978,145869,25530,False
2015,09/06,GrandRapids,1.09,3673,111964,6016,45108,3486,59,Fall,48781,115450,6075,False
2015,08/30,GrandRapids,0.91,3931,152332,16719,48562,2309,3044,Summer,52493,154641,19763,False
2015,08/23,GrandRapids,1.28,4847,72826,5459,40204,4716,626,Summer,45051,77542,6085,False
2015,08/16,GrandRapids,0.89,5134,177609,20395,55316,6674,3771,Summer,60450,184283,24166,False
2015,08/09,GrandRapids,1.08,4807,120579,8389,49559,3294,102,Summer,54366,123873,8491,False
2015,08/02,GrandRapids,1.05,4122,109853,10359,55048,4030,652,Summer,59170,113883,11011,False
2015,07/26,GrandRapids,1.12,3192,66065,9957,69267,4085,1300,Summer,72459,70150,11257,False
2015,07/19,GrandRapids,1.05,2680,122122,29478,52697,3806,4951,Summer,55377,125928,34429,False
2015,07/12,GrandRapids,1.19,4663,66045,9833,66368,4901,1299,Summer,71031,70946,11132,False
2015,07/05,GrandRapids,1.16,2709,109357,34986,44032,5692,6064,Summer,46741,115049,41050,False
2015,06/28,GrandRapids,1.1,3089,55014,9941,80548,5044,2334,Summer,83637,60058,12275,False
2015,06/21,GrandRapids,0.96,2552,167585,32903,53623,4943,3948,Summer,56175,172528,36851,False
2015,06/14,GrandRapids,1.07,4446,116392,4934,67207,4401,5,Summer,71653,120793,4939,False
2015,06/07,GrandRapids,1.14,6926,134230,10407,55432,4067,1535,Summer,62358,138297,11942,False
2015,05/31,GrandRapids,1.31,7097,90411,3360,64208,2794,35,Spring,71305,93205,3395,False
2015,05/24,GrandRapids,1.3,7888,74169,3111,69048,4663,35,Spring,76936,78832,3146,False
2015,05/17,GrandRapids,0.97,5515,202939,12421,52456,3991,178,Spring,57971,206930,12599,False
2015,05/10,GrandRapids,1.36,7383,84947,3817,59129,4335,28,Spring,66512,89282,3845,False
2015,05/03,GrandRapids,1.06,6301,176717,6727,46862,1898,42,Spring,53163,178615,6769,False
2015,04/26,GrandRapids,1.09,4480,105590,6421,68758,4305,52,Spring,73238,109895,6473,False
2015,04/19,GrandRapids,0.93,5547,217323,15023,68697,3761,317,Spring,74244,221084,15340,False
2015,04/12,GrandRapids,1.13,5875,66804,2717,68693,3377,26,Spring,74568,70181,2743,False
2015,04/05,GrandRapids,1.22,4487,92044,5487,50462,5165,73,Spring,54949,97209,5560,False
2015,03/29,GrandRapids,1.11,1977,63600,3003,75725,5299,24,Spring,77702,68899,3027,False
2015,03/22,GrandRapids,0.91,1930,231211,19097,57118,2105,412,Spring,59048,233316,19509,False
2015,03/15,GrandRapids,1.35,1621,69452,4214,45347,3244,15,Spring,46968,72696,4229,False
2015,03/08,GrandRapids,1.08,1783,68592,3903,69329,3169,57,Spring,71112,71761,3960,False
2015,03/01,GrandRapids,0.95,1355,182093,26454,47217,3519,3347,Spring,48572,185612,29801,False
2015,02/22,GrandRapids,1.31,1593,69934,4894,48858,3767,247,Winter,50451,73701,5141,False
2015,02/15,GrandRapids,1.21,1659,67025,4215,57601,6203,56,Winter,59260,73228,4271,False
2015,02/08,GrandRapids,1.24,1155,74113,4855,48150,4209,136,Winter,49305,78322,4991,False
2015,02/01,GrandRapids,0.94,1621,240215,19211,43899,4377,145,Winter,45520,244592,19356,False
2015,01/25,GrandRapids,1.19,1112,78092,6374,54053,4552,116,Winter,55165,82644,6490,False
2015,01/18,GrandRapids,1.07,970,78433,6411,60381,3727,276,Winter,61351,82160,6687,False
2015,01/11,GrandRapids,1.03,972,127984,13798,39193,2896,288,Winter,40165,130880,14086,False
2015,01/04,GrandRapids,0.95,1097,189348,22612,43899,1097,924,Winter,44996,190445,23536,False
2015,12/27,HarrisburgScranton,1.16,22694,98629,149,51396,776,0,Winter,74090,99405,149,False
2015,12/20,HarrisburgScranton,1.11,24111,100758,158,53929,1229,0,Winter,78040,101987,158,False
2015,12/13,HarrisburgScranton,1.14,27053,107144,229,51752,877,0,Winter,78805,108021,229,False
2015,12/06,HarrisburgScranton,1.1,25260,99013,118,46345,458,0,Winter,71605,99471,118,False
2015,11/29,HarrisburgScranton,1.17,23707,82015,110,39640,629,0,Fall,63347,82644,110,False
2015,11/22,HarrisburgScranton,1.16,26601,85742,198,47519,2367,0,Fall,74120,88109,198,False
2015,11/15,HarrisburgScranton,1.09,25483,113515,93,46939,3884,0,Fall,72422,117399,93,False
2015,11/08,HarrisburgScranton,1.09,27837,137670,169,47637,1677,0,Fall,75474,139347,169,False
2015,11/01,HarrisburgScranton,1.13,28916,140625,173,49340,914,0,Fall,78256,141539,173,False
2015,10/25,HarrisburgScranton,1.11,27595,101618,185,52569,1306,0,Fall,80164,102924,185,False
2015,10/18,HarrisburgScranton,0.93,27640,186372,408,48878,923,0,Fall,76518,187295,408,False
2015,10/11,HarrisburgScranton,1.05,32042,137367,267,53610,1791,0,Fall,85652,139158,267,False
2015,10/04,HarrisburgScranton,1.16,32554,95392,323,59227,938,0,Fall,91781,96330,323,False
2015,09/27,HarrisburgScranton,1.15,30410,108385,294,51731,1656,0,Fall,82141,110041,294,False
2015,09/20,HarrisburgScranton,1.17,31925,101200,279,53988,919,0,Fall,85913,102119,279,False
2015,09/13,HarrisburgScranton,1.07,33047,170884,294,48537,1980,0,Fall,81584,172864,294,False
2015,09/06,HarrisburgScranton,1.19,37453,128772,465,57426,1344,32,Fall,94879,130116,497,False
2015,08/30,HarrisburgScranton,1.18,34595,125106,614,57205,1779,606,Summer,91800,126885,1220,False
2015,08/23,HarrisburgScranton,1.1,37213,128402,584,54580,1140,715,Summer,91793,129542,1299,False
2015,08/16,HarrisburgScranton,1.09,37089,161018,402,48581,714,6,Summer,85670,161732,408,False
2015,08/09,HarrisburgScranton,1.07,40320,149595,510,56333,815,0,Summer,96653,150410,510,False
2015,08/02,HarrisburgScranton,1.1,40387,143352,733,56786,1018,3,Summer,97173,144370,736,False
2015,07/26,HarrisburgScranton,1.17,39346,123455,480,60632,1271,41,Summer,99978,124726,521,False
2015,07/19,HarrisburgScranton,1.19,42405,119272,1020,65842,1051,57,Summer,108247,120323,1077,False
2015,07/12,HarrisburgScranton,1.17,42200,119798,2740,67025,1705,168,Summer,109225,121503,2908,False
2015,07/05,HarrisburgScranton,1.19,49829,142250,3215,78409,1623,516,Summer,128238,143873,3731,False
2015,06/28,HarrisburgScranton,1.2,42688,124701,2556,70488,2376,726,Summer,113176,127077,3282,False
2015,06/21,HarrisburgScranton,1.19,44179,128614,3182,76907,1624,922,Summer,121086,130238,4104,False
2015,06/14,HarrisburgScranton,1.13,42766,140403,2028,87952,2821,1606,Summer,130718,143224,3634,False
2015,06/07,HarrisburgScranton,1.21,40587,138950,675,81417,3219,787,Summer,122004,142169,1462,False
2015,05/31,HarrisburgScranton,1.22,42572,125281,804,87880,2341,1177,Spring,130452,127622,1981,False
2015,05/24,HarrisburgScranton,1.21,43499,132429,777,89913,2641,834,Spring,133412,135070,1611,False
2015,05/17,HarrisburgScranton,1.19,44842,120942,487,85065,1400,105,Spring,129907,122342,592,False
2015,05/10,HarrisburgScranton,1.19,53021,158314,585,85161,2065,0,Spring,138182,160379,585,False
2015,05/03,HarrisburgScranton,1.17,46183,130134,527,76930,2137,0,Spring,123113,132271,527,False
2015,04/26,HarrisburgScranton,1.21,45102,118533,415,68210,2022,37,Spring,113312,120555,452,False
2015,04/19,HarrisburgScranton,1.17,45693,112023,501,77244,1965,0,Spring,122937,113988,501,False
2015,04/12,HarrisburgScranton,1.18,35513,101051,400,62948,1630,0,Spring,98461,102681,400,False
2015,04/05,HarrisburgScranton,1.21,35705,112157,485,66320,1643,63,Spring,102025,113800,548,False
2015,03/29,HarrisburgScranton,1.14,31891,102587,418,61035,1349,0,Spring,92926,103936,418,False
2015,03/22,HarrisburgScranton,1.08,28701,129731,481,57777,2457,0,Spring,86478,132188,481,False
2015,03/15,HarrisburgScranton,1.2,31225,84433,470,72181,2448,0,Spring,103406,86881,470,False
2015,03/08,HarrisburgScranton,1.15,38517,75750,334,75825,1850,0,Spring,114342,77600,334,False
2015,03/01,HarrisburgScranton,1.07,28899,134019,614,65870,1508,0,Spring,94769,135527,614,False
2015,02/22,HarrisburgScranton,1.2,32241,83702,506,73386,1203,0,Winter,105627,84905,506,False
2015,02/15,HarrisburgScranton,1.22,28592,85311,503,72146,1118,0,Winter,100738,86429,503,False
2015,02/08,HarrisburgScranton,1.02,35933,126557,722,75408,1134,0,Winter,111341,127691,722,False
2015,02/01,HarrisburgScranton,1.06,42732,168621,851,69529,1403,0,Winter,112261,170024,851,False
2015,01/25,HarrisburgScranton,1.17,33193,89075,426,79720,3658,0,Winter,112913,92733,426,False
2015,01/18,HarrisburgScranton,1.24,30928,85410,535,64180,1549,0,Winter,95108,86959,535,False
2015,01/11,HarrisburgScranton,1.26,34535,78778,582,63840,998,0,Winter,98375,79776,582,False
2015,01/04,HarrisburgScranton,1.05,32679,121020,1286,47583,1368,0,Winter,80262,122388,1286,False
2015,12/27,HartfordSpringfield,1.27,4427,194438,169,43577,944,0,Winter,48004,195382,169,False
2015,12/20,HartfordSpringfield,1.18,4806,212205,184,45981,977,0,Winter,50787,213182,184,False
2015,12/13,HartfordSpringfield,1.24,4439,186550,332,46493,741,0,Winter,50932,187291,332,False
2015,12/06,HartfordSpringfield,1.19,4269,199395,192,35448,639,0,Winter,39717,200034,192,False
2015,11/29,HartfordSpringfield,1.32,3572,172790,169,36423,675,0,Fall,39995,173465,169,False
2015,11/22,HartfordSpringfield,1.27,3720,176358,319,30800,893,0,Fall,34520,177251,319,False
2015,11/15,HartfordSpringfield,1.12,4680,228183,197,40290,1866,0,Fall,44970,230049,197,False
2015,11/08,HartfordSpringfield,1.16,5048,260745,171,37770,5449,0,Fall,42818,266194,171,False
2015,11/01,HartfordSpringfield,1.16,4471,271817,288,44831,4658,0,Fall,49302,276475,288,False
2015,10/25,HartfordSpringfield,1.2,3444,183080,300,43920,3615,0,Fall,47364,186695,300,False
2015,10/18,HartfordSpringfield,0.93,4980,357183,594,42004,3104,0,Fall,46984,360287,594,False
2015,10/11,HartfordSpringfield,1.38,4555,206738,491,49064,3378,0,Fall,53619,210116,491,False
2015,10/04,HartfordSpringfield,1.3,5369,205512,287,46352,5116,0,Fall,51721,210628,287,False
2015,09/27,HartfordSpringfield,1.29,3978,196807,248,42271,3834,0,Fall,46249,200641,248,False
2015,09/20,HartfordSpringfield,1.25,3716,179938,270,52877,4729,0,Fall,56593,184667,270,False
2015,09/13,HartfordSpringfield,1.11,4326,283221,206,47929,5492,0,Fall,52255,288713,206,False
2015,09/06,HartfordSpringfield,1.27,3976,221997,497,52839,1945,0,Fall,56815,223942,497,False
2015,08/30,HartfordSpringfield,1.26,3882,241162,593,46616,572,0,Summer,50498,241734,593,False
2015,08/23,HartfordSpringfield,1.14,4337,248478,422,44345,909,0,Summer,48682,249387,422,False
2015,08/16,HartfordSpringfield,1.12,4402,292976,886,51496,1311,0,Summer,55898,294287,886,False
2015,08/09,HartfordSpringfield,1.12,4619,292318,706,55625,1220,0,Summer,60244,293538,706,False
2015,08/02,HartfordSpringfield,1.16,4543,268797,1283,47631,1192,0,Summer,52174,269989,1283,False
2015,07/26,HartfordSpringfield,1.3,3579,205203,2171,52815,2279,0,Summer,56394,207482,2171,False
2015,07/19,HartfordSpringfield,1.32,3759,189919,5496,56769,2294,0,Summer,60528,192213,5496,False
2015,07/12,HartfordSpringfield,1.06,4947,299937,11286,71429,2181,0,Summer,76376,302118,11286,False
2015,07/05,HartfordSpringfield,1.25,4847,250696,11793,67565,4161,0,Summer,72412,254857,11793,False
2015,06/28,HartfordSpringfield,1.27,4253,226699,9682,60622,3365,0,Summer,64875,230064,9682,False
2015,06/21,HartfordSpringfield,1.25,4030,258200,10100,67505,1792,0,Summer,71535,259992,10100,False
2015,06/14,HartfordSpringfield,1.15,4926,253423,6839,69607,3239,0,Summer,74533,256662,6839,False
2015,06/07,HartfordSpringfield,1.29,4435,281285,219,66052,1481,0,Summer,70487,282766,219,False
2015,05/31,HartfordSpringfield,1.33,4974,237651,142,74809,1925,0,Spring,79783,239576,142,False
2015,05/24,HartfordSpringfield,1.34,4532,229800,177,78505,1915,0,Spring,83037,231715,177,False
2015,05/17,HartfordSpringfield,1.2,4623,281567,249,69888,2424,0,Spring,74511,283991,249,False
2015,05/10,HartfordSpringfield,1.25,5262,288462,390,73455,3352,0,Spring,78717,291814,390,False
2015,05/03,HartfordSpringfield,1.25,4005,255378,539,66957,2709,0,Spring,70962,258087,539,False
2015,04/26,HartfordSpringfield,1.36,4159,206008,229,64008,2693,77,Spring,68167,208701,306,False
2015,04/19,HartfordSpringfield,1.35,3625,196720,175,66844,3833,0,Spring,70469,200553,175,False
2015,04/12,HartfordSpringfield,1.25,3432,182584,133,63103,1829,0,Spring,66535,184413,133,False
2015,04/05,HartfordSpringfield,1.33,4021,183801,194,56550,2399,0,Spring,60571,186200,194,False
2015,03/29,HartfordSpringfield,1.22,3980,184277,217,50509,2509,0,Spring,54489,186786,217,False
2015,03/22,HartfordSpringfield,1.11,5900,230143,139,53990,2646,0,Spring,59890,232789,139,False
2015,03/15,HartfordSpringfield,1.4,6740,150490,160,65306,3063,0,Spring,72046,153553,160,False
2015,03/08,HartfordSpringfield,1.43,3253,125712,145,77718,3545,0,Spring,80971,129257,145,False
2015,03/01,HartfordSpringfield,1.12,4547,250129,271,57600,2367,0,Spring,62147,252496,271,False
2015,02/22,HartfordSpringfield,1.38,3632,142741,285,71330,2220,0,Winter,74962,144961,285,False
2015,02/15,HartfordSpringfield,1.39,3681,138690,216,79026,1555,0,Winter,82707,140245,216,False
2015,02/08,HartfordSpringfield,1.09,6791,289098,215,65594,2872,0,Winter,72385,291970,215,False
2015,02/01,HartfordSpringfield,1.32,4803,216923,364,72234,3643,0,Winter,77037,220566,364,False
2015,01/25,HartfordSpringfield,1.35,4305,150044,231,79402,7189,0,Winter,83707,157233,231,False
2015,01/18,HartfordSpringfield,1.39,3347,160683,286,62671,2226,0,Winter,66018,162909,286,False
2015,01/11,HartfordSpringfield,1.38,4365,143001,223,83319,1730,0,Winter,87684,144731,223,False
2015,01/04,HartfordSpringfield,1.06,6387,267593,165,55401,2660,0,Winter,61788,270253,165,False
2015,12/27,Houston,0.78,389773,288003,126150,73711,36493,30373,Winter,463484,324496,156523,False
2015,12/20,Houston,0.75,382444,278067,127372,72198,31520,30753,Winter,454642,309587,158125,False
2015,12/13,Houston,0.73,412187,386865,81450,69011,48622,616,Winter,481198,435487,82066,False
2015,12/06,Houston,0.74,368528,490805,7041,61020,62281,0,Winter,429548,553086,7041,False
2015,11/29,Houston,0.79,391616,289533,4334,67880,29860,0,Fall,459496,319393,4334,False
2015,11/22,Houston,0.73,402191,391110,6924,70785,41991,0,Fall,472976,433101,6924,False
2015,11/15,Houston,0.72,530464,332541,4611,62414,68770,0,Fall,592878,401311,4611,False
2015,11/08,Houston,0.75,427828,411365,20404,56573,67737,0,Fall,484401,479102,20404,False
2015,11/01,Houston,0.77,395945,365506,111263,56198,78892,0,Fall,452143,444398,111263,False
2015,10/25,Houston,0.88,437329,313129,81274,57577,44260,51,Fall,494906,357389,81325,False
2015,10/18,Houston,0.9,436132,242842,80895,59835,28107,0,Fall,495967,270949,80895,False
2015,10/11,Houston,0.79,410949,385629,126765,62638,50286,0,Fall,473587,435915,126765,False
2015,10/04,Houston,0.82,411727,435388,43558,59751,68859,0,Fall,471478,504247,43558,False
2015,09/27,Houston,0.86,383218,458982,16780,61098,48907,0,Fall,444316,507889,16780,False
2015,09/20,Houston,0.83,417701,445473,6959,55198,41895,0,Fall,472899,487368,6959,False
2015,09/13,Houston,0.89,421533,540499,5559,55636,72560,0,Fall,477169,613059,5559,False
2015,09/06,Houston,0.89,460377,495487,6230,63724,64673,0,Fall,524101,560160,6230,False
2015,08/30,Houston,0.88,559048,260761,4514,72264,29536,0,Summer,631312,290297,4514,False
2015,08/23,Houston,0.89,509472,321616,4323,62733,35020,0,Summer,572205,356636,4323,False
2015,08/16,Houston,0.92,565965,297434,3479,65764,36255,0,Summer,631729,333689,3479,False
2015,08/09,Houston,0.92,474778,356592,5288,62834,35656,0,Summer,537612,392248,5288,False
2015,08/02,Houston,0.9,568694,281941,3494,60782,33213,0,Summer,629476,315154,3494,False
2015,07/26,Houston,0.79,522819,443177,5096,69845,45801,0,Summer,592664,488978,5096,False
2015,07/19,Houston,0.78,517797,424786,4233,73695,72912,0,Summer,591492,497698,4233,False
2015,07/12,Houston,0.79,559622,307628,3226,71467,57474,188,Summer,631089,365102,3414,False
2015,07/05,Houston,0.79,652959,371700,3957,98660,46540,0,Summer,751619,418240,3957,False
2015,06/28,Houston,0.74,613485,337700,1935,87444,95348,0,Summer,700929,433048,1935,False
2015,06/21,Houston,0.74,578767,449584,2227,84406,81134,0,Summer,663173,530718,2227,False
2015,06/14,Houston,0.62,924661,439063,4700,85200,79784,0,Summer,1009861,518847,4700,False
2015,06/07,Houston,0.72,675888,364707,3899,72504,55177,0,Summer,748392,419884,3899,False
2015,05/31,Houston,0.72,757230,383626,2927,53981,65166,0,Spring,811211,448792,2927,False
2015,05/24,Houston,0.83,662438,324447,5151,58142,39498,0,Spring,720580,363945,5151,False
2015,05/17,Houston,0.82,676510,263395,3241,47881,34630,0,Spring,724391,298025,3241,False
2015,05/10,Houston,0.76,654227,424395,3776,49686,69586,0,Spring,703913,493981,3776,False
2015,05/03,Houston,0.74,651055,502617,4521,55875,82238,0,Spring,706930,584855,4521,False
2015,04/26,Houston,0.79,689172,295785,5527,58557,33188,0,Spring,747729,328973,5527,False
2015,04/19,Houston,0.82,566197,250464,3898,78217,34255,0,Spring,644414,284719,3898,False
2015,04/12,Houston,0.79,631292,353794,3936,97144,9907,0,Spring,728436,363701,3936,False
2015,04/05,Houston,0.83,608887,496479,4878,132586,6814,0,Spring,741473,503293,4878,False
2015,03/29,Houston,0.79,502389,480447,4633,122988,5767,0,Spring,625377,486214,4633,False
2015,03/22,Houston,0.8,514614,393974,5199,71977,50897,0,Spring,586591,444871,5199,False
2015,03/15,Houston,0.77,526390,401259,5000,62352,48169,0,Spring,588742,449428,5000,False
2015,03/08,Houston,0.78,507328,517669,5321,60498,75236,0,Spring,567826,592905,5321,False
2015,03/01,Houston,0.87,481279,391780,4149,63264,50854,0,Spring,544543,442634,4149,False
2015,02/22,Houston,0.82,520034,346617,6532,73227,32395,0,Winter,593261,379012,6532,False
2015,02/15,Houston,0.73,571823,364817,5598,83840,36308,0,Winter,655663,401125,5598,False
2015,02/08,Houston,0.7,525259,535768,5175,103507,11011,0,Winter,628766,546779,5175,False
2015,02/01,Houston,0.72,540024,597855,8063,86145,48275,0,Winter,626169,646130,8063,False
2015,01/25,Houston,0.77,549415,309974,4231,95546,24742,0,Winter,644961,334716,4231,False
2015,01/18,Houston,0.77,458532,429687,9353,107320,12960,0,Winter,565852,442647,9353,False
2015,01/11,Houston,0.78,463272,441785,4094,126995,25923,0,Winter,590267,467708,4094,False
2015,01/04,Houston,0.71,506426,436347,4378,90299,25537,0,Winter,596725,461884,4378,False
2015,12/27,Indianapolis,1.04,4647,69384,11206,20644,11524,5688,Winter,25291,80908,16894,False
2015,12/20,Indianapolis,1.1,3702,67983,9327,18144,12133,5061,Winter,21846,80116,14388,False
2015,12/13,Indianapolis,1.03,4904,69984,11398,21259,15580,2215,Winter,26163,85564,13613,False
2015,12/06,Indianapolis,0.92,4067,89452,13570,19365,17733,1550,Winter,23432,107185,15120,False
2015,11/29,Indianapolis,1.08,3079,65254,10854,17455,9975,1825,Fall,20534,75229,12679,False
2015,11/22,Indianapolis,1.11,3979,68939,9639,20313,11041,1470,Fall,24292,79980,11109,False
2015,11/15,Indianapolis,1.08,3478,71346,12795,22294,11753,2550,Fall,25772,83099,15345,False
2015,11/08,Indianapolis,0.96,4337,84844,20220,19246,15189,3961,Fall,23583,100033,24181,False
2015,11/01,Indianapolis,1.01,5224,84968,16933,20800,16206,3327,Fall,26024,101174,20260,False
2015,10/25,Indianapolis,1.02,4333,89943,16586,18548,19394,2752,Fall,22881,109337,19338,False
2015,10/18,Indianapolis,0.97,4397,102117,12142,24129,15546,1129,Fall,28526,117663,13271,False
2015,10/11,Indianapolis,1.1,4270,75604,13860,21300,11566,2246,Fall,25570,87170,16106,False
2015,10/04,Indianapolis,0.98,3645,87385,13528,18727,14546,1844,Fall,22372,101931,15372,False
2015,09/27,Indianapolis,1.04,2961,85578,16176,19742,12078,2954,Fall,22703,97656,19130,False
2015,09/20,Indianapolis,0.91,3942,116683,24166,18045,18135,4988,Fall,21987,134818,29154,False
2015,09/13,Indianapolis,0.87,3668,130327,17967,22010,24284,3361,Fall,25678,154611,21328,False
2015,09/06,Indianapolis,1.11,3361,92568,16662,25163,15845,3006,Fall,28524,108413,19668,False
2015,08/30,Indianapolis,1.17,3709,86767,15531,23305,15000,2752,Summer,27014,101767,18283,False
2015,08/23,Indianapolis,1.22,4293,77251,10288,23701,14786,1614,Summer,27994,92037,11902,False
2015,08/16,Indianapolis,1.14,5270,90141,20017,23010,17605,4014,Summer,28280,107746,24031,False
2015,08/09,Indianapolis,1.2,3553,91631,12389,24883,14289,1637,Summer,28436,105920,14026,False
2015,08/02,Indianapolis,1.21,3914,94006,13847,22812,14978,2324,Summer,26726,108984,16171,False
2015,07/26,Indianapolis,1.22,3840,84797,7897,27526,19119,1296,Summer,31366,103916,9193,False
2015,07/19,Indianapolis,1.07,4866,101983,15100,25201,18741,2270,Summer,30067,120724,17370,False
2015,07/12,Indianapolis,1.05,4181,101947,7053,27061,20240,948,Summer,31242,122187,8001,False
2015,07/05,Indianapolis,1.05,4890,119457,13495,30631,21037,1204,Summer,35521,140494,14699,False
2015,06/28,Indianapolis,0.95,5514,121148,9267,34863,26114,1358,Summer,40377,147262,10625,False
2015,06/21,Indianapolis,1.03,7214,124628,14564,33861,23155,1776,Summer,41075,147783,16340,False
2015,06/14,Indianapolis,1.15,10382,97079,13744,33478,17581,1279,Summer,43860,114660,15023,False
2015,06/07,Indianapolis,1.28,16121,80781,10648,30541,15866,1770,Summer,46662,96647,12418,False
2015,05/31,Indianapolis,1.37,13199,80053,6630,26714,15126,1092,Spring,39913,95179,7722,False
2015,05/24,Indianapolis,1.29,19662,92856,14814,26023,12630,2811,Spring,45685,105486,17625,False
2015,05/17,Indianapolis,1.26,18666,89510,16162,21260,16314,2162,Spring,39926,105824,18324,False
2015,05/10,Indianapolis,1.06,16899,127193,5271,23578,22228,361,Spring,40477,149421,5632,False
2015,05/03,Indianapolis,1.13,18025,113204,7488,21559,17453,1158,Spring,39584,130657,8646,False
2015,04/26,Indianapolis,1.24,12319,88398,16641,23192,14397,3551,Spring,35511,102795,20192,False
2015,04/19,Indianapolis,1.08,12091,106308,10136,35778,13533,1253,Spring,47869,119841,11389,False
2015,04/12,Indianapolis,1.15,13496,86722,2457,33143,10414,187,Spring,46639,97136,2644,False
2015,04/05,Indianapolis,1.17,12623,95213,2843,33761,6720,96,Spring,46384,101933,2939,False
2015,03/29,Indianapolis,1.09,5382,97691,8095,37465,11727,925,Spring,42847,109418,9020,False
2015,03/22,Indianapolis,1.11,3961,102319,15542,19721,16305,2708,Spring,23682,118624,18250,False
2015,03/15,Indianapolis,1.21,4942,88080,5551,24140,16954,818,Spring,29082,105034,6369,False
2015,03/08,Indianapolis,1.07,6082,97697,10846,27937,15551,2322,Spring,34019,113248,13168,False
2015,03/01,Indianapolis,1.13,4876,110740,14372,22401,14728,2436,Spring,27277,125468,16808,False
2015,02/22,Indianapolis,1.34,4269,80442,5161,22828,13884,913,Winter,27097,94326,6074,False
2015,02/15,Indianapolis,1.3,5833,75495,4664,22442,12428,903,Winter,28275,87923,5567,False
2015,02/08,Indianapolis,0.98,7650,109166,8455,18968,12562,1988,Winter,26618,121728,10443,False
2015,02/01,Indianapolis,0.92,7245,181784,14761,20669,18130,2760,Winter,27914,199914,17521,False
2015,01/25,Indianapolis,1.06,3642,108152,724,21963,14952,38,Winter,25605,123104,762,False
2015,01/18,Indianapolis,1.14,2910,103890,2048,22405,17913,149,Winter,25315,121803,2197,False
2015,01/11,Indianapolis,1.25,3024,100509,1771,18466,14765,78,Winter,21490,115274,1849,False
2015,01/04,Indianapolis,1.02,4007,118435,1201,20325,16160,0,Winter,24332,134595,1201,False
2015,12/27,Jacksonville,0.99,91470,7688,514,15300,18008,0,Winter,106770,25696,514,False
2015,12/20,Jacksonville,1.19,63053,6544,241,16151,9940,5,Winter,79204,16484,246,False
2015,12/13,Jacksonville,0.96,100533,8913,199,11312,19064,13,Winter,111845,27977,212,False
2015,12/06,Jacksonville,1.19,65041,7716,703,8770,11105,0,Winter,73811,18821,703,False
2015,11/29,Jacksonville,0.96,85341,7840,266,7638,20149,0,Fall,92979,27989,266,False
2015,11/22,Jacksonville,0.98,77130,8054,301,10738,19075,0,Fall,87868,27129,301,False
2015,11/15,Jacksonville,1.25,57764,7319,998,12498,12406,10,Fall,70262,19725,1008,False
2015,11/08,Jacksonville,1.25,62219,7707,411,12761,11395,0,Fall,74980,19102,411,False
2015,11/01,Jacksonville,0.97,110439,11892,995,14379,24853,0,Fall,124818,36745,995,False
2015,10/25,Jacksonville,1.22,61125,8956,796,19339,7878,0,Fall,80464,16834,796,False
2015,10/18,Jacksonville,1.25,57713,9666,834,14116,10269,0,Fall,71829,19935,834,False
2015,10/11,Jacksonville,0.99,93556,12101,1201,14261,20754,0,Fall,107817,32855,1201,False
2015,10/04,Jacksonville,0.99,102479,13922,537,14925,21281,0,Fall,117404,35203,537,False
2015,09/27,Jacksonville,1.27,52301,14641,1047,14588,9746,0,Fall,66889,24387,1047,False
2015,09/20,Jacksonville,0.99,97864,21665,447,17060,20649,0,Fall,114924,42314,447,False
2015,09/13,Jacksonville,1.24,55192,19471,461,18430,9314,0,Fall,73622,28785,461,False
2015,09/06,Jacksonville,0.98,109912,23440,1561,20609,24313,0,Fall,130521,47753,1561,False
2015,08/30,Jacksonville,1.26,64015,19572,657,20460,11403,0,Summer,84475,30975,657,False
2015,08/23,Jacksonville,1.25,60641,19269,731,20588,10594,0,Summer,81229,29863,731,False
2015,08/16,Jacksonville,1.25,60507,16156,697,19619,10514,27,Summer,80126,26670,724,False
2015,08/09,Jacksonville,0.99,121358,22750,668,21556,22386,0,Summer,142914,45136,668,False
2015,08/02,Jacksonville,1.24,63302,19717,759,19135,9417,0,Summer,82437,29134,759,False
2015,07/26,Jacksonville,1.25,69032,19637,619,18522,5186,0,Summer,87554,24823,619,False
2015,07/19,Jacksonville,1.0,111744,24068,647,17718,19561,0,Summer,129462,43629,647,False
2015,07/12,Jacksonville,1.22,62590,18465,584,19289,10035,0,Summer,81879,28500,584,False
2015,07/05,Jacksonville,0.95,132207,27446,1193,31922,19191,0,Summer,164129,46637,1193,False
2015,06/28,Jacksonville,1.16,78066,19522,866,29903,7380,0,Summer,107969,26902,866,False
2015,06/21,Jacksonville,0.95,118742,23814,1147,26218,22189,0,Summer,144960,46003,1147,False
2015,06/14,Jacksonville,1.2,72175,13979,2356,30968,10045,0,Summer,103143,24024,2356,False
2015,06/07,Jacksonville,0.98,132109,13656,710,24338,19581,0,Summer,156447,33237,710,False
2015,05/31,Jacksonville,1.24,86553,7980,615,22617,10338,0,Spring,109170,18318,615,False
2015,05/24,Jacksonville,1.0,139484,13258,1049,20782,20835,0,Spring,160266,34093,1049,False
2015,05/17,Jacksonville,1.22,81751,8351,524,19947,10355,0,Spring,101698,18706,524,False
2015,05/10,Jacksonville,1.24,85005,8543,625,22038,9392,0,Spring,107043,17935,625,False
2015,05/03,Jacksonville,0.96,185046,16450,1347,25088,26430,150,Spring,210134,42880,1497,False
2015,04/26,Jacksonville,1.21,87231,9218,595,21798,9094,0,Spring,109029,18312,595,False
2015,04/19,Jacksonville,1.17,81015,8893,650,24494,9742,0,Spring,105509,18635,650,False
2015,04/12,Jacksonville,0.99,132039,13392,645,17504,17389,0,Spring,149543,30781,645,False
2015,04/05,Jacksonville,1.1,105691,11012,848,16686,12506,0,Spring,122377,23518,848,False
2015,03/29,Jacksonville,1.2,74529,8432,861,17583,7642,0,Spring,92112,16074,861,False
2015,03/22,Jacksonville,0.96,136390,13642,613,19581,15341,0,Spring,155971,28983,613,False
2015,03/15,Jacksonville,1.27,76237,8987,999,17130,6772,0,Spring,93367,15759,999,False
2015,03/08,Jacksonville,1.24,77300,8997,745,19549,5894,0,Spring,96849,14891,745,False
2015,03/01,Jacksonville,1.01,121358,13685,570,17059,14580,0,Spring,138417,28265,570,False
2015,02/22,Jacksonville,1.1,79840,10684,1447,21773,7302,0,Winter,101613,17986,1447,False
2015,02/15,Jacksonville,1.24,70695,9457,595,15354,9073,0,Winter,86049,18530,595,False
2015,02/08,Jacksonville,1.21,62181,9886,375,11016,8380,0,Winter,73197,18266,375,False
2015,02/01,Jacksonville,0.92,171139,22525,1299,20816,22129,0,Winter,191955,44654,1299,False
2015,01/25,Jacksonville,1.2,66985,14505,523,16753,11172,0,Winter,83738,25677,523,False
2015,01/18,Jacksonville,1.27,57479,16442,513,14684,10376,0,Winter,72163,26818,513,False
2015,01/11,Jacksonville,1.2,57635,17025,529,14862,9703,0,Winter,72497,26728,529,False
2015,01/04,Jacksonville,0.97,105203,19147,468,13653,15033,0,Winter,118856,34180,468,False
2015,12/27,LasVegas,0.83,135799,93317,4977,34675,23936,0,Winter,170474,117253,4977,False
2015,12/20,LasVegas,0.96,96355,77086,4749,34992,19110,0,Winter,131347,96196,4749,False
2015,12/13,LasVegas,0.95,101042,68490,4942,33834,7809,0,Winter,134876,76299,4942,False
2015,12/06,LasVegas,0.89,94777,107758,10794,30201,492,0,Winter,124978,108250,10794,False
2015,11/29,LasVegas,0.95,88653,81160,5227,29475,959,0,Fall,118128,82119,5227,False
2015,11/22,LasVegas,0.98,87241,91574,3926,31653,1587,0,Fall,118894,93161,3926,False
2015,11/15,LasVegas,0.95,100856,106817,4614,33636,1870,0,Fall,134492,108687,4614,False
2015,11/08,LasVegas,0.92,119810,74648,5456,36573,759,0,Fall,156383,75407,5456,False
2015,11/01,LasVegas,0.99,87202,94900,12912,34277,1121,0,Fall,121479,96021,12912,False
2015,10/25,LasVegas,0.98,79873,115618,14217,33684,1774,0,Fall,113557,117392,14217,False
2015,10/18,LasVegas,0.91,108979,126743,4681,37274,1685,0,Fall,146253,128428,4681,False
2015,10/11,LasVegas,0.94,62866,155590,13357,33903,2990,0,Fall,96769,158580,13357,False
2015,10/04,LasVegas,0.97,69916,154943,5551,30931,7727,0,Fall,100847,162670,5551,False
2015,09/27,LasVegas,0.97,63209,170341,4057,31037,4279,0,Fall,94246,174620,4057,False
2015,09/20,LasVegas,0.97,70945,163822,5225,35941,8313,0,Fall,106886,172135,5225,False
2015,09/13,LasVegas,0.88,82171,179103,11064,31703,42952,0,Fall,113874,222055,11064,False
2015,09/06,LasVegas,1.02,123361,128141,7149,38692,13779,0,Fall,162053,141920,7149,False
2015,08/30,LasVegas,1.09,114660,124423,6958,37518,747,0,Summer,152178,125170,6958,False
2015,08/23,LasVegas,1.06,131414,84541,4561,38541,2024,0,Summer,169955,86565,4561,False
2015,08/16,LasVegas,0.96,110442,136169,7799,48127,12236,0,Summer,158569,148405,7799,False
2015,08/09,LasVegas,0.96,117882,163299,8925,41697,21312,0,Summer,159579,184611,8925,False
2015,08/02,LasVegas,1.09,137413,79606,6250,38914,10254,0,Summer,176327,89860,6250,False
2015,07/26,LasVegas,1.06,137702,75823,8654,41514,8571,0,Summer,179216,84394,8654,False
2015,07/19,LasVegas,1.03,131325,78566,5011,44134,10604,0,Summer,175459,89170,5011,False
2015,07/12,LasVegas,1.02,136319,83225,5024,41822,11436,0,Summer,178141,94661,5024,False
2015,07/05,LasVegas,1.05,147937,100709,6281,63540,14266,0,Summer,211477,114975,6281,False
2015,06/28,LasVegas,1.01,138921,86492,4334,52651,11008,0,Summer,191572,97500,4334,False
2015,06/21,LasVegas,0.9,128876,126683,4219,58695,20164,0,Summer,187571,146847,4219,False
2015,06/14,LasVegas,0.88,145932,161219,3768,45747,32931,0,Summer,191679,194150,3768,False
2015,06/07,LasVegas,1.02,146782,112611,5234,47209,23856,0,Summer,193991,136467,5234,False
2015,05/31,LasVegas,1.03,134269,84841,8253,41385,16991,0,Spring,175654,101832,8253,False
2015,05/24,LasVegas,0.98,152869,83857,4566,40849,10916,0,Spring,193718,94773,4566,False
2015,05/17,LasVegas,0.95,144311,84178,3609,34337,13406,0,Spring,178648,97584,3609,False
2015,05/10,LasVegas,0.98,148053,117101,4266,36501,19162,0,Spring,184554,136263,4266,False
2015,05/03,LasVegas,0.94,146068,188533,6101,37775,28362,0,Spring,183843,216895,6101,False
2015,04/26,LasVegas,0.88,133307,132942,5032,39250,24170,15,Spring,172557,157112,5047,False
2015,04/19,LasVegas,0.82,206745,66506,7618,34413,21237,0,Spring,241158,87743,7618,False
2015,04/12,LasVegas,0.76,245368,69484,4229,32104,18629,0,Spring,277472,88113,4229,False
2015,04/05,LasVegas,0.81,226614,76597,6194,38773,12176,0,Spring,265387,88773,6194,False
2015,03/29,LasVegas,0.84,194240,104621,7463,39098,8624,0,Spring,233338,113245,7463,False
2015,03/22,LasVegas,0.9,151597,115109,5684,38187,650,0,Spring,189784,115759,5684,False
2015,03/15,LasVegas,1.07,112120,108345,5897,34915,371,0,Spring,147035,108716,5897,False
2015,03/08,LasVegas,1.01,114868,132275,5339,38263,299,0,Spring,153131,132574,5339,False
2015,03/01,LasVegas,1.05,92829,151163,12440,35745,857,0,Spring,128574,152020,12440,False
2015,02/22,LasVegas,1.16,98669,103066,4731,36112,152,0,Winter,134781,103218,4731,False
2015,02/15,LasVegas,1.12,101363,111729,3869,38196,306,0,Winter,139559,112035,3869,False
2015,02/08,LasVegas,1.01,108258,162192,4610,42743,964,0,Winter,151001,163156,4610,False
2015,02/01,LasVegas,0.94,144461,185057,4255,35205,1243,0,Winter,179666,186300,4255,False
2015,01/25,LasVegas,1.06,114584,98937,3874,31833,279,0,Winter,146417,99216,3874,False
2015,01/18,LasVegas,1.06,100191,94930,4887,32897,277,0,Winter,133088,95207,4887,False
2015,01/11,LasVegas,0.93,126092,101653,9591,36874,269,0,Winter,162966,101922,9591,False
2015,01/04,LasVegas,0.8,134003,120628,4591,58126,512,0,Winter,192129,121140,4591,False
2015,12/27,LosAngeles,0.8,976982,455203,86202,722787,74359,11407,Winter,1699769,529562,97609,False
2015,12/20,LosAngeles,0.85,870581,396515,96111,681332,94921,10409,Winter,1551913,491436,106520,False
2015,12/13,LosAngeles,0.74,1072331,456120,67975,962784,123270,7813,Winter,2035115,579390,75788,False
2015,12/06,LosAngeles,0.66,1204232,682692,64728,997845,92324,6467,Winter,2202077,775016,71195,False
2015,11/29,LosAngeles,0.83,833468,501667,70943,681435,61342,7151,Fall,1514903,563009,78094,False
2015,11/22,LosAngeles,0.81,886079,558302,75963,676325,64489,6914,Fall,1562404,622791,82877,False
2015,11/15,LosAngeles,0.74,1281378,661936,70734,763322,44152,6837,Fall,2044700,706088,77571,False
2015,11/08,LosAngeles,0.84,1314856,702841,75385,492713,29335,5946,Fall,1807569,732176,81331,False
2015,11/01,LosAngeles,0.89,1232603,914725,74252,378048,13371,4805,Fall,1610651,928096,79057,False
2015,10/25,LosAngeles,0.95,974251,925306,78774,341731,3774,3796,Fall,1315982,929080,82570,False
2015,10/18,LosAngeles,0.89,1045819,1169758,78303,358998,6303,2162,Fall,1404817,1176061,80465,False
2015,10/11,LosAngeles,0.92,1014382,1205553,74862,280841,13203,3137,Fall,1295223,1218756,77999,False
2015,10/04,LosAngeles,0.98,798046,1120569,86683,251924,17899,3505,Fall,1049970,1138468,90188,False
2015,09/27,LosAngeles,0.9,1004429,1305809,81864,268104,9642,4807,Fall,1272533,1315451,86671,False
2015,09/20,LosAngeles,0.99,1024117,947562,118706,284791,12275,4996,Fall,1308908,959837,123702,False
2015,09/13,LosAngeles,0.98,1076046,1079298,97210,226956,64067,5933,Fall,1303002,1143365,103143,False
2015,09/06,LosAngeles,0.92,1809743,738938,90624,312763,26701,4391,Fall,2122506,765639,95015,False
2015,08/30,LosAngeles,0.9,2084250,503077,86574,357387,3503,2870,Summer,2441637,506580,89444,False
2015,08/23,LosAngeles,1.03,1687625,538010,92245,279700,3994,3414,Summer,1967325,542004,95659,False
2015,08/16,LosAngeles,0.93,2040657,516718,79890,301831,760,3361,Summer,2342488,517478,83251,False
2015,08/09,LosAngeles,0.94,2176899,813280,69168,304882,4251,2631,Summer,2481781,817531,71799,False
2015,08/02,LosAngeles,1.0,1883744,503247,58532,291524,2991,2172,Summer,2175268,506238,60704,False
2015,07/26,LosAngeles,0.95,2052103,440413,79478,316322,2936,2632,Summer,2368425,443349,82110,False
2015,07/19,LosAngeles,1.02,1801294,417289,89206,290890,13264,2780,Summer,2092184,430553,91986,False
2015,07/12,LosAngeles,1.03,1707544,548712,83398,298568,11398,2858,Summer,2006112,560110,86256,False
2015,07/05,LosAngeles,0.96,2373501,564583,99097,377663,17234,3294,Summer,2751164,581817,102391,False
2015,06/28,LosAngeles,0.94,2073077,419199,75759,336537,13953,2621,Summer,2409614,433152,78380,False
2015,06/21,LosAngeles,0.91,2133616,473295,79616,334560,15484,3450,Summer,2468176,488779,83066,False
2015,06/14,LosAngeles,0.79,2747257,497878,69556,357012,14619,2816,Summer,3104269,512497,72372,False
2015,06/07,LosAngeles,0.84,2356669,447751,71705,367627,14651,3438,Summer,2724296,462402,75143,False
2015,05/31,LosAngeles,0.85,2355022,455405,76580,292423,14480,3024,Spring,2647445,469885,79604,False
2015,05/24,LosAngeles,0.97,2013195,465604,73414,283662,14885,3142,Spring,2296857,480489,76556,False
2015,05/17,LosAngeles,0.98,1817736,390302,54789,280916,11067,2888,Spring,2098652,401369,57677,False
2015,05/10,LosAngeles,0.78,2743972,390901,60232,345073,10675,2786,Spring,3089045,401576,63018,False
2015,05/03,LosAngeles,0.78,2914047,670161,61569,356360,11566,1857,Spring,3270407,681727,63426,False
2015,04/26,LosAngeles,1.02,1567937,427885,62487,280321,15427,1644,Spring,1848258,443312,64131,False
2015,04/19,LosAngeles,0.93,2029025,487491,58423,279355,45364,1527,Spring,2308380,532855,59950,False
2015,04/12,LosAngeles,0.93,1818859,579426,64716,284383,50472,1809,Spring,2103242,629898,66525,False
2015,04/05,LosAngeles,1.01,1753452,490701,73965,245998,36929,2067,Spring,1999450,527630,76032,False
2015,03/29,LosAngeles,1.0,1672623,535932,69022,250801,36844,1464,Spring,1923424,572776,70486,False
2015,03/22,LosAngeles,1.01,1423482,679696,68607,275797,17691,1459,Spring,1699279,697387,70066,False
2015,03/15,LosAngeles,0.94,1841764,445562,70872,313898,16220,1939,Spring,2155662,461782,72811,False
2015,03/08,LosAngeles,0.86,2005781,400644,62567,311497,15650,1604,Spring,2317278,416294,64171,False
2015,03/01,LosAngeles,0.75,2145439,592196,61863,269524,23570,1684,Spring,2414963,615766,63547,False
2015,02/22,LosAngeles,0.83,2050402,505580,61573,309850,25218,2081,Winter,2360252,530798,63654,False
2015,02/15,LosAngeles,0.83,2146773,408395,62511,271596,35034,2124,Winter,2418369,443429,64635,False
2015,02/08,LosAngeles,0.9,1673425,582236,58216,280560,44327,2266,Winter,1953985,626563,60482,False
2015,02/01,LosAngeles,0.74,2770656,854673,64439,308754,31108,2317,Winter,3079410,885781,66756,False
2015,01/25,LosAngeles,0.96,1518406,456562,60922,255279,36398,2418,Winter,1773685,492960,63340,False
2015,01/18,LosAngeles,0.89,1925013,526106,59364,260857,26671,2666,Winter,2185870,552777,62030,False
2015,01/11,LosAngeles,0.85,1786326,617233,58892,222971,25111,3163,Winter,2009297,642344,62055,False
2015,01/04,LosAngeles,0.85,1837999,524430,64225,215571,36981,2950,Winter,2053570,561411,67175,False
2015,12/27,Louisville,1.04,1377,37760,3204,11289,7288,734,Winter,12666,45048,3938,False
2015,12/20,Louisville,1.05,1703,30942,2554,11290,9360,591,Winter,12993,40302,3145,False
2015,12/13,Louisville,0.91,1830,47375,1613,11718,13677,328,Winter,13548,61052,1941,False
2015,12/06,Louisville,0.83,2186,65644,4604,10619,19216,1006,Winter,12805,84860,5610,False
2015,11/29,Louisville,0.97,1290,34019,2342,10740,9710,564,Fall,12030,43729,2906,False
2015,11/22,Louisville,1.01,1319,33164,3367,12082,10219,818,Fall,13401,43383,4185,False
2015,11/15,Louisville,1.04,1374,33868,1787,12910,8473,401,Fall,14284,42341,2188,False
2015,11/08,Louisville,0.93,2052,52494,6709,10817,12978,1877,Fall,12869,65472,8586,False
2015,11/01,Louisville,0.89,3443,60544,5446,11070,21945,1319,Fall,14513,82489,6765,False
2015,10/25,Louisville,1.06,2031,36450,4127,11226,9879,887,Fall,13257,46329,5014,False
2015,10/18,Louisville,1.03,1772,46436,2941,12347,10100,494,Fall,14119,56536,3435,False
2015,10/11,Louisville,1.03,2060,44941,4873,11836,10132,692,Fall,13896,55073,5565,False
2015,10/04,Louisville,1.11,1596,39700,4198,10607,6299,753,Fall,12203,45999,4951,False
2015,09/27,Louisville,1.18,1456,40352,4205,8797,5225,943,Fall,10253,45577,5148,False
2015,09/20,Louisville,1.05,1645,40184,7294,9084,10942,1911,Fall,10729,51126,9205,False
2015,09/13,Louisville,0.98,1730,56765,5424,9468,11295,1235,Fall,11198,68060,6659,False
2015,09/06,Louisville,0.98,2188,65116,3287,10648,16180,733,Fall,12836,81296,4020,False
2015,08/30,Louisville,1.13,4909,40377,5962,10816,6584,1515,Summer,15725,46961,7477,False
2015,08/23,Louisville,1.15,2607,39932,1974,10968,9442,408,Summer,13575,49374,2382,False
2015,08/16,Louisville,1.09,5051,45325,7750,11076,7718,2004,Summer,16127,53043,9754,False
2015,08/09,Louisville,1.08,3152,52753,4025,12114,10835,711,Summer,15266,63588,4736,False
2015,08/02,Louisville,0.93,2141,59505,3666,11522,13604,695,Summer,13663,73109,4361,False
2015,07/26,Louisville,0.88,1965,64026,2057,13129,17841,525,Summer,15094,81867,2582,False
2015,07/19,Louisville,1.08,5812,44739,4934,13721,7346,948,Summer,19533,52085,5882,False
2015,07/12,Louisville,1.13,2051,43381,1678,13950,11355,275,Summer,16001,54736,1953,False
2015,07/05,Louisville,1.15,1948,49319,3205,16460,10376,437,Summer,18408,59695,3642,False
2015,06/28,Louisville,1.15,2289,41216,1060,15247,9197,219,Summer,17536,50413,1279,False
2015,06/21,Louisville,1.17,3338,44777,6132,15669,7104,1249,Summer,19007,51881,7381,False
2015,06/14,Louisville,1.07,2241,50907,3570,15803,9422,418,Summer,18044,60329,3988,False
2015,06/07,Louisville,1.01,8145,62401,4540,12423,10432,922,Summer,20568,72833,5462,False
2015,05/31,Louisville,1.0,7195,58910,1622,11607,12647,361,Spring,18802,71557,1983,False
2015,05/24,Louisville,1.05,2581,55999,1616,10358,8634,376,Spring,12939,64633,1992,False
2015,05/17,Louisville,1.2,2114,48390,4737,8983,8235,1075,Spring,11097,56625,5812,False
2015,05/10,Louisville,1.1,2278,60221,606,9533,12740,65,Spring,11811,72961,671,False
2015,05/03,Louisville,1.03,2031,66286,2641,8761,15348,480,Spring,10792,81634,3121,False
2015,04/26,Louisville,1.21,2070,42192,2780,9812,8286,600,Spring,11882,50478,3380,False
2015,04/19,Louisville,1.01,2113,62591,5341,19572,5205,1134,Spring,21685,67796,6475,False
2015,04/12,Louisville,0.97,2761,61733,340,19990,3351,57,Spring,22751,65084,397,False
2015,04/05,Louisville,1.08,1833,49893,565,15903,7424,6,Spring,17736,57317,571,False
2015,03/29,Louisville,1.0,2639,64264,1117,22498,3113,169,Spring,25137,67377,1286,False
2015,03/22,Louisville,0.99,2464,62778,7475,7992,12576,1813,Spring,10456,75354,9288,False
2015,03/15,Louisville,1.21,2010,36582,1294,9906,6777,299,Spring,11916,43359,1593,False
2015,03/08,Louisville,1.18,2777,38415,1615,11944,7667,309,Spring,14721,46082,1924,False
2015,03/01,Louisville,1.02,1553,53158,6909,7537,7839,1628,Spring,9090,60997,8537,False
2015,02/22,Louisville,1.01,3122,77315,1217,9789,15762,235,Winter,12911,93077,1452,False
2015,02/15,Louisville,1.13,3843,50486,1394,11567,12926,319,Winter,15410,63412,1713,False
2015,02/08,Louisville,1.0,6359,59424,1307,10210,9464,288,Winter,16569,68888,1595,False
2015,02/01,Louisville,0.9,5378,83854,5155,8618,21296,1202,Winter,13996,105150,6357,False
2015,01/25,Louisville,1.02,2283,63038,234,8875,12189,14,Winter,11158,75227,248,False
2015,01/18,Louisville,1.06,2250,63826,426,10228,8804,43,Winter,12478,72630,469,False
2015,01/11,Louisville,1.05,2299,53313,237,7964,11299,13,Winter,10263,64612,250,False
2015,01/04,Louisville,0.92,1991,75090,283,7769,16027,0,Winter,9760,91117,283,False
2015,12/27,MiamiFtLauderdale,0.99,387953,44652,54,53606,58798,0,Winter,441559,103450,54,False
2015,12/20,MiamiFtLauderdale,1.21,238269,32386,92,50138,29624,23,Winter,288407,62010,115,False
2015,12/13,MiamiFtLauderdale,0.97,387065,49363,85,38463,54339,0,Winter,425528,103702,85,False
2015,12/06,MiamiFtLauderdale,1.25,247061,34861,83,25297,33209,0,Winter,272358,68070,83,False
2015,11/29,MiamiFtLauderdale,0.98,349408,42435,70,27392,50911,0,Fall,376800,93346,70,False
2015,11/22,MiamiFtLauderdale,0.98,359876,47195,72,32763,59482,5,Fall,392639,106677,77,False
2015,11/15,MiamiFtLauderdale,1.22,258624,42921,21,34369,33058,0,Fall,292993,75979,21,False
2015,11/08,MiamiFtLauderdale,1.22,223219,37562,21,36440,31818,2,Fall,259659,69380,23,False
2015,11/01,MiamiFtLauderdale,0.98,415970,54992,32,37980,57051,2,Fall,453950,112043,34,False
2015,10/25,MiamiFtLauderdale,1.25,212163,35901,42,33429,25527,8,Fall,245592,61428,50,False
2015,10/18,MiamiFtLauderdale,1.24,224505,42454,24,40518,26421,8,Fall,265023,68875,32,False
2015,10/11,MiamiFtLauderdale,1.0,384920,59335,21,39787,54316,2,Fall,424707,113651,23,False
2015,10/04,MiamiFtLauderdale,0.99,411182,63182,48,47869,48084,0,Fall,459051,111266,48,False
2015,09/27,MiamiFtLauderdale,1.31,200219,57857,40,35358,24572,0,Fall,235577,82429,40,False
2015,09/20,MiamiFtLauderdale,0.98,381034,76606,58,47692,54427,0,Fall,428726,131033,58,False
2015,09/13,MiamiFtLauderdale,1.26,197328,64770,17,42655,26305,0,Fall,239983,91075,17,False
2015,09/06,MiamiFtLauderdale,0.98,442545,80524,13,49819,64423,0,Fall,492364,144947,13,False
2015,08/30,MiamiFtLauderdale,1.24,212188,66569,73,59815,23581,2,Summer,272003,90150,75,False
2015,08/23,MiamiFtLauderdale,1.24,218751,70677,63,58853,24165,14,Summer,277604,94842,77,False
2015,08/16,MiamiFtLauderdale,1.24,213812,61634,31,62035,22794,0,Summer,275847,84428,31,False
2015,08/09,MiamiFtLauderdale,0.97,450713,86740,81,61527,56758,0,Summer,512240,143498,81,False
2015,08/02,MiamiFtLauderdale,1.22,219518,66230,66,63761,22083,0,Summer,283279,88313,66,False
2015,07/26,MiamiFtLauderdale,1.24,233056,63065,76,63018,20736,0,Summer,296074,83801,76,False
2015,07/19,MiamiFtLauderdale,0.96,436603,96849,98,55330,37959,0,Summer,491933,134808,98,False
2015,07/12,MiamiFtLauderdale,1.24,235985,79717,87,61873,24836,206,Summer,297858,104553,293,False
2015,07/05,MiamiFtLauderdale,0.98,483878,101119,193,72566,60394,0,Summer,556444,161513,193,False
2015,06/28,MiamiFtLauderdale,1.21,259852,79482,262,76411,27962,0,Summer,336263,107444,262,False
2015,06/21,MiamiFtLauderdale,0.96,445033,90433,5433,74032,54476,0,Summer,519065,144909,5433,False
2015,06/14,MiamiFtLauderdale,1.26,273373,55875,9215,72754,26678,0,Summer,346127,82553,9215,False
2015,06/07,MiamiFtLauderdale,0.99,503235,60937,103,65839,53761,0,Summer,569074,114698,103,False
2015,05/31,MiamiFtLauderdale,1.27,296763,35493,57,61102,25740,0,Spring,357865,61233,57,False
2015,05/24,MiamiFtLauderdale,1.01,571149,62989,72,62451,60641,0,Spring,633600,123630,72,False
2015,05/17,MiamiFtLauderdale,1.24,323238,36762,136,64400,26066,0,Spring,387638,62828,136,False
2015,05/10,MiamiFtLauderdale,1.28,315524,37151,58,60376,22436,0,Spring,375900,59587,58,False
2015,05/03,MiamiFtLauderdale,0.98,690389,81078,35,68322,77201,397,Spring,758711,158279,432,False
2015,04/26,MiamiFtLauderdale,1.25,341780,41476,120,63701,28442,495,Spring,405481,69918,615,False
2015,04/19,MiamiFtLauderdale,1.23,306881,38958,41,58121,30023,0,Spring,365002,68981,41,False
2015,04/12,MiamiFtLauderdale,1.0,525432,63130,59,47627,56319,0,Spring,573059,119449,59,False
2015,04/05,MiamiFtLauderdale,1.11,370549,48767,91,49707,41286,337,Spring,420256,90053,428,False
2015,03/29,MiamiFtLauderdale,1.25,261045,32977,87,47569,28385,0,Spring,308614,61362,87,False
2015,03/22,MiamiFtLauderdale,0.97,480064,58232,165,51350,53122,0,Spring,531414,111354,165,False
2015,03/15,MiamiFtLauderdale,1.33,272270,35374,145,38984,24940,0,Spring,311254,60314,145,False
2015,03/08,MiamiFtLauderdale,1.3,253963,32888,62,47346,22049,0,Spring,301309,54937,62,False
2015,03/01,MiamiFtLauderdale,1.01,484615,60307,41,45516,56532,0,Spring,530131,116839,41,False
2015,02/22,MiamiFtLauderdale,1.24,256141,35032,67,51870,26708,0,Winter,308011,61740,67,False
2015,02/15,MiamiFtLauderdale,1.29,243991,34941,77,38771,35738,0,Winter,282762,70679,77,False
2015,02/08,MiamiFtLauderdale,1.25,249833,35897,34,36164,26280,0,Winter,285997,62177,34,False
2015,02/01,MiamiFtLauderdale,0.95,566917,74532,82,48097,63671,0,Winter,615014,138203,82,False
2015,01/25,MiamiFtLauderdale,1.27,289948,41120,65,35279,31641,0,Winter,325227,72761,65,False
2015,01/18,MiamiFtLauderdale,1.3,285204,42798,42,41312,35780,0,Winter,326516,78578,42,False
2015,01/11,MiamiFtLauderdale,1.28,242922,36043,38,35069,28722,0,Winter,277991,64765,38,False
2015,01/04,MiamiFtLauderdale,0.97,398670,54844,39,38505,48175,0,Winter,437175,103019,39,False
2015,12/27,Nashville,0.96,79508,8706,4748,23563,7140,3,Winter,103071,15846,4751,False
2015,12/20,Nashville,0.99,87309,7415,4356,23562,4722,7,Winter,110871,12137,4363,False
2015,12/13,Nashville,0.91,103097,11175,6145,23065,9806,134,Winter,126162,20981,6279,False
2015,12/06,Nashville,1.0,88033,9655,5447,22956,4797,98,Winter,110989,14452,5545,False
2015,11/29,Nashville,0.95,77155,9407,5435,20470,7440,10,Fall,97625,16847,5445,False
2015,11/22,Nashville,0.96,79960,10083,5985,23717,7157,261,Fall,103677,17240,6246,False
2015,11/15,Nashville,1.04,77510,11869,5903,24126,5261,0,Fall,101636,17130,5903,False
2015,11/08,Nashville,1.03,87957,11807,4873,25641,5225,0,Fall,113598,17032,4873,False
2015,11/01,Nashville,0.94,97774,20102,5054,24437,11949,0,Fall,122211,32051,5054,False
2015,10/25,Nashville,0.91,89991,20511,4334,25000,8823,0,Fall,114991,29334,4334,False
2015,10/18,Nashville,0.91,114107,29076,6047,23996,9419,0,Fall,138103,38495,6047,False
2015,10/11,Nashville,0.96,83621,35428,7009,23793,17803,0,Fall,107414,53231,7009,False
2015,10/04,Nashville,0.96,78331,30106,6363,26267,16376,45,Fall,104598,46482,6408,False
2015,09/27,Nashville,1.04,93381,25445,6807,25432,9435,45,Fall,118813,34880,6852,False
2015,09/20,Nashville,0.95,108519,32478,9286,27175,19540,649,Fall,135694,52018,9935,False
2015,09/13,Nashville,1.05,76424,25095,9786,31983,11023,309,Fall,108407,36118,10095,False
2015,09/06,Nashville,0.97,92988,30510,9638,27102,15494,242,Fall,120090,46004,9880,False
2015,08/30,Nashville,1.09,82766,21072,7912,24581,5819,0,Summer,107347,26891,7912,False
2015,08/23,Nashville,0.97,112284,19284,10060,25633,4312,0,Summer,137917,23596,10060,False
2015,08/16,Nashville,0.96,126796,18393,13672,22867,5354,226,Summer,149663,23747,13898,False
2015,08/09,Nashville,0.98,105537,20560,10196,30602,8883,631,Summer,136139,29443,10827,False
2015,08/02,Nashville,1.08,87160,19863,9366,30724,4552,140,Summer,117884,24415,9506,False
2015,07/26,Nashville,1.07,85386,19400,9807,29923,4702,42,Summer,115309,24102,9849,False
2015,07/19,Nashville,0.98,113404,19371,9567,34877,8680,357,Summer,148281,28051,9924,False
2015,07/12,Nashville,1.09,90781,17434,9746,29736,5171,121,Summer,120517,22605,9867,False
2015,07/05,Nashville,0.97,121473,25125,10804,35733,8482,179,Summer,157206,33607,10983,False
2015,06/28,Nashville,1.06,90881,19436,8297,36900,3662,803,Summer,127781,23098,9100,False
2015,06/21,Nashville,0.96,111226,17917,8103,41015,9725,775,Summer,152241,27642,8878,False
2015,06/14,Nashville,1.03,103389,17224,7010,38948,5729,0,Summer,142337,22953,7010,False
2015,06/07,Nashville,0.96,128293,10385,10508,31059,8944,278,Summer,159352,19329,10786,False
2015,05/31,Nashville,1.04,117285,8351,11839,24244,4413,80,Spring,141529,12764,11919,False
2015,05/24,Nashville,0.98,140921,9348,14228,22090,7942,459,Spring,163011,17290,14687,False
2015,05/17,Nashville,1.07,100832,8161,10852,25235,4310,7,Spring,126067,12471,10859,False
2015,05/10,Nashville,1.07,114337,9079,13932,23620,4406,350,Spring,137957,13485,14282,False
2015,05/03,Nashville,0.98,159791,13149,16218,23216,10436,0,Spring,183007,23585,16218,False
2015,04/26,Nashville,1.08,117295,8599,15685,21480,3495,0,Spring,138775,12094,15685,False
2015,04/19,Nashville,1.11,91537,7598,12377,22422,6712,0,Spring,113959,14310,12377,False
2015,04/12,Nashville,1.0,111682,9658,12737,14353,10057,0,Spring,126035,19715,12737,False
2015,04/05,Nashville,1.06,104270,8266,14141,21583,6812,0,Spring,125853,15078,14141,False
2015,03/29,Nashville,1.07,102824,8307,14079,19540,6549,0,Spring,122364,14856,14079,False
2015,03/22,Nashville,1.01,122204,9195,13155,22501,6833,89,Spring,144705,16028,13244,False
2015,03/15,Nashville,1.08,86390,6821,11458,21886,3381,1114,Spring,108276,10202,12572,False
2015,03/08,Nashville,1.08,104187,7723,10813,22958,3555,0,Spring,127145,11278,10813,False
2015,03/01,Nashville,0.99,121799,9712,10894,20732,6153,129,Spring,142531,15865,11023,False
2015,02/22,Nashville,1.05,101095,10053,13693,20671,2645,4,Winter,121766,12698,13697,False
2015,02/15,Nashville,1.03,109047,9817,11085,21186,2715,0,Winter,130233,12532,11085,False
2015,02/08,Nashville,0.94,125785,8119,9717,25896,2229,0,Winter,151681,10348,9717,False
2015,02/01,Nashville,0.94,160834,13445,17578,23898,5714,0,Winter,184732,19159,17578,False
2015,01/25,Nashville,1.07,95428,8371,11082,24183,1789,0,Winter,119611,10160,11082,False
2015,01/18,Nashville,1.08,97216,8423,12187,23520,2116,0,Winter,120736,10539,12187,False
2015,01/11,Nashville,1.07,103822,9098,11665,22478,2766,0,Winter,126300,11864,11665,False
2015,01/04,Nashville,1.0,113865,11083,11699,19681,5611,221,Winter,133546,16694,11920,False
2015,12/27,NewOrleansMobile,0.91,105570,18655,284,53908,9224,19,Winter,159478,27879,303,False
2015,12/20,NewOrleansMobile,0.92,110266,18630,255,57100,5619,64,Winter,167366,24249,319,False
2015,12/13,NewOrleansMobile,0.86,119689,31214,437,44564,8310,0,Winter,164253,39524,437,False
2015,12/06,NewOrleansMobile,0.94,117854,21553,325,41822,3839,0,Winter,159676,25392,325,False
2015,11/29,NewOrleansMobile,0.9,96662,23572,298,49172,6127,0,Fall,145834,29699,298,False
2015,11/22,NewOrleansMobile,0.94,112638,18822,388,53791,6426,6,Fall,166429,25248,394,False
2015,11/15,NewOrleansMobile,0.98,113570,21747,335,56099,4028,0,Fall,169669,25775,335,False
2015,11/08,NewOrleansMobile,0.96,122265,21552,692,49206,3996,0,Fall,171471,25548,692,False
2015,11/01,NewOrleansMobile,0.97,129683,16059,486,50413,8082,12,Fall,180096,24141,498,False
2015,10/25,NewOrleansMobile,1.01,117736,17516,646,51959,3321,0,Fall,169695,20837,646,False
2015,10/18,NewOrleansMobile,1.02,124894,18241,1003,58060,4364,0,Fall,182954,22605,1003,False
2015,10/11,NewOrleansMobile,1.0,135769,16126,1155,56426,8293,6,Fall,192195,24419,1161,False
2015,10/04,NewOrleansMobile,1.0,133195,20601,1171,59907,7612,0,Fall,193102,28213,1171,False
2015,09/27,NewOrleansMobile,1.06,123528,17616,1515,53115,4131,0,Fall,176643,21747,1515,False
2015,09/20,NewOrleansMobile,1.0,135003,24187,1608,56901,6309,6,Fall,191904,30496,1614,False
2015,09/13,NewOrleansMobile,1.02,140509,18106,1713,54335,5110,0,Fall,194844,23216,1713,False
2015,09/06,NewOrleansMobile,0.99,155273,18010,2204,64673,8193,0,Fall,219946,26203,2204,False
2015,08/30,NewOrleansMobile,1.03,144651,14746,2416,68104,4376,12,Summer,212755,19122,2428,False
2015,08/23,NewOrleansMobile,1.04,152247,18687,2886,61777,4942,18,Summer,214024,23629,2904,False
2015,08/16,NewOrleansMobile,1.04,151208,16681,7405,72975,4844,42,Summer,224183,21525,7447,False
2015,08/09,NewOrleansMobile,1.0,171948,10121,11932,71332,7130,0,Summer,243280,17251,11932,False
2015,08/02,NewOrleansMobile,1.04,157656,8025,11763,66186,5015,24,Summer,223842,13040,11787,False
2015,07/26,NewOrleansMobile,1.03,171672,10443,12343,61569,2930,0,Summer,233241,13373,12343,False
2015,07/19,NewOrleansMobile,0.98,167068,8930,11720,62702,8131,6,Summer,229770,17061,11726,False
2015,07/12,NewOrleansMobile,1.05,149305,11069,11822,62705,4999,6,Summer,212010,16068,11828,False
2015,07/05,NewOrleansMobile,1.01,185225,9201,15050,81157,6839,6,Summer,266382,16040,15056,False
2015,06/28,NewOrleansMobile,1.03,163193,10737,8080,75120,4043,24,Summer,238313,14780,8104,False
2015,06/21,NewOrleansMobile,0.93,182416,8803,7161,86878,8474,0,Summer,269294,17277,7161,False
2015,06/14,NewOrleansMobile,1.02,166072,10920,268,80570,4418,0,Summer,246642,15338,268,False
2015,06/07,NewOrleansMobile,0.99,186502,8769,297,85387,7902,0,Summer,271889,16671,297,False
2015,05/31,NewOrleansMobile,1.04,164856,8536,319,67111,4469,0,Spring,231967,13005,319,False
2015,05/24,NewOrleansMobile,1.03,175841,10463,235,71635,7062,0,Spring,247476,17525,235,False
2015,05/17,NewOrleansMobile,0.96,172610,9661,262,69919,4950,0,Spring,242529,14611,262,False
2015,05/10,NewOrleansMobile,1.05,176480,7959,321,67176,4354,0,Spring,243656,12313,321,False
2015,05/03,NewOrleansMobile,0.93,204609,13133,299,81127,9484,0,Spring,285736,22617,299,False
2015,04/26,NewOrleansMobile,0.96,179543,9195,288,72727,3985,0,Spring,252270,13180,288,False
2015,04/19,NewOrleansMobile,0.93,172951,12171,373,74117,3873,0,Spring,247068,16044,373,False
2015,04/12,NewOrleansMobile,0.97,168050,7155,294,53843,6367,0,Spring,221893,13522,294,False
2015,04/05,NewOrleansMobile,0.99,166893,7766,250,57555,5167,188,Spring,224448,12933,438,False
2015,03/29,NewOrleansMobile,0.97,161509,9472,77,62564,3564,0,Spring,224073,13036,77,False
2015,03/22,NewOrleansMobile,0.9,196325,8985,179,68626,8377,0,Spring,264951,17362,179,False
2015,03/15,NewOrleansMobile,1.09,159683,11363,183,58352,4113,0,Spring,218035,15476,183,False
2015,03/08,NewOrleansMobile,1.06,163007,12379,269,69335,3281,0,Spring,232342,15660,269,False
2015,03/01,NewOrleansMobile,1.08,138924,16229,384,62740,6472,0,Spring,201664,22701,384,False
2015,02/22,NewOrleansMobile,0.92,178792,10819,346,62873,3341,0,Winter,241665,14160,346,False
2015,02/15,NewOrleansMobile,1.02,155288,11863,253,60468,2195,0,Winter,215756,14058,253,False
2015,02/08,NewOrleansMobile,0.93,169656,8648,202,61345,2212,0,Winter,231001,10860,202,False
2015,02/01,NewOrleansMobile,0.81,271075,11860,426,76463,7885,0,Winter,347538,19745,426,False
2015,01/25,NewOrleansMobile,0.94,188798,12771,352,66085,3438,0,Winter,254883,16209,352,False
2015,01/18,NewOrleansMobile,1.03,179991,23263,213,61302,2895,0,Winter,241293,26158,213,False
2015,01/11,NewOrleansMobile,0.97,165505,10680,231,59593,3221,0,Winter,225098,13901,231,False
2015,01/04,NewOrleansMobile,0.94,148384,14085,218,54422,5640,0,Winter,202806,19725,218,False
2015,12/27,NewYork,1.17,13711,872603,894,208470,34191,4,Winter,222181,906794,898,False
2015,12/20,NewYork,1.23,13998,867406,803,212615,44523,0,Winter,226613,911929,803,False
2015,12/13,NewYork,1.12,15990,975504,1657,222446,39205,0,Winter,238436,1014709,1657,False
2015,12/06,NewYork,1.2,15730,887708,892,136643,27997,0,Winter,152373,915705,892,False
2015,11/29,NewYork,1.16,13652,814571,863,139508,30573,0,Fall,153160,845144,863,False
2015,11/22,NewYork,1.14,15004,905344,1227,156660,33558,7,Fall,171664,938902,1234,False
2015,11/15,NewYork,1.04,23669,1107466,929,196060,29267,0,Fall,219729,1136733,929,False
2015,11/08,NewYork,1.13,20146,1097994,753,198024,89343,0,Fall,218170,1187337,753,False
2015,11/01,NewYork,1.06,24197,1916954,1226,183727,54399,15,Fall,207924,1971353,1241,False
2015,10/25,NewYork,1.23,18035,790163,540,192750,46555,0,Fall,210785,836718,540,False
2015,10/18,NewYork,0.97,23873,1598365,1173,181854,51069,2,Fall,205727,1649434,1175,False
2015,10/11,NewYork,1.28,14859,792683,721,214209,76809,0,Fall,229068,869492,721,False
2015,10/04,NewYork,1.26,19623,1060768,1078,208106,53386,0,Fall,227729,1114154,1078,False
2015,09/27,NewYork,1.16,15448,941112,983,185973,57548,0,Fall,201421,998660,983,False
2015,09/20,NewYork,1.18,16098,913022,801,214317,47970,0,Fall,230415,960992,801,False
2015,09/13,NewYork,1.16,20526,1208256,1030,181277,68237,7,Fall,201803,1276493,1037,False
2015,09/06,NewYork,1.22,19894,1074698,1295,201210,43820,7,Fall,221104,1118518,1302,False
2015,08/30,NewYork,1.22,18628,982355,1530,208604,39872,88,Summer,227232,1022227,1618,False
2015,08/23,NewYork,1.1,22589,1222687,822,197249,34604,10,Summer,219838,1257291,832,False
2015,08/16,NewYork,1.14,19663,1291206,1727,188594,34787,1,Summer,208257,1325993,1728,False
2015,08/09,NewYork,1.1,23326,1290583,976,218715,30313,0,Summer,242041,1320896,976,False
2015,08/02,NewYork,1.14,21768,1184264,1330,216693,34664,0,Summer,238461,1218928,1330,False
2015,07/26,NewYork,1.28,19228,910716,1321,233874,46589,0,Summer,253102,957305,1321,False
2015,07/19,NewYork,1.37,20811,923816,2324,256581,48382,3,Summer,277392,972198,2327,False
2015,07/12,NewYork,1.27,22742,956051,5130,306199,47542,616,Summer,328941,1003593,5746,False
2015,07/05,NewYork,1.18,23947,1290776,5470,278911,67625,93,Summer,302858,1358401,5563,False
2015,06/28,NewYork,1.36,17714,917010,3347,266450,80224,41,Summer,284164,997234,3388,False
2015,06/21,NewYork,1.28,18711,1312242,5159,287710,43147,55,Summer,306421,1355389,5214,False
2015,06/14,NewYork,1.32,23161,931945,3548,323080,81280,117,Summer,346241,1013225,3665,False
2015,06/07,NewYork,1.32,24734,1347902,2235,296939,59171,76,Summer,321673,1407073,2311,False
2015,05/31,NewYork,1.43,24958,1077663,1368,322139,67077,10,Spring,347097,1144740,1378,False
2015,05/24,NewYork,1.37,21741,1103694,1724,322563,65288,10,Spring,344304,1168982,1734,False
2015,05/17,NewYork,1.43,21866,871213,1648,300933,59891,0,Spring,322799,931104,1648,False
2015,05/10,NewYork,1.22,27734,1711900,4590,316975,57393,0,Spring,344709,1769293,4590,False
2015,05/03,NewYork,1.32,23447,1317970,4554,257688,74835,608,Spring,281135,1392805,5162,False
2015,04/26,NewYork,1.44,20400,932216,2618,246376,93487,490,Spring,266776,1025703,3108,False
2015,04/19,NewYork,1.42,20252,927145,2366,278784,103965,0,Spring,299036,1031110,2366,False
2015,04/12,NewYork,1.43,18928,764676,1846,239070,59886,0,Spring,257998,824562,1846,False
2015,04/05,NewYork,1.41,20081,909664,2011,252129,59757,680,Spring,272210,969421,2691,False
2015,03/29,NewYork,1.36,21780,882071,1812,216859,61290,0,Spring,238639,943361,1812,False
2015,03/22,NewYork,1.33,22713,884992,1650,223369,60005,0,Spring,246082,944997,1650,False
2015,03/15,NewYork,1.45,22591,749461,1923,258642,65119,0,Spring,281233,814580,1923,False
2015,03/08,NewYork,1.36,31886,755537,2109,271636,68163,0,Spring,303522,823700,2109,False
2015,03/01,NewYork,1.18,19919,1025372,2849,228539,61449,0,Spring,248458,1086821,2849,False
2015,02/22,NewYork,1.33,18716,757987,2885,253336,56051,0,Winter,272052,814038,2885,False
2015,02/15,NewYork,1.36,17342,688201,2659,240950,48408,0,Winter,258292,736609,2659,False
2015,02/08,NewYork,1.11,26781,1310966,2996,249204,68760,0,Winter,275985,1379726,2996,False
2015,02/01,NewYork,1.36,22622,1084529,3251,243186,80172,0,Winter,265808,1164701,3251,False
2015,01/25,NewYork,1.36,18101,768131,3184,249848,63602,0,Winter,267949,831733,3184,False
2015,01/18,NewYork,1.37,18945,749309,3039,211934,61052,0,Winter,230879,810361,3039,False
2015,01/11,NewYork,1.34,15880,714530,2315,221731,63767,0,Winter,237611,778297,2315,False
2015,01/04,NewYork,1.09,23641,1127882,1871,178683,70812,0,Winter,202324,1198694,1871,False
2015,12/27,NorthernNewEngland,1.21,2601,250270,12123,39602,0,0,Winter,42203,250270,12123,False
2015,12/20,NorthernNewEngland,1.17,2616,232459,3820,45911,0,0,Winter,48527,232459,3820,False
2015,12/13,NorthernNewEngland,0.95,2970,369076,116,35319,0,0,Winter,38289,369076,116,False
2015,12/06,NorthernNewEngland,1.11,3320,261503,94,38140,0,0,Winter,41460,261503,94,False
2015,11/29,NorthernNewEngland,1.25,2897,181977,88,34725,0,0,Fall,37622,181977,88,False
2015,11/22,NorthernNewEngland,1.08,2770,230517,140,40777,3,0,Fall,43547,230520,140,False
2015,11/15,NorthernNewEngland,1.07,2589,237255,90,46867,212,0,Fall,49456,237467,90,False
2015,11/08,NorthernNewEngland,0.96,2347,453089,132,33362,408,0,Fall,35709,453497,132,False
2015,11/01,NorthernNewEngland,1.07,3271,281498,209,65081,200,0,Fall,68352,281698,209,False
2015,10/25,NorthernNewEngland,1.08,2599,268057,158,42475,591,0,Fall,45074,268648,158,False
2015,10/18,NorthernNewEngland,1.0,3274,361448,192,36297,1253,0,Fall,39571,362701,192,False
2015,10/11,NorthernNewEngland,1.19,3616,231543,204,43001,106,0,Fall,46617,231649,204,False
2015,10/04,NorthernNewEngland,1.12,3978,253346,248,40431,217,0,Fall,44409,253563,248,False
2015,09/27,NorthernNewEngland,0.98,2768,427544,265,27515,508,0,Fall,30283,428052,265,False
2015,09/20,NorthernNewEngland,1.17,2413,270775,291,48164,1084,0,Fall,50577,271859,291,False
2015,09/13,NorthernNewEngland,1.09,1752,301172,277,52023,880,0,Fall,53775,302052,277,False
2015,09/06,NorthernNewEngland,1.01,2506,456884,377,48349,88,0,Fall,50855,456972,377,False
2015,08/30,NorthernNewEngland,1.13,2834,337184,457,54650,0,0,Summer,57484,337184,457,False
2015,08/23,NorthernNewEngland,1.18,2487,338130,608,58875,0,0,Summer,61362,338130,608,False
2015,08/16,NorthernNewEngland,1.23,2067,304465,775,65208,0,0,Summer,67275,304465,775,False
2015,08/09,NorthernNewEngland,1.03,2513,523492,815,52400,3,0,Summer,54913,523495,815,False
2015,08/02,NorthernNewEngland,1.25,2279,347110,1637,66056,0,0,Summer,68335,347110,1637,False
2015,07/26,NorthernNewEngland,1.25,2558,324258,2452,73518,4,0,Summer,76076,324262,2452,False
2015,07/19,NorthernNewEngland,1.03,3108,522040,6851,62434,17,0,Summer,65542,522057,6851,False
2015,07/12,NorthernNewEngland,1.1,3111,341891,15371,148811,28,0,Summer,151922,341919,15371,False
2015,07/05,NorthernNewEngland,1.15,2968,338863,17991,176636,182,0,Summer,179604,339045,17991,False
2015,06/28,NorthernNewEngland,1.14,2582,282587,15156,152425,48,0,Summer,155007,282635,15156,False
2015,06/21,NorthernNewEngland,1.18,2279,300069,14779,108756,0,0,Summer,111035,300069,14779,False
2015,06/14,NorthernNewEngland,1.04,2804,362082,10744,162093,0,0,Summer,164897,362082,10744,False
2015,06/07,NorthernNewEngland,1.17,2096,314308,37,110774,0,0,Summer,112870,314308,37,False
2015,05/31,NorthernNewEngland,1.2,2523,313153,61,97960,0,0,Spring,100483,313153,61,False
2015,05/24,NorthernNewEngland,1.04,2624,372289,53,137204,0,0,Spring,139828,372289,53,False
2015,05/17,NorthernNewEngland,1.15,2745,287792,29,131904,11,0,Spring,134649,287803,29,False
2015,05/10,NorthernNewEngland,1.05,2739,503984,78,71253,380,0,Spring,73992,504364,78,False
2015,05/03,NorthernNewEngland,1.16,2322,304233,59,60354,17,0,Spring,62676,304250,59,False
2015,04/26,NorthernNewEngland,1.24,1960,253562,79,56259,17,0,Spring,58219,253579,79,False
2015,04/19,NorthernNewEngland,1.13,2156,284389,78,59936,0,0,Spring,62092,284389,78,False
2015,04/12,NorthernNewEngland,1.16,2160,214309,58,89699,21,0,Spring,91859,214330,58,False
2015,04/05,NorthernNewEngland,1.19,2352,252306,82,54288,114,0,Spring,56640,252420,82,False
2015,03/29,NorthernNewEngland,1.07,2452,372165,57,37036,927,0,Spring,39488,373092,57,False
2015,03/22,NorthernNewEngland,1.19,4556,229492,55,47856,194,0,Spring,52412,229686,55,False
2015,03/15,NorthernNewEngland,1.15,6236,247092,90,48390,42,0,Spring,54626,247134,90,False
2015,03/08,NorthernNewEngland,1.09,2507,234532,15,50606,302,0,Spring,53113,234834,15,False
2015,03/01,NorthernNewEngland,1.05,2266,310490,41,42880,0,0,Spring,45146,310490,41,False
2015,02/22,NorthernNewEngland,1.13,2875,217477,23,43735,6,0,Winter,46610,217483,23,False
2015,02/15,NorthernNewEngland,1.11,2897,232117,33,53303,162,0,Winter,56200,232279,33,False
2015,02/08,NorthernNewEngland,1.03,4606,308443,33,50014,837,0,Winter,54620,309280,33,False
2015,02/01,NorthernNewEngland,1.06,4353,361694,34,46576,93,0,Winter,50929,361787,34,False
2015,01/25,NorthernNewEngland,1.06,3806,233232,24,53543,4,0,Winter,57349,233236,24,False
2015,01/18,NorthernNewEngland,1.12,3012,241380,38,64770,0,0,Winter,67782,241380,38,False
2015,01/11,NorthernNewEngland,1.06,4578,265252,22,44863,0,0,Winter,49441,265252,22,False
2015,01/04,NorthernNewEngland,1.05,4966,264351,14,52490,0,0,Winter,57456,264351,14,False
2015,12/27,Orlando,0.99,211102,20765,124,40641,33139,0,Winter,251743,53904,124,False
2015,12/20,Orlando,1.21,131152,15794,122,36258,16747,0,Winter,167410,32541,122,False
2015,12/13,Orlando,0.96,217679,24260,168,31407,36585,0,Winter,249086,60845,168,False
2015,12/06,Orlando,1.2,135222,21555,121,24098,18064,0,Winter,159320,39619,121,False
2015,11/29,Orlando,0.96,190361,21007,37,21536,29739,0,Fall,211897,50746,37,False
2015,11/22,Orlando,0.98,184441,21585,120,27114,33688,0,Fall,211555,55273,120,False
2015,11/15,Orlando,1.24,129533,20681,109,27742,22648,0,Fall,157275,43329,109,False
2015,11/08,Orlando,1.24,132375,21007,92,31369,18109,0,Fall,163744,39116,92,False
2015,11/01,Orlando,0.97,228073,29350,80,33748,38819,0,Fall,261821,68169,80,False
2015,10/25,Orlando,1.25,138110,24182,91,29737,18128,16,Fall,167847,42310,107,False
2015,10/18,Orlando,1.24,131126,24094,71,32915,16319,0,Fall,164041,40413,71,False
2015,10/11,Orlando,1.0,211056,30064,105,31968,34838,0,Fall,243024,64902,105,False
2015,10/04,Orlando,1.0,224769,34085,60,37192,36886,2,Fall,261961,70971,62,False
2015,09/27,Orlando,1.28,114107,41995,142,29149,17062,0,Fall,143256,59057,142,False
2015,09/20,Orlando,0.99,201392,51930,119,36956,39285,0,Fall,238348,91215,119,False
2015,09/13,Orlando,1.23,113374,51291,43,37653,19183,0,Fall,151027,70474,43,False
2015,09/06,Orlando,0.99,232502,56930,82,43014,43206,0,Fall,275516,100136,82,False
2015,08/30,Orlando,1.25,123335,51487,173,44694,18578,0,Summer,168029,70065,173,False
2015,08/23,Orlando,1.21,113657,51869,81,47516,15800,0,Summer,161173,67669,81,False
2015,08/16,Orlando,1.23,128769,46941,91,45260,19122,0,Summer,174029,66063,91,False
2015,08/09,Orlando,0.99,249265,57952,99,47242,33990,0,Summer,296507,91942,99,False
2015,08/02,Orlando,1.24,130990,49482,88,43472,16786,0,Summer,174462,66268,88,False
2015,07/26,Orlando,1.22,128204,51179,71,44878,15507,0,Summer,173082,66686,71,False
2015,07/19,Orlando,0.98,226313,57749,61,42477,37132,0,Summer,268790,94881,61,False
2015,07/12,Orlando,1.22,133073,53986,73,41732,16663,0,Summer,174805,70649,73,False
2015,07/05,Orlando,0.97,258450,66371,83,58523,36900,0,Summer,316973,103271,83,False
2015,06/28,Orlando,1.15,144510,52467,118,62186,18570,0,Summer,206696,71037,118,False
2015,06/21,Orlando,0.96,243576,57122,726,55420,37189,0,Summer,298996,94311,726,False
2015,06/14,Orlando,1.22,141946,36946,2083,56501,18663,8,Summer,198447,55609,2091,False
2015,06/07,Orlando,0.98,271323,33611,561,48219,37841,0,Summer,319542,71452,561,False
2015,05/31,Orlando,1.26,174419,19641,73,38303,17602,0,Spring,212722,37243,73,False
2015,05/24,Orlando,1.0,295794,29758,160,37157,39120,0,Spring,332951,68878,160,False
2015,05/17,Orlando,1.23,168886,19797,173,38066,16341,0,Spring,206952,36138,173,False
2015,05/10,Orlando,1.23,185586,19590,138,35990,15726,0,Spring,221576,35316,138,False
2015,05/03,Orlando,0.98,369352,36610,165,40398,54823,223,Spring,409750,91433,388,False
2015,04/26,Orlando,1.23,179052,21351,93,38167,18294,347,Spring,217219,39645,440,False
2015,04/19,Orlando,1.23,157931,18812,205,35504,19323,0,Spring,193435,38135,205,False
2015,04/12,Orlando,0.99,275283,28203,96,31886,39893,0,Spring,307169,68096,96,False
2015,04/05,Orlando,1.1,211116,25858,103,34091,29143,365,Spring,245207,55001,468,False
2015,03/29,Orlando,1.25,150612,18785,128,29215,18182,0,Spring,179827,36967,128,False
2015,03/22,Orlando,0.98,260635,29682,141,37453,35592,0,Spring,298088,65274,141,False
2015,03/15,Orlando,1.27,154931,21353,115,34513,15333,0,Spring,189444,36686,115,False
2015,03/08,Orlando,1.27,149785,19868,86,33996,15334,0,Spring,183781,35202,86,False
2015,03/01,Orlando,1.0,227527,26599,114,31707,30250,0,Spring,259234,56849,114,False
2015,02/22,Orlando,1.18,151270,22481,66,36700,16446,0,Winter,187970,38927,66,False
2015,02/15,Orlando,1.26,139189,21210,37,20733,23641,0,Winter,159922,44851,37,False
2015,02/08,Orlando,1.23,137587,24318,99,18229,24162,0,Winter,155816,48480,99,False
2015,02/01,Orlando,0.95,358731,50048,180,26854,53409,0,Winter,385585,103457,180,False
2015,01/25,Orlando,1.28,133616,29418,91,22591,26273,0,Winter,156207,55691,91,False
2015,01/18,Orlando,1.33,112722,34703,83,18914,24654,0,Winter,131636,59357,83,False
2015,01/11,Orlando,1.29,119336,39236,52,18762,24647,0,Winter,138098,63883,52,False
2015,01/04,Orlando,1.0,190743,38265,75,19933,32785,0,Winter,210676,71050,75,False
2015,12/27,Philadelphia,1.25,9778,208945,530,82776,6513,3,Winter,92554,215458,533,False
2015,12/20,Philadelphia,1.33,9646,198361,532,88587,9715,0,Winter,98233,208076,532,False
2015,12/13,Philadelphia,1.18,12500,244536,683,87738,6908,3,Winter,100238,251444,686,False
2015,12/06,Philadelphia,1.18,16536,254808,540,67405,7596,8,Winter,83941,262404,548,False
2015,11/29,Philadelphia,1.23,11335,195284,533,62262,5676,0,Fall,73597,200960,533,False
2015,11/22,Philadelphia,1.23,12680,226193,591,74840,5752,0,Fall,87520,231945,591,False
2015,11/15,Philadelphia,1.17,13989,263608,604,78169,7176,0,Fall,92158,270784,604,False
2015,11/08,Philadelphia,1.27,13866,268320,479,76143,16123,0,Fall,90009,284443,479,False
2015,11/01,Philadelphia,1.13,15179,453729,570,78873,11206,6,Fall,94052,464935,576,False
2015,10/25,Philadelphia,1.19,19897,283085,437,84288,10627,0,Fall,104185,293712,437,False
2015,10/18,Philadelphia,1.06,14369,388376,819,83101,9569,0,Fall,97470,397945,819,False
2015,10/11,Philadelphia,1.26,13073,256350,550,83281,20392,1,Fall,96354,276742,551,False
2015,10/04,Philadelphia,1.28,14121,268719,754,91635,12975,0,Fall,105756,281694,754,False
2015,09/27,Philadelphia,1.25,14983,255352,497,82669,15276,0,Fall,97652,270628,497,False
2015,09/20,Philadelphia,1.25,14832,251090,580,84698,10160,0,Fall,99530,261250,580,False
2015,09/13,Philadelphia,1.19,15898,346217,752,78976,12950,0,Fall,94874,359167,752,False
2015,09/06,Philadelphia,1.25,16018,284480,633,89096,8827,5,Fall,105114,293307,638,False
2015,08/30,Philadelphia,1.26,14942,269812,654,86293,9570,45,Summer,101235,279382,699,False
2015,08/23,Philadelphia,1.09,21862,336374,717,82479,8193,88,Summer,104341,344567,805,False
2015,08/16,Philadelphia,1.2,14748,324061,652,78393,7851,0,Summer,93141,331912,652,False
2015,08/09,Philadelphia,1.19,14929,294414,801,88554,6856,0,Summer,103483,301270,801,False
2015,08/02,Philadelphia,1.21,15487,288809,955,85344,8614,0,Summer,100831,297423,955,False
2015,07/26,Philadelphia,1.36,16844,251976,856,92024,11329,0,Summer,108868,263305,856,False
2015,07/19,Philadelphia,1.39,15791,237182,1472,103254,12272,0,Summer,119045,249454,1472,False
2015,07/12,Philadelphia,1.38,15106,233808,1885,109196,11757,308,Summer,124302,245565,2193,False
2015,07/05,Philadelphia,1.25,16232,306535,1024,122252,14370,43,Summer,138484,320905,1067,False
2015,06/28,Philadelphia,1.38,15520,234777,806,111168,16658,0,Summer,126688,251435,806,False
2015,06/21,Philadelphia,1.33,16066,310906,1155,117744,11040,70,Summer,133810,321946,1225,False
2015,06/14,Philadelphia,1.32,16036,253565,1064,130970,19779,97,Summer,147006,273344,1161,False
2015,06/07,Philadelphia,1.35,17117,325420,1339,116932,15941,75,Summer,134049,341361,1414,False
2015,05/31,Philadelphia,1.43,18200,270397,1068,130734,15496,131,Spring,148934,285893,1199,False
2015,05/24,Philadelphia,1.4,15940,277233,1055,129470,16871,2,Spring,145410,294104,1057,False
2015,05/17,Philadelphia,1.44,16905,241209,1129,116806,12725,23,Spring,133711,253934,1152,False
2015,05/10,Philadelphia,1.32,18571,381134,2051,118815,15350,0,Spring,137386,396484,2051,False
2015,05/03,Philadelphia,1.22,27871,393975,1834,106616,18018,238,Spring,134487,411993,2072,False
2015,04/26,Philadelphia,1.46,17337,249070,1439,100776,16917,0,Spring,118113,265987,1439,False
2015,04/19,Philadelphia,1.43,16585,242740,1309,110321,18457,0,Spring,126906,261197,1309,False
2015,04/12,Philadelphia,1.44,15208,210183,1217,95743,13036,0,Spring,110951,223219,1217,False
2015,04/05,Philadelphia,1.43,15897,240591,1290,94087,14028,51,Spring,109984,254619,1341,False
2015,03/29,Philadelphia,1.39,15819,222182,1168,88306,12400,0,Spring,104125,234582,1168,False
2015,03/22,Philadelphia,1.18,27380,322071,1104,85471,13234,0,Spring,112851,335305,1104,False
2015,03/15,Philadelphia,1.44,15055,199103,1077,102101,14118,0,Spring,117156,213221,1077,False
2015,03/08,Philadelphia,1.4,19780,207010,1051,106813,14953,1,Spring,126593,221963,1052,False
2015,03/01,Philadelphia,1.24,16329,267027,1528,93745,13782,0,Spring,110074,280809,1528,False
2015,02/22,Philadelphia,1.36,14876,214953,1353,105513,11518,0,Winter,120389,226471,1353,False
2015,02/15,Philadelphia,1.34,15920,210874,1259,97737,9380,0,Winter,113657,220254,1259,False
2015,02/08,Philadelphia,1.09,26219,336509,1353,100107,13683,1,Winter,126326,350192,1354,False
2015,02/01,Philadelphia,1.14,30263,417993,1722,104365,14959,0,Winter,134628,432952,1722,False
2015,01/25,Philadelphia,1.36,16112,211453,1409,110991,15679,0,Winter,127103,227132,1409,False
2015,01/18,Philadelphia,1.4,15116,209523,1469,93250,12135,0,Winter,108366,221658,1469,False
2015,01/11,Philadelphia,1.38,14323,198387,1715,88980,12578,0,Winter,103303,210965,1715,False
2015,01/04,Philadelphia,1.1,24190,294715,2121,72829,13817,0,Winter,97019,308532,2121,False
2015,12/27,PhoenixTucson,0.49,738314,286858,11642,70749,30142,0,Winter,809063,317000,11642,False
2015,12/20,PhoenixTucson,0.53,785254,204147,10346,72169,25305,0,Winter,857423,229452,10346,False
2015,12/13,PhoenixTucson,0.66,546182,241774,9429,92028,18054,0,Winter,638210,259828,9429,False
2015,12/06,PhoenixTucson,0.56,760680,271207,13354,60255,2,0,Winter,820935,271209,13354,False
2015,11/29,PhoenixTucson,0.75,449043,208439,9770,57662,0,0,Fall,506705,208439,9770,False
2015,11/22,PhoenixTucson,0.77,441712,220374,11102,63088,1555,0,Fall,504800,221929,11102,False
2015,11/15,PhoenixTucson,0.62,690246,244820,11412,63178,473,0,Fall,753424,245293,11412,False
2015,11/08,PhoenixTucson,0.6,793103,234926,11555,62666,19,0,Fall,855769,234945,11555,False
2015,11/01,PhoenixTucson,0.71,592066,232050,20971,62363,0,0,Fall,654429,232050,20971,False
2015,10/25,PhoenixTucson,0.83,435986,240689,19968,64585,30,0,Fall,500571,240719,19968,False
2015,10/18,PhoenixTucson,0.65,728349,287934,10255,68128,61,0,Fall,796477,287995,10255,False
2015,10/11,PhoenixTucson,0.89,382706,321487,19579,71955,2,0,Fall,454661,321489,19579,False
2015,10/04,PhoenixTucson,0.89,363730,269015,10663,82685,0,0,Fall,446415,269015,10663,False
2015,09/27,PhoenixTucson,0.91,364703,229488,9974,59972,63,0,Fall,424675,229551,9974,False
2015,09/20,PhoenixTucson,0.71,410147,403760,6031,64530,7681,0,Fall,474677,411441,6031,False
2015,09/13,PhoenixTucson,0.71,606856,294311,15399,74017,110315,0,Fall,680873,404626,15399,False
2015,09/06,PhoenixTucson,0.58,937165,293505,6101,93116,60528,0,Fall,1030281,354033,6101,False
2015,08/30,PhoenixTucson,0.74,610521,238518,5931,84714,99,0,Summer,695235,238617,5931,False
2015,08/23,PhoenixTucson,0.78,562928,228549,4923,75885,1570,0,Summer,638813,230119,4923,False
2015,08/16,PhoenixTucson,0.66,836443,223690,8294,95992,38729,0,Summer,932435,262419,8294,False
2015,08/09,PhoenixTucson,0.79,621184,228961,7040,79670,45118,0,Summer,700854,274079,7040,False
2015,08/02,PhoenixTucson,0.78,611966,205131,5261,80224,44284,0,Summer,692190,249415,5261,False
2015,07/26,PhoenixTucson,0.77,579515,204147,8805,77011,33762,0,Summer,656526,237909,8805,False
2015,07/19,PhoenixTucson,0.76,608209,200732,4302,84065,31290,0,Summer,692274,232022,4302,False
2015,07/12,PhoenixTucson,0.7,689407,201234,4759,84710,35134,319,Summer,774117,236368,5078,False
2015,07/05,PhoenixTucson,0.56,1096452,220124,5251,98977,36030,0,Summer,1195429,256154,5251,False
2015,06/28,PhoenixTucson,0.7,668071,176318,4419,84853,21848,0,Summer,752924,198166,4419,False
2015,06/21,PhoenixTucson,0.54,1028045,188115,4910,99129,22980,0,Summer,1127174,211095,4910,False
2015,06/14,PhoenixTucson,0.53,1046887,180388,4263,94240,28069,0,Summer,1141127,208457,4263,False
2015,06/07,PhoenixTucson,0.52,1130917,199669,4499,90030,32242,0,Summer,1220947,231911,4499,False
2015,05/31,PhoenixTucson,0.56,981853,177850,10400,81585,30405,0,Spring,1063438,208255,10400,False
2015,05/24,PhoenixTucson,0.58,968755,180676,6013,84441,21652,0,Spring,1053196,202328,6013,False
2015,05/17,PhoenixTucson,0.67,739725,167185,4706,77703,23727,0,Spring,817428,190912,4706,False
2015,05/10,PhoenixTucson,0.67,775683,182956,4878,77196,31585,0,Spring,852879,214541,4878,False
2015,05/03,PhoenixTucson,0.6,901701,256791,5692,80245,23882,294,Spring,981946,280673,5986,False
2015,04/26,PhoenixTucson,0.53,1012900,159158,5832,76637,17900,0,Spring,1089537,177058,5832,False
2015,04/19,PhoenixTucson,0.51,1097285,164460,7534,44646,52917,0,Spring,1141931,217377,7534,False
2015,04/12,PhoenixTucson,0.66,746352,181417,5732,39455,46322,0,Spring,785807,227739,5732,False
2015,04/05,PhoenixTucson,0.57,1058164,172115,7128,49271,33641,0,Spring,1107435,205756,7128,False
2015,03/29,PhoenixTucson,0.57,998057,157108,8638,43759,23702,0,Spring,1041816,180810,8638,False
2015,03/22,PhoenixTucson,0.71,813326,208871,6035,60874,8,0,Spring,874200,208879,6035,False
2015,03/15,PhoenixTucson,0.6,1104002,149254,6041,67422,0,0,Spring,1171424,149254,6041,False
2015,03/08,PhoenixTucson,0.72,824092,143842,5737,68487,0,0,Spring,892579,143842,5737,False
2015,03/01,PhoenixTucson,0.7,755408,198955,12551,64435,0,0,Spring,819843,198955,12551,False
2015,02/22,PhoenixTucson,0.63,925363,163229,6791,67727,3,0,Winter,993090,163232,6791,False
2015,02/15,PhoenixTucson,0.6,938840,143378,5938,71344,7,0,Winter,1010184,143385,5938,False
2015,02/08,PhoenixTucson,0.64,881998,184023,5517,79618,0,0,Winter,961616,184023,5517,False
2015,02/01,PhoenixTucson,0.56,1194635,261342,6335,82437,0,0,Winter,1277072,261342,6335,False
2015,01/25,PhoenixTucson,0.61,1002267,150640,5034,75558,2,0,Winter,1077825,150642,5034,False
2015,01/18,PhoenixTucson,0.67,811662,200514,5643,70788,0,0,Winter,882450,200514,5643,False
2015,01/11,PhoenixTucson,0.61,849580,182629,12237,66305,0,0,Winter,915885,182629,12237,False
2015,01/04,PhoenixTucson,0.65,770635,178418,6509,92499,0,0,Winter,863134,178418,6509,False
2015,12/27,Pittsburgh,1.25,1241,45856,951,17512,7392,156,Winter,18753,53248,1107,False
2015,12/20,Pittsburgh,1.22,1176,40726,1003,17094,8749,223,Winter,18270,49475,1226,False
2015,12/13,Pittsburgh,1.19,1219,38684,959,15525,8943,0,Winter,16744,47627,959,False
2015,12/06,Pittsburgh,1.21,1712,41481,1081,8739,8854,0,Winter,10451,50335,1081,False
2015,11/29,Pittsburgh,1.26,1443,35859,958,7946,8570,0,Fall,9389,44429,958,False
2015,11/22,Pittsburgh,1.3,1584,42392,1119,12552,5696,0,Fall,14136,48088,1119,False
2015,11/15,Pittsburgh,1.24,1179,42966,979,13712,5679,0,Fall,14891,48645,979,False
2015,11/08,Pittsburgh,0.93,1423,85217,2313,13430,21103,0,Fall,14853,106320,2313,False
2015,11/01,Pittsburgh,1.16,1523,60507,1706,12000,5835,0,Fall,13523,66342,1706,False
2015,10/25,Pittsburgh,1.22,2301,40984,1289,13587,11029,0,Fall,15888,52013,1289,False
2015,10/18,Pittsburgh,1.23,1700,43226,1465,13949,9791,0,Fall,15649,53017,1465,False
2015,10/11,Pittsburgh,0.96,981,59821,1535,14948,6767,0,Fall,15929,66588,1535,False
2015,10/04,Pittsburgh,0.99,1068,69555,2321,13300,3292,0,Fall,14368,72847,2321,False
2015,09/27,Pittsburgh,1.11,815,62972,1852,14361,11557,0,Fall,15176,74529,1852,False
2015,09/20,Pittsburgh,1.19,1137,44085,1176,19393,9033,0,Fall,20530,53118,1176,False
2015,09/13,Pittsburgh,1.16,1340,43000,998,21080,8542,0,Fall,22420,51542,998,False
2015,09/06,Pittsburgh,1.12,1158,78578,2074,23118,9284,0,Fall,24276,87862,2074,False
2015,08/30,Pittsburgh,1.37,1493,40727,3632,20079,8573,3,Summer,21572,49300,3635,False
2015,08/23,Pittsburgh,1.2,1411,51014,1714,18577,10477,0,Summer,19988,61491,1714,False
2015,08/16,Pittsburgh,1.23,1314,53769,1381,21335,9887,0,Summer,22649,63656,1381,False
2015,08/09,Pittsburgh,0.96,1306,99815,3021,26618,15168,0,Summer,27924,114983,3021,False
2015,08/02,Pittsburgh,1.43,1309,42703,1151,23664,5852,0,Summer,24973,48555,1151,False
2015,07/26,Pittsburgh,1.43,1421,40238,1088,20545,5642,0,Summer,21966,45880,1088,False
2015,07/19,Pittsburgh,1.44,1296,43696,1675,23700,2951,0,Summer,24996,46647,1675,False
2015,07/12,Pittsburgh,1.48,1229,40944,2652,21786,2221,11,Summer,23015,43165,2663,False
2015,07/05,Pittsburgh,1.23,1635,67122,5316,31488,10017,0,Summer,33123,77139,5316,False
2015,06/28,Pittsburgh,1.2,1548,62790,3823,31542,11981,3,Summer,33090,74771,3826,False
2015,06/21,Pittsburgh,1.34,1680,43292,4210,29949,9080,0,Summer,31629,52372,4210,False
2015,06/14,Pittsburgh,1.3,1614,44490,3147,34041,9418,0,Summer,35655,53908,3147,False
2015,06/07,Pittsburgh,1.33,1734,43816,1482,28434,9081,7,Summer,30168,52897,1489,False
2015,05/31,Pittsburgh,1.32,1472,45514,1439,24083,10498,0,Spring,25555,56012,1439,False
2015,05/24,Pittsburgh,1.01,2157,117543,3203,26280,31985,0,Spring,28437,149528,3203,False
2015,05/17,Pittsburgh,1.41,1822,50365,1406,24984,6827,0,Spring,26806,57192,1406,False
2015,05/10,Pittsburgh,1.46,2099,48280,1279,23419,7031,0,Spring,25518,55311,1279,False
2015,05/03,Pittsburgh,0.98,5264,145405,5183,24324,28644,0,Spring,29588,174049,5183,False
2015,04/26,Pittsburgh,1.44,1820,44304,1309,22762,9781,0,Spring,24582,54085,1309,False
2015,04/19,Pittsburgh,1.49,1724,43528,1286,29007,227,0,Spring,30731,43755,1286,False
2015,04/12,Pittsburgh,1.5,1734,38757,1180,27527,139,0,Spring,29261,38896,1180,False
2015,04/05,Pittsburgh,1.29,2256,48395,1645,23652,161,35,Spring,25908,48556,1680,False
2015,03/29,Pittsburgh,1.25,2566,51530,1503,14034,108,3,Spring,16600,51638,1506,False
2015,03/22,Pittsburgh,1.23,2604,46711,1370,10044,7769,0,Spring,12648,54480,1370,False
2015,03/15,Pittsburgh,1.23,2450,44600,1291,17661,5901,0,Spring,20111,50501,1291,False
2015,03/08,Pittsburgh,0.95,2148,116151,3731,19742,17962,0,Spring,21890,134113,3731,False
2015,03/01,Pittsburgh,1.25,841,39074,1225,19985,4357,0,Spring,20826,43431,1225,False
2015,02/22,Pittsburgh,1.26,1496,42829,1187,19166,5666,0,Winter,20662,48495,1187,False
2015,02/15,Pittsburgh,1.43,1773,32544,1559,19783,4553,0,Winter,21556,37097,1559,False
2015,02/08,Pittsburgh,1.38,1904,37355,990,20249,5860,0,Winter,22153,43215,990,False
2015,02/01,Pittsburgh,1.25,2685,75345,2164,20561,11308,0,Winter,23246,86653,2164,False
2015,01/25,Pittsburgh,1.32,1847,70060,2397,17599,6817,0,Winter,19446,76877,2397,False
2015,01/18,Pittsburgh,1.47,2147,36730,1075,12321,7037,0,Winter,14468,43767,1075,False
2015,01/11,Pittsburgh,1.54,1491,33759,1325,12165,5902,0,Winter,13656,39661,1325,False
2015,01/04,Pittsburgh,1.52,3013,35456,1561,11264,3660,0,Winter,14277,39116,1561,False
2015,12/27,Portland,1.01,87748,131201,16182,181763,44,249,Winter,269511,131245,16431,False
2015,12/20,Portland,0.98,82416,134956,13276,185479,29,140,Winter,267895,134985,13416,False
2015,12/13,Portland,0.93,94577,162734,12487,159009,109,186,Winter,253586,162843,12673,False
2015,12/06,Portland,0.73,90996,270188,13360,363808,4531,883,Winter,454804,274719,14243,False
2015,11/29,Portland,1.04,78566,113850,13672,147268,89,371,Fall,225834,113939,14043,False
2015,11/22,Portland,1.03,83017,131660,14806,150474,7,759,Fall,233491,131667,15565,False
2015,11/15,Portland,0.9,83998,199356,16340,258913,2157,7648,Fall,342911,201513,23988,False
2015,11/08,Portland,1.04,100419,152265,15085,136935,236,1605,Fall,237354,152501,16690,False
2015,11/01,Portland,1.06,98262,182672,11993,130164,123,258,Fall,228426,182795,12251,False
2015,10/25,Portland,0.91,95297,191061,13673,178207,1322,833,Fall,273504,192383,14506,False
2015,10/18,Portland,1.05,113111,188908,16086,119843,92,141,Fall,232954,189000,16227,False
2015,10/11,Portland,0.79,84270,324386,31627,211701,3997,1673,Fall,295971,328383,33300,False
2015,10/04,Portland,1.13,104149,172302,45229,99417,165,167,Fall,203566,172467,45396,False
2015,09/27,Portland,0.9,159779,187080,13101,124612,1,22,Fall,284391,187081,13123,False
2015,09/20,Portland,0.94,121425,291367,12831,140535,58,167,Fall,261960,291425,12998,False
2015,09/13,Portland,1.0,222536,181246,15103,116569,22,41,Fall,339105,181268,15144,False
2015,09/06,Portland,1.1,174913,188351,13357,88369,231,35,Fall,263282,188582,13392,False
2015,08/30,Portland,1.14,154462,186124,13235,73781,138,34,Summer,228243,186262,13269,False
2015,08/23,Portland,1.08,153011,274926,15312,101670,332,43,Summer,254681,275258,15355,False
2015,08/16,Portland,1.17,180693,190950,15332,78821,94,4,Summer,259514,191044,15336,False
2015,08/09,Portland,1.19,174171,185098,17536,71232,89,8,Summer,245403,185187,17544,False
2015,08/02,Portland,1.14,193728,217474,20132,69761,7,2,Summer,263489,217481,20134,False
2015,07/26,Portland,1.18,178906,171527,17189,66239,135,0,Summer,245145,171662,17189,False
2015,07/19,Portland,1.18,188492,180269,16444,56419,5228,8,Summer,244911,185497,16452,False
2015,07/12,Portland,1.02,264203,187613,17027,88288,10900,96,Summer,352491,198513,17123,False
2015,07/05,Portland,1.19,215805,273227,22969,59731,3256,8,Summer,275536,276483,22977,False
2015,06/28,Portland,1.16,196765,223128,21601,66557,98,22,Summer,263322,223226,21623,False
2015,06/21,Portland,1.08,170388,284787,32660,89830,14,1876,Summer,260218,284801,34536,False
2015,06/14,Portland,1.08,180452,323409,18608,99951,393,64,Summer,280403,323802,18672,False
2015,06/07,Portland,1.16,194122,239758,19235,90346,473,8,Summer,284468,240231,19243,False
2015,05/31,Portland,1.01,249742,226577,17218,106687,51,25,Spring,356429,226628,17243,False
2015,05/24,Portland,1.01,190231,295332,15508,104757,136,72,Spring,294988,295468,15580,False
2015,05/17,Portland,1.06,210129,162760,19253,94742,0,139,Spring,304871,162760,19392,False
2015,05/10,Portland,0.91,241819,295585,16212,121155,338,157,Spring,362974,295923,16369,False
2015,05/03,Portland,0.95,226738,305964,16791,94890,7,26,Spring,321628,305971,16817,False
2015,04/26,Portland,0.95,238672,224599,13860,94185,85,38,Spring,332857,224684,13898,False
2015,04/19,Portland,0.99,144514,337188,13456,114658,690,150,Spring,259172,337878,13606,False
2015,04/12,Portland,1.16,150701,199632,15964,67361,43,0,Spring,218062,199675,15964,False
2015,04/05,Portland,1.22,160806,178795,19335,73228,144,418,Spring,234034,178939,19753,False
2015,03/29,Portland,1.2,162580,163122,18487,57229,402,1,Spring,219809,163524,18488,False
2015,03/22,Portland,1.1,153885,213514,16449,42292,37,1,Spring,196177,213551,16450,False
2015,03/15,Portland,1.21,156506,160239,17300,58756,0,0,Spring,215262,160239,17300,False
2015,03/08,Portland,1.17,147899,201529,17444,52751,220,3,Spring,200650,201749,17447,False
2015,03/01,Portland,0.94,138994,359783,16252,79396,4310,17,Spring,218390,364093,16269,False
2015,02/22,Portland,1.11,117115,287695,15574,74573,74,0,Winter,191688,287769,15574,False
2015,02/15,Portland,1.23,140491,153003,16459,51454,2472,7,Winter,191945,155475,16466,False
2015,02/08,Portland,1.08,161940,232248,13386,38999,1125,0,Winter,200939,233373,13386,False
2015,02/01,Portland,0.98,165259,535324,15903,48200,11547,1,Winter,213459,546871,15904,False
2015,01/25,Portland,1.09,131530,229573,13384,40428,17854,0,Winter,171958,247427,13384,False
2015,01/18,Portland,1.11,155745,220991,14692,34402,13785,0,Winter,190147,234776,14692,False
2015,01/11,Portland,1.05,121596,292968,22743,64831,8012,0,Winter,186427,300980,22743,False
2015,01/04,Portland,0.97,126485,377138,19781,61308,15251,0,Winter,187793,392389,19781,False
2015,12/27,RaleighGreensboro,0.96,47444,86212,21669,52596,502,0,Winter,100040,86714,21669,False
2015,12/20,RaleighGreensboro,0.98,43169,78630,20913,46617,253,0,Winter,89786,78883,20913,False
2015,12/13,RaleighGreensboro,0.98,51042,86614,24041,45573,355,0,Winter,96615,86969,24041,False
2015,12/06,RaleighGreensboro,0.97,54037,84518,26500,45120,202,0,Winter,99157,84720,26500,False
2015,11/29,RaleighGreensboro,0.98,49084,72843,21863,41606,334,0,Fall,90690,73177,21863,False
2015,11/22,RaleighGreensboro,1.02,44120,75630,25366,33573,392,0,Fall,77693,76022,25366,False
2015,11/15,RaleighGreensboro,1.0,52380,112379,38424,34671,1134,0,Fall,87051,113513,38424,False
2015,11/08,RaleighGreensboro,1.07,61118,68546,52451,39551,1895,0,Fall,100669,70441,52451,False
2015,11/01,RaleighGreensboro,1.12,56638,60350,63741,46809,1990,0,Fall,103447,62340,63741,False
2015,10/25,RaleighGreensboro,1.22,52737,50170,50086,44925,1301,0,Fall,97662,51471,50086,False
2015,10/18,RaleighGreensboro,1.23,49804,64754,53069,48619,1333,0,Fall,98423,66087,53069,False
2015,10/11,RaleighGreensboro,1.17,47887,54545,69417,48621,2133,0,Fall,96508,56678,69417,False
2015,10/04,RaleighGreensboro,1.29,48417,56829,45935,34300,2209,0,Fall,82717,59038,45935,False
2015,09/27,RaleighGreensboro,1.12,47076,71030,69313,33593,1836,0,Fall,80669,72866,69313,False
2015,09/20,RaleighGreensboro,1.22,50149,63790,47238,52100,3241,0,Fall,102249,67031,47238,False
2015,09/13,RaleighGreensboro,1.16,63924,55553,37519,80146,1759,0,Fall,144070,57312,37519,False
2015,09/06,RaleighGreensboro,1.04,56439,83271,77352,83519,1058,0,Fall,139958,84329,77352,False
2015,08/30,RaleighGreensboro,1.16,52246,61767,42039,97342,182,0,Summer,149588,61949,42039,False
2015,08/23,RaleighGreensboro,1.13,50939,68496,46614,111602,325,0,Summer,162541,68821,46614,False
2015,08/16,RaleighGreensboro,1.23,50360,59216,47919,83231,392,0,Summer,133591,59608,47919,False
2015,08/09,RaleighGreensboro,1.23,42925,65067,44441,81028,607,0,Summer,123953,65674,44441,False
2015,08/02,RaleighGreensboro,1.22,49760,64419,44520,84232,315,0,Summer,133992,64734,44520,False
2015,07/26,RaleighGreensboro,1.2,50568,52944,41446,87050,195,0,Summer,137618,53139,41446,False
2015,07/19,RaleighGreensboro,1.2,46281,63762,45046,90363,1059,0,Summer,136644,64821,45046,False
2015,07/12,RaleighGreensboro,1.19,38293,78845,42204,86455,1367,0,Summer,124748,80212,42204,False
2015,07/05,RaleighGreensboro,1.16,42042,103086,40891,88239,1410,0,Summer,130281,104496,40891,False
2015,06/28,RaleighGreensboro,1.17,39793,84150,45055,86724,199,0,Summer,126517,84349,45055,False
2015,06/21,RaleighGreensboro,1.17,45414,87728,41369,89158,565,0,Summer,134572,88293,41369,False
2015,06/14,RaleighGreensboro,1.11,60157,95409,41274,89685,288,0,Summer,149842,95697,41274,False
2015,06/07,RaleighGreensboro,1.14,73208,61502,41892,82782,591,0,Summer,155990,62093,41892,False
2015,05/31,RaleighGreensboro,1.16,77231,60701,43537,80542,276,0,Spring,157773,60977,43537,False
2015,05/24,RaleighGreensboro,1.21,58855,80893,50072,76580,621,0,Spring,135435,81514,50072,False
2015,05/17,RaleighGreensboro,1.16,77565,64994,41158,80610,579,0,Spring,158175,65573,41158,False
2015,05/10,RaleighGreensboro,1.11,76699,60772,37794,91891,498,0,Spring,168590,61270,37794,False
2015,05/03,RaleighGreensboro,1.01,70984,108604,80829,73838,1147,59,Spring,144822,109751,80888,False
2015,04/26,RaleighGreensboro,1.16,75695,62292,38961,81554,978,140,Spring,157249,63270,39101,False
2015,04/19,RaleighGreensboro,1.13,67458,58452,36476,92654,393,0,Spring,160112,58845,36476,False
2015,04/12,RaleighGreensboro,1.1,71379,72736,37443,92113,1312,0,Spring,163492,74048,37443,False
2015,04/05,RaleighGreensboro,1.12,68933,53335,37207,85179,836,0,Spring,154112,54171,37207,False
2015,03/29,RaleighGreensboro,1.23,56270,71237,44155,66273,1055,0,Spring,122543,72292,44155,False
2015,03/22,RaleighGreensboro,1.19,78241,60049,37929,67695,741,0,Spring,145936,60790,37929,False
2015,03/15,RaleighGreensboro,1.18,66629,71027,46569,68114,186,0,Spring,134743,71213,46569,False
2015,03/08,RaleighGreensboro,1.24,41324,54059,37877,65493,144,0,Spring,106817,54203,37877,False
2015,03/01,RaleighGreensboro,1.2,57245,55213,36330,67743,309,0,Spring,124988,55522,36330,False
2015,02/22,RaleighGreensboro,1.11,65910,69081,69371,53806,559,0,Winter,119716,69640,69371,False
2015,02/15,RaleighGreensboro,1.21,66005,55126,48502,49618,11378,0,Winter,115623,66504,48502,False
2015,02/08,RaleighGreensboro,1.14,68078,47671,33712,62051,10971,0,Winter,130129,58642,33712,False
2015,02/01,RaleighGreensboro,0.99,79507,115316,88450,41191,19822,0,Winter,120698,135138,88450,False
2015,01/25,RaleighGreensboro,1.16,61158,59374,36067,63206,13469,0,Winter,124364,72843,36067,False
2015,01/18,RaleighGreensboro,1.22,48613,55881,39543,46298,14167,0,Winter,94911,70048,39543,False
2015,01/11,RaleighGreensboro,1.24,43986,54185,41272,50818,15497,0,Winter,94804,69682,41272,False
2015,01/04,RaleighGreensboro,1.2,53316,72178,39928,44040,11623,0,Winter,97356,83801,39928,False
2015,12/27,RichmondNorfolk,0.98,46837,67974,5986,40770,3,5,Winter,87607,67977,5991,False
2015,12/20,RichmondNorfolk,0.99,45598,73851,5425,33982,5,7,Winter,79580,73856,5432,False
2015,12/13,RichmondNorfolk,0.98,57804,75113,7096,34365,0,0,Winter,92169,75113,7096,False
2015,12/06,RichmondNorfolk,0.98,65474,77494,7028,26727,6,0,Winter,92201,77500,7028,False
2015,11/29,RichmondNorfolk,0.99,46757,65442,5499,23240,0,0,Fall,69997,65442,5499,False
2015,11/22,RichmondNorfolk,1.01,44462,69493,6545,27736,2,2,Fall,72198,69495,6547,False
2015,11/15,RichmondNorfolk,0.94,57421,101470,9940,29466,634,0,Fall,86887,102104,9940,False
2015,11/08,RichmondNorfolk,0.95,83635,76222,12315,29783,875,0,Fall,113418,77097,12315,False
2015,11/01,RichmondNorfolk,1.0,72020,93880,16391,29676,884,0,Fall,101696,94764,16391,False
2015,10/25,RichmondNorfolk,1.02,68613,70131,13184,27568,817,0,Fall,96181,70948,13184,False
2015,10/18,RichmondNorfolk,1.0,70405,106053,13205,27252,280,24,Fall,97657,106333,13229,False
2015,10/11,RichmondNorfolk,1.01,61756,85083,16004,28741,617,27,Fall,90497,85700,16031,False
2015,10/04,RichmondNorfolk,1.04,67267,91381,11357,30425,389,0,Fall,97692,91770,11357,False
2015,09/27,RichmondNorfolk,0.97,61853,101484,16430,23139,766,0,Fall,84992,102250,16430,False
2015,09/20,RichmondNorfolk,1.04,76712,72627,11692,34070,640,0,Fall,110782,73267,11692,False
2015,09/13,RichmondNorfolk,1.01,86208,89290,9499,43507,715,0,Fall,129715,90005,9499,False
2015,09/06,RichmondNorfolk,0.98,72054,112958,19484,48304,48,2,Fall,120358,113006,19486,False
2015,08/30,RichmondNorfolk,1.06,70639,86152,10562,45766,0,0,Summer,116405,86152,10562,False
2015,08/23,RichmondNorfolk,1.04,76650,96308,12155,46959,0,0,Summer,123609,96308,12155,False
2015,08/16,RichmondNorfolk,1.05,70382,95071,12570,44672,0,0,Summer,115054,95071,12570,False
2015,08/09,RichmondNorfolk,1.06,72133,87338,12731,44376,0,0,Summer,116509,87338,12731,False
2015,08/02,RichmondNorfolk,1.05,76879,101904,13008,43712,0,0,Summer,120591,101904,13008,False
2015,07/26,RichmondNorfolk,1.03,74157,86910,11762,50052,0,0,Summer,124209,86910,11762,False
2015,07/19,RichmondNorfolk,1.02,74921,84052,12403,53877,3,0,Summer,128798,84055,12403,False
2015,07/12,RichmondNorfolk,1.02,80375,90573,12718,50740,160,0,Summer,131115,90733,12718,False
2015,07/05,RichmondNorfolk,1.01,94880,118022,15212,58905,551,0,Summer,153785,118573,15212,False
2015,06/28,RichmondNorfolk,1.0,78419,90965,11394,55427,4,0,Summer,133846,90969,11394,False
2015,06/21,RichmondNorfolk,1.01,95486,99696,11120,58619,0,0,Summer,154105,99696,11120,False
2015,06/14,RichmondNorfolk,0.98,102242,113772,10989,62286,0,0,Summer,164528,113772,10989,False
2015,06/07,RichmondNorfolk,1.02,84737,90992,10333,61701,882,0,Summer,146438,91874,10333,False
2015,05/31,RichmondNorfolk,1.02,102486,98090,11466,53587,4968,0,Spring,156073,103058,11466,False
2015,05/24,RichmondNorfolk,1.03,91042,116589,13055,56304,3246,2,Spring,147346,119835,13057,False
2015,05/17,RichmondNorfolk,1.04,91276,103883,11273,52612,3458,5,Spring,143888,107341,11278,False
2015,05/10,RichmondNorfolk,1.06,72224,115679,11036,57579,6507,0,Spring,129803,122186,11036,False
2015,05/03,RichmondNorfolk,0.99,89712,128429,21169,51895,1238,298,Spring,141607,129667,21467,False
2015,04/26,RichmondNorfolk,1.11,76765,97538,11133,49595,390,122,Spring,126360,97928,11255,False
2015,04/19,RichmondNorfolk,1.1,75898,91143,10864,53008,727,0,Spring,128906,91870,10864,False
2015,04/12,RichmondNorfolk,1.11,60609,96301,9863,44510,1747,0,Spring,105119,98048,9863,False
2015,04/05,RichmondNorfolk,1.14,69929,95585,9827,45789,990,0,Spring,115718,96575,9827,False
2015,03/29,RichmondNorfolk,1.15,54695,96405,11552,42423,876,0,Spring,97118,97281,11552,False
2015,03/22,RichmondNorfolk,1.12,61853,91980,10380,48817,55,0,Spring,110670,92035,10380,False
2015,03/15,RichmondNorfolk,1.16,66591,87711,11621,44199,0,0,Spring,110790,87711,11621,False
2015,03/08,RichmondNorfolk,1.19,50712,64964,10295,51568,0,0,Spring,102280,64964,10295,False
2015,03/01,RichmondNorfolk,1.13,53902,83985,9840,47039,29,0,Spring,100941,84014,9840,False
2015,02/22,RichmondNorfolk,1.1,75550,89874,17018,43046,340,0,Winter,118596,90214,17018,False
2015,02/15,RichmondNorfolk,1.13,70877,77855,10942,41738,5836,0,Winter,112615,83691,10942,False
2015,02/08,RichmondNorfolk,1.06,74594,81138,7883,42969,6301,0,Winter,117563,87439,7883,False
2015,02/01,RichmondNorfolk,0.97,99429,140203,21686,40189,6952,0,Winter,139618,147155,21686,False
2015,01/25,RichmondNorfolk,1.17,54046,75205,8644,45878,10311,0,Winter,99924,85516,8644,False
2015,01/18,RichmondNorfolk,1.18,54459,66963,9958,36798,10858,0,Winter,91257,77821,9958,False
2015,01/11,RichmondNorfolk,1.15,71743,66849,10952,36160,8754,0,Winter,107903,75603,10952,False
2015,01/04,RichmondNorfolk,1.13,56293,80396,9762,31778,4467,0,Winter,88071,84863,9762,False
2015,12/27,Roanoke,0.96,33255,31680,152,32877,0,619,Winter,66132,31680,771,False
2015,12/20,Roanoke,1.0,27512,31883,116,27888,8,773,Winter,55400,31891,889,False
2015,12/13,Roanoke,1.01,38378,34347,127,27030,2,0,Winter,65408,34349,127,False
2015,12/06,Roanoke,1.01,41191,35662,100,22565,0,0,Winter,63756,35662,100,False
2015,11/29,Roanoke,1.03,24165,30145,114,19307,0,0,Fall,43472,30145,114,False
2015,11/22,Roanoke,1.0,28956,29324,163,25520,0,0,Fall,54476,29324,163,False
2015,11/15,Roanoke,1.0,41213,45406,99,23209,0,0,Fall,64422,45406,99,False
2015,11/08,Roanoke,1.01,53190,35852,135,24873,73,0,Fall,78063,35925,135,False
2015,11/01,Roanoke,1.0,54831,40083,177,20934,771,0,Fall,75765,40854,177,False
2015,10/25,Roanoke,0.99,57250,33829,153,19231,430,0,Fall,76481,34259,153,False
2015,10/18,Roanoke,0.98,48540,47290,115,21570,0,0,Fall,70110,47290,115,False
2015,10/11,Roanoke,1.01,53713,37828,151,26312,3,0,Fall,80025,37831,151,False
2015,10/04,Roanoke,1.04,51177,38394,126,24788,0,0,Fall,75965,38394,126,False
2015,09/27,Roanoke,1.01,44983,44626,84,19577,0,3,Fall,64560,44626,87,False
2015,09/20,Roanoke,1.0,64728,37055,128,23770,0,0,Fall,88498,37055,128,False
2015,09/13,Roanoke,0.99,69411,49831,180,28181,12,0,Fall,97592,49843,180,False
2015,09/06,Roanoke,1.09,42757,55250,139,33001,42,6,Fall,75758,55292,145,False
2015,08/30,Roanoke,1.14,39821,43618,261,29963,389,0,Summer,69784,44007,261,False
2015,08/23,Roanoke,1.12,38976,47017,318,27837,1458,0,Summer,66813,48475,318,False
2015,08/16,Roanoke,1.13,40667,43698,411,29038,0,0,Summer,69705,43698,411,False
2015,08/09,Roanoke,1.09,45164,40962,76,30114,0,0,Summer,75278,40962,76,False
2015,08/02,Roanoke,1.04,48105,45920,92,28450,0,0,Summer,76555,45920,92,False
2015,07/26,Roanoke,1.04,48519,38794,67,31073,0,0,Summer,79592,38794,67,False
2015,07/19,Roanoke,1.04,48761,41554,110,33820,0,0,Summer,82581,41554,110,False
2015,07/12,Roanoke,1.06,50647,42235,740,34430,0,0,Summer,85077,42235,740,False
2015,07/05,Roanoke,1.05,54928,51261,2541,39017,0,0,Summer,93945,51261,2541,False
2015,06/28,Roanoke,1.04,50052,43905,68,37248,0,0,Summer,87300,43905,68,False
2015,06/21,Roanoke,1.05,51621,47601,73,36598,0,0,Summer,88219,47601,73,False
2015,06/14,Roanoke,1.02,58275,50914,19,38416,6,0,Summer,96691,50920,19,False
2015,06/07,Roanoke,1.05,58789,41702,109,38372,490,0,Summer,97161,42192,109,False
2015,05/31,Roanoke,1.06,57819,41122,33,33050,1831,0,Spring,90869,42953,33,False
2015,05/24,Roanoke,1.07,55748,50452,99,34793,1180,0,Spring,90541,51632,99,False
2015,05/17,Roanoke,1.08,55106,46302,68,32381,1422,0,Spring,87487,47724,68,False
2015,05/10,Roanoke,1.09,52698,52242,146,34415,2357,0,Spring,87113,54599,146,False
2015,05/03,Roanoke,1.03,54015,60973,120,32327,253,0,Spring,86342,61226,120,False
2015,04/26,Roanoke,1.09,63041,47028,81,27733,0,0,Spring,90774,47028,81,False
2015,04/19,Roanoke,1.08,68391,44913,146,30623,589,0,Spring,99014,45502,146,False
2015,04/12,Roanoke,1.13,50246,49285,130,28274,1761,0,Spring,78520,51046,130,False
2015,04/05,Roanoke,1.19,48155,44874,258,27849,432,0,Spring,76004,45306,258,False
2015,03/29,Roanoke,1.13,46540,46915,110,22961,1134,0,Spring,69501,48049,110,False
2015,03/22,Roanoke,1.09,51584,46659,102,28170,15,3,Spring,79754,46674,105,False
2015,03/15,Roanoke,1.12,47388,43327,73,27985,348,0,Spring,75373,43675,73,False
2015,03/08,Roanoke,1.16,43783,36289,81,31447,100,0,Spring,75230,36389,81,False
2015,03/01,Roanoke,1.11,45568,38348,79,26965,28,0,Spring,72533,38376,79,False
2015,02/22,Roanoke,1.09,55931,45806,43,25882,191,0,Winter,81813,45997,43,False
2015,02/15,Roanoke,1.07,68986,39203,87,26632,2041,0,Winter,95618,41244,87,False
2015,02/08,Roanoke,1.02,78195,38763,134,25981,2572,0,Winter,104176,41335,134,False
2015,02/01,Roanoke,1.0,71867,65784,93,27117,3353,0,Winter,98984,69137,93,False
2015,01/25,Roanoke,1.15,48244,41412,103,29161,4148,0,Winter,77405,45560,103,False
2015,01/18,Roanoke,1.18,44676,37854,117,25952,3504,0,Winter,70628,41358,117,False
2015,01/11,Roanoke,1.16,45706,37629,57,26555,3286,0,Winter,72261,40915,57,False
2015,01/04,Roanoke,1.13,48285,37562,34,21582,1750,0,Winter,69867,39312,34,False
2015,12/27,Sacramento,0.98,98482,249362,13805,42084,5,0,Winter,140566,249367,13805,False
2015,12/20,Sacramento,1.0,99604,224843,15917,45138,8,5,Winter,144742,224851,15922,False
2015,12/13,Sacramento,1.0,94854,221627,16953,43250,2,0,Winter,138104,221629,16953,False
2015,12/06,Sacramento,1.07,82537,184349,12748,38638,0,5,Winter,121175,184349,12753,False
2015,11/29,Sacramento,0.99,80757,216851,13205,36574,0,17,Fall,117331,216851,13222,False
2015,11/22,Sacramento,1.06,83984,218912,12684,39405,0,0,Fall,123389,218912,12684,False
2015,11/15,Sacramento,0.94,100343,262929,11181,39707,0,0,Fall,140050,262929,11181,False
2015,11/08,Sacramento,1.14,118696,185189,11093,42153,0,0,Fall,160849,185189,11093,False
2015,11/01,Sacramento,1.02,180210,300978,12762,38515,0,0,Fall,218725,300978,12762,False
2015,10/25,Sacramento,1.26,98792,190021,12903,42041,0,0,Fall,140833,190021,12903,False
2015,10/18,Sacramento,1.28,94529,175181,12783,43963,0,0,Fall,138492,175181,12783,False
2015,10/11,Sacramento,1.29,85276,211955,13141,45098,0,0,Fall,130374,211955,13141,False
2015,10/04,Sacramento,1.1,70755,259002,12312,35121,0,0,Fall,105876,259002,12312,False
2015,09/27,Sacramento,1.28,84527,213297,13481,39676,0,0,Fall,124203,213297,13481,False
2015,09/20,Sacramento,1.25,79142,220538,12364,41185,0,0,Fall,120327,220538,12364,False
2015,09/13,Sacramento,1.24,101189,220364,15102,47530,4,0,Fall,148719,220368,15102,False
2015,09/06,Sacramento,1.21,137388,262139,17201,49967,8,0,Fall,187355,262147,17201,False
2015,08/30,Sacramento,1.3,114804,197034,17331,48058,0,0,Summer,162862,197034,17331,False
2015,08/23,Sacramento,1.26,112710,233164,12415,46984,0,0,Summer,159694,233164,12415,False
2015,08/16,Sacramento,1.3,136485,202459,13395,49356,11,0,Summer,185841,202470,13395,False
2015,08/09,Sacramento,1.28,146135,206011,13618,49041,17,0,Summer,195176,206028,13618,False
2015,08/02,Sacramento,1.33,131156,209986,14770,48750,0,0,Summer,179906,209986,14770,False
2015,07/26,Sacramento,1.32,130034,200668,13184,51550,33,0,Summer,181584,200701,13184,False
2015,07/19,Sacramento,1.29,130412,210334,9285,54572,0,0,Summer,184984,210334,9285,False
2015,07/12,Sacramento,1.23,130109,218611,6078,56976,0,152,Summer,187085,218611,6230,False
2015,07/05,Sacramento,1.26,161220,305122,17131,67335,0,0,Summer,228555,305122,17131,False
2015,06/28,Sacramento,1.26,143118,210343,13590,56932,0,0,Summer,200050,210343,13590,False
2015,06/21,Sacramento,1.27,137206,215068,14700,55744,4,0,Summer,192950,215072,14700,False
2015,06/14,Sacramento,1.22,149611,209926,13867,58386,0,0,Summer,207997,209926,13867,False
2015,06/07,Sacramento,1.18,143063,224039,14288,53695,0,0,Summer,196758,224039,14288,False
2015,05/31,Sacramento,1.17,156719,219047,14172,45775,8,0,Spring,202494,219055,14172,False
2015,05/24,Sacramento,1.26,110289,232223,12830,48450,0,0,Spring,158739,232223,12830,False
2015,05/17,Sacramento,1.18,141111,200745,12034,43324,0,0,Spring,184435,200745,12034,False
2015,05/10,Sacramento,1.14,162135,217681,13246,44760,0,0,Spring,206895,217681,13246,False
2015,05/03,Sacramento,1.05,149107,458178,13261,41281,0,204,Spring,190388,458178,13465,False
2015,04/26,Sacramento,1.27,101324,205561,13085,46748,0,0,Spring,148072,205561,13085,False
2015,04/19,Sacramento,1.19,117518,241637,13267,43392,25,0,Spring,160910,241662,13267,False
2015,04/12,Sacramento,1.24,119295,208546,13073,41625,42,0,Spring,160920,208588,13073,False
2015,04/05,Sacramento,1.23,120613,214547,15099,54049,25,0,Spring,174662,214572,15099,False
2015,03/29,Sacramento,1.2,110809,203705,13740,62884,38,0,Spring,173693,203743,13740,False
2015,03/22,Sacramento,1.13,106578,221094,13423,83611,0,0,Spring,190189,221094,13423,False
2015,03/15,Sacramento,1.22,113759,204089,14830,48082,0,0,Spring,161841,204089,14830,False
2015,03/08,Sacramento,1.12,152131,199610,13402,50002,0,0,Spring,202133,199610,13402,False
2015,03/01,Sacramento,1.02,143867,256090,13870,39017,0,0,Spring,182884,256090,13870,False
2015,02/22,Sacramento,1.14,137425,216791,11561,39235,0,0,Winter,176660,216791,11561,False
2015,02/15,Sacramento,1.13,134992,194031,10273,41744,0,0,Winter,176736,194031,10273,False
2015,02/08,Sacramento,0.98,144586,237751,9798,40435,0,0,Winter,185021,237751,9798,False
2015,02/01,Sacramento,1.04,287292,429601,15342,39738,0,0,Winter,327030,429601,15342,False
2015,01/25,Sacramento,1.19,101289,210411,9507,38819,0,0,Winter,140108,210411,9507,False
2015,01/18,Sacramento,1.22,83097,238956,5672,39320,0,0,Winter,122417,238956,5672,False
2015,01/11,Sacramento,1.09,109368,271300,5094,43722,6,0,Winter,153090,271306,5094,False
2015,01/04,Sacramento,1.05,110693,270107,9737,39600,0,0,Winter,150293,270107,9737,False
2015,12/27,SanDiego,0.92,141447,130341,20174,116383,31621,0,Winter,257830,161962,20174,False
2015,12/20,SanDiego,0.94,130565,119298,25052,111019,34540,0,Winter,241584,153838,25052,False
2015,12/13,SanDiego,0.84,155111,118664,16726,128053,43991,0,Winter,283164,162655,16726,False
2015,12/06,SanDiego,0.67,196490,209350,17406,114044,28225,0,Winter,310534,237575,17406,False
2015,11/29,SanDiego,0.91,143861,140359,20206,64857,16004,0,Fall,208718,156363,20206,False
2015,11/22,SanDiego,0.98,163396,129579,18973,59945,13404,0,Fall,223341,142983,18973,False
2015,11/15,SanDiego,0.85,264103,150523,15638,63091,8482,0,Fall,327194,159005,15638,False
2015,11/08,SanDiego,0.92,255993,154270,16457,58719,6944,0,Fall,314712,161214,16457,False
2015,11/01,SanDiego,1.01,211287,179995,17716,53567,5897,8,Fall,264854,185892,17724,False
2015,10/25,SanDiego,1.08,172518,165522,18702,48469,3117,4,Fall,220987,168639,18706,False
2015,10/18,SanDiego,1.03,197862,179049,19380,47913,3456,0,Fall,245775,182505,19380,False
2015,10/11,SanDiego,0.93,202263,234833,17638,35490,2050,0,Fall,237753,236883,17638,False
2015,10/04,SanDiego,1.11,154884,194838,18666,31952,3960,0,Fall,186836,198798,18666,False
2015,09/27,SanDiego,0.93,194526,245815,14807,34448,2392,0,Fall,228974,248207,14807,False
2015,09/20,SanDiego,1.07,204096,173105,28629,39560,3095,0,Fall,243656,176200,28629,False
2015,09/13,SanDiego,1.08,191302,199953,21645,46655,4747,0,Fall,237957,204700,21645,False
2015,09/06,SanDiego,1.02,271640,165034,19961,41719,4321,0,Fall,313359,169355,19961,False
2015,08/30,SanDiego,1.04,277305,145974,19843,45500,1645,0,Summer,322805,147619,19843,False
2015,08/23,SanDiego,1.15,250163,153378,20782,33582,1563,0,Summer,283745,154941,20782,False
2015,08/16,SanDiego,1.05,281209,176899,16942,38649,502,0,Summer,319858,177401,16942,False
2015,08/09,SanDiego,1.03,285569,288086,14248,41132,1904,0,Summer,326701,289990,14248,False
2015,08/02,SanDiego,1.07,275822,168300,12740,42995,1139,0,Summer,318817,169439,12740,False
2015,07/26,SanDiego,1.1,279280,161574,16605,36718,1165,0,Summer,315998,162739,16605,False
2015,07/19,SanDiego,1.15,258240,142492,16611,41231,3950,0,Summer,299471,146442,16611,False
2015,07/12,SanDiego,1.1,251056,182844,14524,38417,3469,0,Summer,289473,186313,14524,False
2015,07/05,SanDiego,1.05,328818,187820,18794,46816,5490,0,Summer,375634,193310,18794,False
2015,06/28,SanDiego,1.02,295023,142348,15418,37940,4578,0,Summer,332963,146926,15418,False
2015,06/21,SanDiego,0.94,368402,163855,16575,41075,4578,0,Summer,409477,168433,16575,False
2015,06/14,SanDiego,0.87,403551,165020,14478,43522,4173,0,Summer,447073,169193,14478,False
2015,06/07,SanDiego,0.89,378749,164367,13914,46211,4224,0,Summer,424960,168591,13914,False
2015,05/31,SanDiego,0.9,358147,153680,14150,39195,4240,0,Spring,397342,157920,14150,False
2015,05/24,SanDiego,1.08,273672,155813,13519,29727,4682,0,Spring,303399,160495,13519,False
2015,05/17,SanDiego,1.02,283530,131772,9903,29400,3585,0,Spring,312930,135357,9903,False
2015,05/10,SanDiego,0.85,399789,136147,11997,43190,3614,0,Spring,442979,139761,11997,False
2015,05/03,SanDiego,0.8,424263,247709,14408,50153,4224,0,Spring,474416,251933,14408,False
2015,04/26,SanDiego,1.11,235664,141949,14634,37689,6053,0,Spring,273353,148002,14634,False
2015,04/19,SanDiego,1.04,270328,156651,13282,25453,22379,0,Spring,295781,179030,13282,False
2015,04/12,SanDiego,1.01,260591,189713,14665,26305,23949,21,Spring,286896,213662,14686,False
2015,04/05,SanDiego,1.11,249036,162601,15718,25464,16966,95,Spring,274500,179567,15813,False
2015,03/29,SanDiego,1.08,234361,155583,14998,25798,19629,0,Spring,260159,175212,14998,False
2015,03/22,SanDiego,0.96,235106,221942,14165,38487,6063,0,Spring,273593,228005,14165,False
2015,03/15,SanDiego,1.06,257709,144761,17440,37920,5268,7,Spring,295629,150029,17447,False
2015,03/08,SanDiego,0.95,314550,127157,14754,42719,5102,0,Spring,357269,132259,14754,False
2015,03/01,SanDiego,0.83,317625,202619,14036,32922,5315,32,Spring,350547,207934,14068,False
2015,02/22,SanDiego,0.92,301983,151869,14484,42234,5543,32,Winter,344217,157412,14516,False
2015,02/15,SanDiego,0.94,303637,127874,15333,33642,5425,199,Winter,337279,133299,15532,False
2015,02/08,SanDiego,0.98,229118,162856,14251,36417,5526,223,Winter,265535,168382,14474,False
2015,02/01,SanDiego,0.85,357235,277723,15691,36622,4738,265,Winter,393857,282461,15956,False
2015,01/25,SanDiego,1.02,217747,140456,13326,30090,4708,261,Winter,247837,145164,13587,False
2015,01/18,SanDiego,1.01,250311,163944,14125,27844,4411,426,Winter,278155,168355,14551,False
2015,01/11,SanDiego,0.82,303369,192913,12900,31807,3271,404,Winter,335176,196184,13304,False
2015,01/04,SanDiego,0.94,244152,165299,15302,30884,5595,373,Winter,275036,170894,15675,False
2015,12/27,SanFrancisco,1.05,181704,422617,28184,59094,582,21,Winter,240798,423199,28205,False
2015,12/20,SanFrancisco,1.15,173521,364622,33083,65038,766,59,Winter,238559,365388,33142,False
2015,12/13,SanFrancisco,1.22,127080,384958,34069,69022,781,103,Winter,196102,385739,34172,False
2015,12/06,SanFrancisco,1.06,102771,498975,37321,55171,638,103,Winter,157942,499613,37424,False
2015,11/29,SanFrancisco,1.05,102783,462966,31195,53992,647,53,Fall,156775,463613,31248,False
2015,11/22,SanFrancisco,1.04,121232,502068,29410,55908,773,50,Fall,177140,502841,29460,False
2015,11/15,SanFrancisco,0.99,165884,517366,27969,63811,780,38,Fall,229695,518146,28007,False
2015,11/08,SanFrancisco,1.4,165981,319176,36598,77364,693,70,Fall,243345,319869,36668,False
2015,11/01,SanFrancisco,0.97,214932,563719,31481,58929,845,19,Fall,273861,564564,31500,False
2015,10/25,SanFrancisco,1.55,126498,334051,31358,68582,812,38,Fall,195080,334863,31396,False
2015,10/18,SanFrancisco,1.52,146584,332942,31021,74724,756,44,Fall,221308,333698,31065,False
2015,10/11,SanFrancisco,1.58,106180,351965,33512,72030,735,32,Fall,178210,352700,33544,False
2015,10/04,SanFrancisco,1.04,119177,563257,32511,47092,796,31,Fall,166269,564053,32542,False
2015,09/27,SanFrancisco,1.38,208309,349648,28301,64581,785,70,Fall,272890,350433,28371,False
2015,09/20,SanFrancisco,1.56,94105,380999,33739,68664,946,44,Fall,162769,381945,33783,False
2015,09/13,SanFrancisco,1.53,110779,367833,48322,76151,734,19,Fall,186930,368567,48341,False
2015,09/06,SanFrancisco,1.54,154276,384033,30732,76963,805,0,Fall,231239,384838,30732,False
2015,08/30,SanFrancisco,1.53,177166,364371,28647,78843,863,0,Summer,256009,365234,28647,False
2015,08/23,SanFrancisco,1.59,129106,380934,27089,72131,950,0,Summer,201237,381884,27089,False
2015,08/16,SanFrancisco,1.59,145519,364968,27530,79372,846,0,Summer,224891,365814,27530,False
2015,08/09,SanFrancisco,1.56,158022,345590,24997,74158,1108,0,Summer,232180,346698,24997,False
2015,08/02,SanFrancisco,1.57,164972,374726,28138,76597,723,0,Summer,241569,375449,28138,False
2015,07/26,SanFrancisco,1.58,150230,366576,32096,78533,893,0,Summer,228763,367469,32096,False
2015,07/19,SanFrancisco,1.56,146180,385520,19150,81674,801,0,Summer,227854,386321,19150,False
2015,07/12,SanFrancisco,1.39,149802,430540,10213,88477,893,423,Summer,238279,431433,10636,False
2015,07/05,SanFrancisco,1.53,168468,451890,30802,100146,882,0,Summer,268614,452772,30802,False
2015,06/28,SanFrancisco,1.54,154423,377054,29603,84459,783,0,Summer,238882,377837,29603,False
2015,06/21,SanFrancisco,1.52,161726,396191,29789,84970,1043,0,Summer,246696,397234,29789,False
2015,06/14,SanFrancisco,1.51,181175,403173,32092,79360,1071,0,Summer,260535,404244,32092,False
2015,06/07,SanFrancisco,1.31,167496,477146,36846,76252,1075,0,Summer,243748,478221,36846,False
2015,05/31,SanFrancisco,1.29,192708,469208,26109,75077,1009,0,Spring,267785,470217,26109,False
2015,05/24,SanFrancisco,1.37,131638,467572,23810,76306,1083,0,Spring,207944,468655,23810,False
2015,05/17,SanFrancisco,1.32,167532,434957,26013,71643,952,0,Spring,239175,435909,26013,False
2015,05/10,SanFrancisco,1.3,172662,462218,33343,73411,1035,0,Spring,246073,463253,33343,False
2015,05/03,SanFrancisco,1.0,237060,975141,32834,64042,971,313,Spring,301102,976112,33147,False
2015,04/26,SanFrancisco,1.39,107461,458055,35558,78503,1052,206,Spring,185964,459107,35764,False
2015,04/19,SanFrancisco,1.23,134592,584922,25208,72532,1560,0,Spring,207124,586482,25208,False
2015,04/12,SanFrancisco,1.33,159838,469655,25315,73789,1291,0,Spring,233627,470946,25315,False
2015,04/05,SanFrancisco,1.33,143671,473142,35650,88603,1025,445,Spring,232274,474167,36095,False
2015,03/29,SanFrancisco,1.3,145294,460144,26459,109753,930,0,Spring,255047,461074,26459,False
2015,03/22,SanFrancisco,1.19,136354,568189,30959,105385,818,15,Spring,241739,569007,30974,False
2015,03/15,SanFrancisco,1.26,204467,455307,25349,93761,862,6,Spring,298228,456169,25355,False
2015,03/08,SanFrancisco,1.16,260192,442834,31289,95539,803,116,Spring,355731,443637,31405,False
2015,03/01,SanFrancisco,0.95,251296,697969,22240,66973,726,58,Spring,318269,698695,22298,False
2015,02/22,SanFrancisco,1.23,165066,502502,27811,80088,823,42,Winter,245154,503325,27853,False
2015,02/15,SanFrancisco,1.23,176265,414826,27243,77306,824,49,Winter,253571,415650,27292,False
2015,02/08,SanFrancisco,0.92,252068,581737,20265,74003,733,27,Winter,326071,582470,20292,False
2015,02/01,SanFrancisco,0.91,369580,896514,20587,64393,832,118,Winter,433973,897346,20705,False
2015,01/25,SanFrancisco,1.21,127276,481792,21293,82293,796,70,Winter,209569,482588,21363,False
2015,01/18,SanFrancisco,1.22,107566,554501,12868,78241,515,52,Winter,185807,555016,12920,False
2015,01/11,SanFrancisco,1.03,155455,670522,4107,85706,658,0,Winter,241161,671180,4107,False
2015,01/04,SanFrancisco,0.99,179507,637000,8803,82033,444,6,Winter,261540,637444,8809,False
2015,12/27,Seattle,1.09,101442,178459,7000,162930,26,325,Winter,264372,178485,7325,False
2015,12/20,Seattle,1.15,88134,139794,6308,170458,11,155,Winter,258592,139805,6463,False
2015,12/13,Seattle,1.05,114813,156347,9650,173537,35,43,Winter,288350,156382,9693,False
2015,12/06,Seattle,0.81,117507,219412,9120,380298,0,165,Winter,497805,219412,9285,False
2015,11/29,Seattle,1.17,90354,131571,9878,141430,0,75,Fall,231784,131571,9953,False
2015,11/22,Seattle,1.07,111896,155494,9372,149358,0,216,Fall,261254,155494,9588,False
2015,11/15,Seattle,0.93,146061,213666,9650,273223,0,800,Fall,419284,213666,10450,False
2015,11/08,Seattle,1.06,135637,172982,9195,172749,0,262,Fall,308386,172982,9457,False
2015,11/01,Seattle,1.14,105846,176922,10032,143026,0,91,Fall,248872,176922,10123,False
2015,10/25,Seattle,1.03,130741,201858,8273,179544,0,281,Fall,310285,201858,8554,False
2015,10/18,Seattle,1.08,147440,185069,10284,141266,0,44,Fall,288706,185069,10328,False
2015,10/11,Seattle,0.9,87081,301656,15431,234219,0,1943,Fall,321300,301656,17374,False
2015,10/04,Seattle,1.06,103495,281914,11368,115646,0,844,Fall,219141,281914,12212,False
2015,09/27,Seattle,1.1,159459,152002,10158,146143,13,14,Fall,305602,152015,10172,False
2015,09/20,Seattle,1.02,158198,242849,11283,178374,8,6,Fall,336572,242857,11289,False
2015,09/13,Seattle,1.02,230283,181240,10787,164176,0,14,Fall,394459,181240,10801,False
2015,09/06,Seattle,1.17,167782,155468,12346,124129,61,4,Fall,291911,155529,12350,False
2015,08/30,Seattle,1.18,171694,150815,12204,112127,1,8,Summer,283821,150816,12212,False
2015,08/23,Seattle,1.13,137390,265837,9738,138486,26,18,Summer,275876,265863,9756,False
2015,08/16,Seattle,1.15,173165,201936,12055,110361,2,4,Summer,283526,201938,12059,False
2015,08/09,Seattle,1.15,220284,169096,13416,120360,0,0,Summer,340644,169096,13416,False
2015,08/02,Seattle,1.18,210529,181274,12790,115288,2,1,Summer,325817,181276,12791,False
2015,07/26,Seattle,1.29,158304,172990,12492,92385,35,0,Summer,250689,173025,12492,False
2015,07/19,Seattle,1.25,197532,192075,11882,90074,88,0,Summer,287606,192163,11882,False
2015,07/12,Seattle,1.14,261870,204320,12664,117906,980,116,Summer,379776,205300,12780,False
2015,07/05,Seattle,1.35,201350,263046,16266,95899,5462,11,Summer,297249,268508,16277,False
2015,06/28,Seattle,1.31,175064,222871,13848,84437,58,21,Summer,259501,222929,13869,False
2015,06/21,Seattle,1.19,178641,272213,16161,110537,31,20,Summer,289178,272244,16181,False
2015,06/14,Seattle,1.18,207290,274970,13480,119723,17,16,Summer,327013,274987,13496,False
2015,06/07,Seattle,1.27,194535,207213,14325,78760,8,11,Summer,273295,207221,14336,False
2015,05/31,Seattle,1.12,244319,185303,14394,99789,97,3,Spring,344108,185400,14397,False
2015,05/24,Seattle,1.14,213212,240665,14400,109172,459,36,Spring,322384,241124,14436,False
2015,05/17,Seattle,1.22,176144,196907,13149,86751,1074,54,Spring,262895,197981,13203,False
2015,05/10,Seattle,1.08,263440,242012,9484,111289,12415,54,Spring,374729,254427,9538,False
2015,05/03,Seattle,1.02,226074,355250,11154,94995,477,19,Spring,321069,355727,11173,False
2015,04/26,Seattle,1.19,202726,188384,10046,89235,21,11,Spring,291961,188405,10057,False
2015,04/19,Seattle,1.13,130765,324680,10877,103533,161,13,Spring,234298,324841,10890,False
2015,04/12,Seattle,1.33,134346,184720,11710,65783,144,22,Spring,200129,184864,11732,False
2015,04/05,Seattle,1.26,148128,238612,9791,69293,210,84,Spring,217421,238822,9875,False
2015,03/29,Seattle,1.22,162078,205582,9896,74523,658,4,Spring,236601,206240,9900,False
2015,03/22,Seattle,1.13,192630,229939,8716,82898,0,11,Spring,275528,229939,8727,False
2015,03/15,Seattle,1.24,173278,189014,12217,79057,8,12,Spring,252335,189022,12229,False
2015,03/08,Seattle,1.24,170637,190973,8269,69941,8,16,Spring,240578,190981,8285,False
2015,03/01,Seattle,1.07,162940,327299,12576,110637,62,18,Spring,273577,327361,12594,False
2015,02/22,Seattle,1.11,106012,353201,10013,82779,0,29,Winter,188791,353201,10042,False
2015,02/15,Seattle,1.33,114014,171966,8106,57771,431,44,Winter,171785,172397,8150,False
2015,02/08,Seattle,1.08,153475,257164,10978,65239,2117,4,Winter,218714,259281,10982,False
2015,02/01,Seattle,0.97,201139,578708,10182,142049,1034,33,Winter,343188,579742,10215,False
2015,01/25,Seattle,1.26,118569,228985,11119,61054,370,24,Winter,179623,229355,11143,False
2015,01/18,Seattle,1.2,160898,223145,11177,67519,720,10,Winter,228417,223865,11187,False
2015,01/11,Seattle,1.06,144349,278069,18076,81221,5632,1,Winter,225570,283701,18077,False
2015,01/04,Seattle,0.97,165839,341836,15291,96695,14859,0,Winter,262534,356695,15291,False
2015,12/27,SouthCarolina,0.98,137133,48908,8151,48181,9060,7,Winter,185314,57968,8158,False
2015,12/20,SouthCarolina,1.04,115402,39931,6244,44628,4851,7,Winter,160030,44782,6251,False
2015,12/13,SouthCarolina,0.96,148691,47393,7391,43815,9863,10,Winter,192506,57256,7401,False
2015,12/06,SouthCarolina,1.03,130410,47118,9427,40092,6203,20,Winter,170502,53321,9447,False
2015,11/29,SouthCarolina,0.97,125440,42269,7454,33356,9433,10,Fall,158796,51702,7464,False
2015,11/22,SouthCarolina,0.99,123208,42099,8114,34239,9106,0,Fall,157447,51205,8114,False
2015,11/15,SouthCarolina,1.07,116059,61600,11569,29409,5734,0,Fall,145468,67334,11569,False
2015,11/08,SouthCarolina,1.08,118352,47266,15742,34385,5325,7,Fall,152737,52591,15749,False
2015,11/01,SouthCarolina,1.0,143163,59937,19045,44763,13977,0,Fall,187926,73914,19045,False
2015,10/25,SouthCarolina,1.11,107103,46792,17192,43924,8593,0,Fall,151027,55385,17192,False
2015,10/18,SouthCarolina,1.12,105221,55038,16616,40996,8372,0,Fall,146217,63410,16616,False
2015,10/11,SouthCarolina,1.03,121966,64658,20190,43009,18138,0,Fall,164975,82796,20190,False
2015,10/04,SouthCarolina,1.04,123692,70671,14906,38750,19899,0,Fall,162442,90570,14906,False
2015,09/27,SouthCarolina,1.08,111054,72273,18765,42223,9105,0,Fall,153277,81378,18765,False
2015,09/20,SouthCarolina,1.02,148633,77644,14421,49597,21851,28,Fall,198230,99495,14449,False
2015,09/13,SouthCarolina,1.14,124781,61067,13939,55240,14707,18,Fall,180021,75774,13957,False
2015,09/06,SouthCarolina,1.0,165544,78503,23189,68114,18328,73,Fall,233658,96831,23262,False
2015,08/30,SouthCarolina,1.15,130772,58761,15284,70666,5198,15,Summer,201438,63959,15299,False
2015,08/23,SouthCarolina,1.09,139531,64117,17089,84625,5017,0,Summer,224156,69134,17089,False
2015,08/16,SouthCarolina,1.12,157907,60468,17614,78819,5940,0,Summer,236726,66408,17614,False
2015,08/09,SouthCarolina,1.05,179463,69024,18362,75517,11497,66,Summer,254980,80521,18428,False
2015,08/02,SouthCarolina,1.14,148657,64352,19051,72040,5488,21,Summer,220697,69840,19072,False
2015,07/26,SouthCarolina,1.11,160050,63162,18771,80982,4662,0,Summer,241032,67824,18771,False
2015,07/19,SouthCarolina,1.05,212349,70690,18957,67097,10410,0,Summer,279446,81100,18957,False
2015,07/12,SouthCarolina,1.14,143217,81353,17190,73161,5916,94,Summer,216378,87269,17284,False
2015,07/05,SouthCarolina,1.05,204374,93000,20072,78695,10568,0,Summer,283069,103568,20072,False
2015,06/28,SouthCarolina,1.11,152050,76047,18078,89211,4983,53,Summer,241261,81030,18131,False
2015,06/21,SouthCarolina,1.03,207438,71556,17373,84821,11533,32,Summer,292259,83089,17405,False
2015,06/14,SouthCarolina,1.1,172821,60267,18287,82278,6256,8,Summer,255099,66523,18295,False
2015,06/07,SouthCarolina,1.04,223638,46631,17294,80177,11102,0,Summer,303815,57733,17294,False
2015,05/31,SouthCarolina,1.13,185323,43301,18015,70487,5756,5,Spring,255810,49057,18020,False
2015,05/24,SouthCarolina,1.05,247039,58352,20373,69674,12060,0,Spring,316713,70412,20373,False
2015,05/17,SouthCarolina,1.09,200005,46163,18077,76994,5459,0,Spring,276999,51622,18077,False
2015,05/10,SouthCarolina,1.13,199489,44017,16482,64229,5626,0,Spring,263718,49643,16482,False
2015,05/03,SouthCarolina,0.97,271320,72324,26965,70270,16530,0,Spring,341590,88854,26965,False
2015,04/26,SouthCarolina,1.1,191953,43170,16204,63208,5122,0,Spring,255161,48292,16204,False
2015,04/19,SouthCarolina,1.08,185939,43227,15722,72168,5882,0,Spring,258107,49109,15722,False
2015,04/12,SouthCarolina,1.05,220208,49060,16838,57990,12529,0,Spring,278198,61589,16838,False
2015,04/05,SouthCarolina,1.1,187483,44278,18418,53591,7875,0,Spring,241074,52153,18418,False
2015,03/29,SouthCarolina,1.11,151124,45649,16553,64967,6545,0,Spring,216091,52194,16553,False
2015,03/22,SouthCarolina,1.0,218785,48984,15237,71610,12061,0,Spring,290395,61045,15237,False
2015,03/15,SouthCarolina,1.15,171702,44167,18024,58791,5170,0,Spring,230493,49337,18024,False
2015,03/08,SouthCarolina,1.14,173429,39009,14400,58373,4466,0,Spring,231802,43475,14400,False
2015,03/01,SouthCarolina,1.05,213315,42197,13638,57884,10540,0,Spring,271199,52737,13638,False
2015,02/22,SouthCarolina,1.02,193228,45809,23875,64068,5936,0,Winter,257296,51745,23875,False
2015,02/15,SouthCarolina,1.11,163447,40081,14735,44927,15322,0,Winter,208374,55403,14735,False
2015,02/08,SouthCarolina,1.06,169169,41468,12641,44770,14772,0,Winter,213939,56240,12641,False
2015,02/01,SouthCarolina,0.91,284674,78055,27248,51793,27913,0,Winter,336467,105968,27248,False
2015,01/25,SouthCarolina,1.06,187805,46947,12431,45690,18473,0,Winter,233495,65420,12431,False
2015,01/18,SouthCarolina,1.15,160256,44019,14954,35311,21663,0,Winter,195567,65682,14954,False
2015,01/11,SouthCarolina,1.1,162428,39713,14197,44864,18502,0,Winter,207292,58215,14197,False
2015,01/04,SouthCarolina,1.01,180977,46253,12923,52556,16314,0,Winter,233533,62567,12923,False
2015,12/27,Spokane,1.05,20577,21592,2889,21900,0,139,Winter,42477,21592,3028,False
2015,12/20,Spokane,1.12,17819,16576,2660,24499,0,0,Winter,42318,16576,2660,False
2015,12/13,Spokane,0.99,22229,20738,2189,22269,4,0,Winter,44498,20742,2189,False
2015,12/06,Spokane,0.85,18780,39234,2758,38946,513,0,Winter,57726,39747,2758,False
2015,11/29,Spokane,1.17,16876,16826,2523,15204,0,0,Fall,32080,16826,2523,False
2015,11/22,Spokane,1.12,17535,21806,2671,14000,0,0,Fall,31535,21806,2671,False
2015,11/15,Spokane,1.0,17121,38867,2013,26395,0,0,Fall,43516,38867,2013,False
2015,11/08,Spokane,1.08,19315,26207,2182,16116,0,0,Fall,35431,26207,2182,False
2015,11/01,Spokane,1.13,20262,23801,2428,13658,0,0,Fall,33920,23801,2428,False
2015,10/25,Spokane,1.08,16618,33389,2073,14720,50,0,Fall,31338,33439,2073,False
2015,10/18,Spokane,1.13,16562,30936,1935,11298,0,0,Fall,27860,30936,1935,False
2015,10/11,Spokane,0.94,11289,56878,1932,18479,0,0,Fall,29768,56878,1932,False
2015,10/04,Spokane,0.99,18331,47471,1657,10054,0,0,Fall,28385,47471,1657,False
2015,09/27,Spokane,1.09,25431,23735,2196,12539,0,0,Fall,37970,23735,2196,False
2015,09/20,Spokane,1.05,20718,42342,4327,12114,0,0,Fall,32832,42342,4327,False
2015,09/13,Spokane,1.03,39572,24065,2657,12475,0,0,Fall,52047,24065,2657,False
2015,09/06,Spokane,1.08,32235,18153,3891,12820,0,0,Fall,45055,18153,3891,False
2015,08/30,Spokane,1.11,31274,16651,3820,9427,2,0,Summer,40701,16653,3820,False
2015,08/23,Spokane,1.08,34441,35454,2497,11869,70,0,Summer,46310,35524,2497,False
2015,08/16,Spokane,1.15,33363,25970,3108,9950,0,0,Summer,43313,25970,3108,False
2015,08/09,Spokane,1.21,32213,23114,3261,11761,0,0,Summer,43974,23114,3261,False
2015,08/02,Spokane,1.19,35242,24453,3189,11954,0,0,Summer,47196,24453,3189,False
2015,07/26,Spokane,1.18,33592,22293,3203,12060,0,0,Summer,45652,22293,3203,False
2015,07/19,Spokane,1.16,39750,23169,2910,11475,0,0,Summer,51225,23169,2910,False
2015,07/12,Spokane,1.05,45146,23703,3714,13594,160,0,Summer,58740,23863,3714,False
2015,07/05,Spokane,1.22,43121,30059,6422,11245,347,0,Summer,54366,30406,6422,False
2015,06/28,Spokane,1.2,38303,26660,6367,9944,0,0,Summer,48247,26660,6367,False
2015,06/21,Spokane,1.12,33513,33789,4665,12770,0,0,Summer,46283,33789,4665,False
2015,06/14,Spokane,1.13,36980,35548,3428,12621,0,0,Summer,49601,35548,3428,False
2015,06/07,Spokane,1.19,40534,26271,3744,9182,0,0,Summer,49716,26271,3744,False
2015,05/31,Spokane,1.08,42027,24334,3310,12797,0,0,Spring,54824,24334,3310,False
2015,05/24,Spokane,1.07,41058,33679,3564,14362,0,0,Spring,55420,33679,3564,False
2015,05/17,Spokane,1.09,36879,24110,4295,12710,0,0,Spring,49589,24110,4295,False
2015,05/10,Spokane,1.03,46467,31703,3071,12192,2179,0,Spring,58659,33882,3071,False
2015,05/03,Spokane,0.98,44094,48511,3133,12127,185,0,Spring,56221,48696,3133,False
2015,04/26,Spokane,1.08,41208,24094,2597,12543,0,0,Spring,53751,24094,2597,False
2015,04/19,Spokane,1.03,31965,42072,2783,14557,0,0,Spring,46522,42072,2783,False
2015,04/12,Spokane,1.21,27692,23281,3057,10498,0,0,Spring,38190,23281,3057,False
2015,04/05,Spokane,1.15,30529,29902,3073,10090,84,0,Spring,40619,29986,3073,False
2015,03/29,Spokane,1.12,36451,26800,2051,9376,320,0,Spring,45827,27120,2051,False
2015,03/22,Spokane,1.1,32960,28457,2400,10906,0,0,Spring,43866,28457,2400,False
2015,03/15,Spokane,1.19,32528,26391,3967,8878,0,0,Spring,41406,26391,3967,False
2015,03/08,Spokane,1.18,35184,24432,2713,7514,4,0,Spring,42698,24436,2713,False
2015,03/01,Spokane,1.03,26800,44707,2869,13805,121,0,Spring,40605,44828,2869,False
2015,02/22,Spokane,1.03,25370,45291,2537,12095,0,0,Winter,37465,45291,2537,False
2015,02/15,Spokane,1.24,24008,22723,2683,8319,133,0,Winter,32327,22856,2683,False
2015,02/08,Spokane,1.03,28901,36736,3175,5135,190,0,Winter,34036,36926,3175,False
2015,02/01,Spokane,0.97,35897,84741,2704,12276,36,0,Winter,48173,84777,2704,False
2015,01/25,Spokane,1.21,23843,29590,2672,8010,0,0,Winter,31853,29590,2672,False
2015,01/18,Spokane,1.18,28457,29719,2933,7986,503,0,Winter,36443,30222,2933,False
2015,01/11,Spokane,1.07,21973,35996,4131,6899,1695,0,Winter,28872,37691,4131,False
2015,01/04,Spokane,1.0,26607,44341,3660,9556,446,0,Winter,36163,44787,3660,False
2015,12/27,StLouis,1.1,50481,25206,23,58430,17978,0,Winter,108911,43184,23,False
2015,12/20,StLouis,1.13,40333,23867,40,59160,12026,0,Winter,99493,35893,40,False
2015,12/13,StLouis,0.99,64673,24481,71,55878,20979,0,Winter,120551,45460,71,False
2015,12/06,StLouis,1.09,60481,25222,27,53742,8069,0,Winter,114223,33291,27,False
2015,11/29,StLouis,1.16,38130,26526,115,57854,6840,8,Fall,95984,33366,123,False
2015,11/22,StLouis,1.15,40115,27003,23,60331,7514,0,Fall,100446,34517,23,False
2015,11/15,StLouis,1.07,62810,28499,14,61782,7074,2,Fall,124592,35573,16,False
2015,11/08,StLouis,1.18,54277,29529,25,59269,4928,0,Fall,113546,34457,25,False
2015,11/01,StLouis,1.21,49010,34559,43,64373,4084,6,Fall,113383,38643,49,False
2015,10/25,StLouis,1.21,52371,37039,37,56579,5240,0,Fall,108950,42279,37,False
2015,10/18,StLouis,1.26,53413,34898,25,51312,4287,6,Fall,104725,39185,31,False
2015,10/11,StLouis,1.15,77647,25627,28,52275,3421,11,Fall,129922,29048,39,False
2015,10/04,StLouis,1.23,64603,36643,51,46870,3051,0,Fall,111473,39694,51,False
2015,09/27,StLouis,1.12,99021,34231,62,40596,2046,0,Fall,139617,36277,62,False
2015,09/20,StLouis,1.24,77969,37269,58,47579,2357,20,Fall,125548,39626,78,False
2015,09/13,StLouis,1.15,108859,33405,227,55794,1694,136,Fall,164653,35099,363,False
2015,09/06,StLouis,1.3,85673,36576,71,58293,88,2,Fall,143966,36664,73,False
2015,08/30,StLouis,1.32,74751,34386,16,55153,404,4,Summer,129904,34790,20,False
2015,08/23,StLouis,1.11,111101,35104,33,56606,11,4,Summer,167707,35115,37,False
2015,08/16,StLouis,0.88,186669,44789,101,59339,0,6,Summer,246008,44789,107,False
2015,08/09,StLouis,1.15,92511,47874,230,60173,0,4,Summer,152684,47874,234,False
2015,08/02,StLouis,1.26,79291,43745,4,61457,0,2,Summer,140748,43745,6,False
2015,07/26,StLouis,1.06,120124,38710,21,58136,0,0,Summer,178260,38710,21,False
2015,07/19,StLouis,1.2,99044,41712,56,63651,0,0,Summer,162695,41712,56,False
2015,07/12,StLouis,1.13,132490,44204,232,56425,3,222,Summer,188915,44207,454,False
2015,07/05,StLouis,1.32,97253,57668,23,69313,642,0,Summer,166566,58310,23,False
2015,06/28,StLouis,1.17,107631,40137,54,69371,39,0,Summer,177002,40176,54,False
2015,06/21,StLouis,1.26,84699,38461,51,74925,0,0,Summer,159624,38461,51,False
2015,06/14,StLouis,1.28,87726,41782,102,73588,0,48,Summer,161314,41782,150,False
2015,06/07,StLouis,1.3,92964,38450,41,63206,0,4,Summer,156170,38450,45,False
2015,05/31,StLouis,1.16,147104,38945,8,61113,23,0,Spring,208217,38968,8,False
2015,05/24,StLouis,1.18,135166,38773,9,62233,7,0,Spring,197399,38780,9,False
2015,05/17,StLouis,1.32,96530,37553,37,52814,0,0,Spring,149344,37553,37,False
2015,05/10,StLouis,1.25,125846,33050,42,59620,0,2,Spring,185466,33050,44,False
2015,05/03,StLouis,1.09,190986,36252,32,47809,0,0,Spring,238795,36252,32,False
2015,04/26,StLouis,1.37,86967,42320,15,48894,0,2,Spring,135861,42320,17,False
2015,04/19,StLouis,1.34,101449,38169,33,45322,4,0,Spring,146771,38173,33,False
2015,04/12,StLouis,1.21,138215,37441,144,38323,0,0,Spring,176538,37441,144,False
2015,04/05,StLouis,1.36,77970,34544,67,46762,115,0,Spring,124732,34659,67,False
2015,03/29,StLouis,1.21,111921,39575,56,46687,155,0,Spring,158608,39730,56,False
2015,03/22,StLouis,1.34,77997,37696,39,47513,77,0,Spring,125510,37773,39,False
2015,03/15,StLouis,1.33,70836,36549,69,50190,153,0,Spring,121026,36702,69,False
2015,03/08,StLouis,1.36,73956,31856,48,41663,0,0,Spring,115619,31856,48,False
2015,03/01,StLouis,1.24,93746,39403,100,46019,6,0,Spring,139765,39409,100,False
2015,02/22,StLouis,1.32,75717,36667,58,43660,8,0,Winter,119377,36675,58,False
2015,02/15,StLouis,1.23,88022,33530,41,47493,31,0,Winter,135515,33561,41,False
2015,02/08,StLouis,1.09,140791,31995,48,41880,2,0,Winter,182671,31997,48,False
2015,02/01,StLouis,1.1,209893,48651,59,49768,0,0,Winter,259661,48651,59,False
2015,01/25,StLouis,1.17,99020,31381,42,46375,0,0,Winter,145395,31381,42,False
2015,01/18,StLouis,1.28,78724,50701,145,41014,4,0,Winter,119738,50705,145,False
2015,01/11,StLouis,1.29,79292,41050,62,44509,2,0,Winter,123801,41052,62,False
2015,01/04,StLouis,1.15,125713,34555,53,38400,11,0,Winter,164113,34566,53,False
2015,12/27,Syracuse,1.36,828,23560,14,17940,0,0,Winter,18768,23560,14,False
2015,12/20,Syracuse,1.36,646,22231,12,16474,0,0,Winter,17120,22231,12,False
2015,12/13,Syracuse,1.32,773,33149,5,16455,0,0,Winter,17228,33149,5,False
2015,12/06,Syracuse,1.17,874,34439,11,15306,0,0,Winter,16180,34439,11,False
2015,11/29,Syracuse,1.41,719,21285,8,13839,0,0,Fall,14558,21285,8,False
2015,11/22,Syracuse,1.38,846,22314,34,15904,0,0,Fall,16750,22314,34,False
2015,11/15,Syracuse,1.21,912,34236,20,16364,191,0,Fall,17276,34427,20,False
2015,11/08,Syracuse,1.23,645,37788,12,16690,422,0,Fall,17335,38210,12,False
2015,11/01,Syracuse,1.16,1062,36281,29,17374,346,0,Fall,18436,36627,29,False
2015,10/25,Syracuse,1.26,935,30448,18,16893,675,0,Fall,17828,31123,18,False
2015,10/18,Syracuse,1.26,748,28155,21,19364,364,0,Fall,20112,28519,21,False
2015,10/11,Syracuse,1.32,1054,27690,26,15861,537,0,Fall,16915,28227,26,False
2015,10/04,Syracuse,1.34,1777,22698,10,16884,533,0,Fall,18661,23231,10,False
2015,09/27,Syracuse,1.16,925,43139,19,9981,128,0,Fall,10906,43267,19,False
2015,09/20,Syracuse,1.44,775,27299,29,8492,448,0,Fall,9267,27747,29,False
2015,09/13,Syracuse,1.44,882,30696,45,10960,475,0,Fall,11842,31171,45,False
2015,09/06,Syracuse,1.36,675,37504,97,10081,0,0,Fall,10756,37504,97,False
2015,08/30,Syracuse,1.2,601,43932,102,9064,0,0,Summer,9665,43932,102,False
2015,08/23,Syracuse,1.44,579,30616,77,11660,0,0,Summer,12239,30616,77,False
2015,08/16,Syracuse,1.42,619,32282,82,11261,0,0,Summer,11880,32282,82,False
2015,08/09,Syracuse,1.35,510,39597,127,10859,0,0,Summer,11369,39597,127,False
2015,08/02,Syracuse,1.48,722,26661,219,13396,0,0,Summer,14118,26661,219,False
2015,07/26,Syracuse,1.23,878,41541,334,17192,0,0,Summer,18070,41541,334,False
2015,07/19,Syracuse,1.38,593,34449,1027,23356,0,0,Summer,23949,34449,1027,False
2015,07/12,Syracuse,1.25,577,43147,2809,28512,97,0,Summer,29089,43244,2809,False
2015,07/05,Syracuse,1.45,797,35080,3980,28845,217,0,Summer,29642,35297,3980,False
2015,06/28,Syracuse,1.39,755,30246,2965,29940,31,0,Summer,30695,30277,2965,False
2015,06/21,Syracuse,1.4,624,32511,3173,24061,0,0,Summer,24685,32511,3173,False
2015,06/14,Syracuse,1.35,547,27340,2737,34559,0,0,Summer,35106,27340,2737,False
2015,06/07,Syracuse,1.22,632,41825,31,27287,0,0,Summer,27919,41825,31,False
2015,05/31,Syracuse,1.36,744,34985,44,29065,0,0,Spring,29809,34985,44,False
2015,05/24,Syracuse,1.35,559,34572,36,26415,0,0,Spring,26974,34572,36,False
2015,05/17,Syracuse,1.44,743,42174,39,26524,168,0,Spring,27267,42342,39,False
2015,05/10,Syracuse,1.34,899,44891,24,32561,331,0,Spring,33460,45222,24,False
2015,05/03,Syracuse,1.4,634,24201,18,25405,330,0,Spring,26039,24531,18,False
2015,04/26,Syracuse,1.4,768,23424,19,24363,235,0,Spring,25131,23659,19,False
2015,04/19,Syracuse,1.4,721,24884,49,27009,136,0,Spring,27730,25020,49,False
2015,04/12,Syracuse,1.36,670,21961,26,23944,226,0,Spring,24614,22187,26,False
2015,04/05,Syracuse,1.38,716,24675,20,24340,262,0,Spring,25056,24937,20,False
2015,03/29,Syracuse,1.29,1020,28858,42,22377,120,0,Spring,23397,28978,42,False
2015,03/22,Syracuse,1.33,2030,21884,43,24222,0,0,Spring,26252,21884,43,False
2015,03/15,Syracuse,1.36,2534,20482,18,19020,22,0,Spring,21554,20504,18,False
2015,03/08,Syracuse,1.28,796,23821,25,21318,237,0,Spring,22114,24058,25,False
2015,03/01,Syracuse,1.32,728,22776,53,24277,53,0,Spring,25005,22829,53,False
2015,02/22,Syracuse,1.33,1098,21441,41,19816,264,0,Winter,20914,21705,41,False
2015,02/15,Syracuse,1.35,880,19621,7,18118,122,0,Winter,18998,19743,7,False
2015,02/08,Syracuse,1.25,1093,26366,14,23658,424,0,Winter,24751,26790,14,False
2015,02/01,Syracuse,1.26,1321,30243,14,25793,51,0,Winter,27114,30294,14,False
2015,01/25,Syracuse,1.37,810,22526,36,20725,420,0,Winter,21535,22946,36,False
2015,01/18,Syracuse,1.4,789,24755,27,14818,0,0,Winter,15607,24755,27,False
2015,01/11,Syracuse,1.45,984,21576,14,19441,0,0,Winter,20425,21576,14,False
2015,01/04,Syracuse,1.33,2506,20905,16,17715,0,0,Winter,20221,20905,16,False
2015,12/27,Tampa,0.97,246326,35652,56,55850,38301,0,Winter,302176,73953,56,False
2015,12/20,Tampa,1.15,146376,23810,33,50715,18013,0,Winter,197091,41823,33,False
2015,12/13,Tampa,0.96,242293,40944,52,42015,40338,0,Winter,284308,81282,52,False
2015,12/06,Tampa,1.17,145404,29926,43,33251,18505,0,Winter,178655,48431,43,False
2015,11/29,Tampa,0.96,213390,41026,18,36785,38839,0,Fall,250175,79865,18,False
2015,11/22,Tampa,0.97,194667,39338,57,46934,30787,0,Fall,241601,70125,57,False
2015,11/15,Tampa,1.22,138482,32425,51,43524,21691,2,Fall,182006,54116,53,False
2015,11/08,Tampa,1.21,135741,33351,40,40754,18696,0,Fall,176495,52047,40,False
2015,11/01,Tampa,0.97,228324,72749,100,44449,45890,0,Fall,272773,118639,100,False
2015,10/25,Tampa,1.12,109048,51940,43,35990,36998,2,Fall,145038,88938,45,False
2015,10/18,Tampa,1.11,112096,54378,42,49373,40703,17,Fall,161469,95081,59,False
2015,10/11,Tampa,0.88,175545,90767,80,47783,88049,2,Fall,223328,178816,82,False
2015,10/04,Tampa,0.89,184069,92366,106,52595,84698,2,Fall,236664,177064,108,False
2015,09/27,Tampa,1.13,99077,70565,99,42717,39668,0,Fall,141794,110233,99,False
2015,09/20,Tampa,0.88,186843,104344,88,50247,91438,0,Fall,237090,195782,88,False
2015,09/13,Tampa,1.1,97653,69978,102,50111,39529,0,Fall,147764,109507,102,False
2015,09/06,Tampa,0.91,205188,94841,63,60131,76303,0,Fall,265319,171144,63,False
2015,08/30,Tampa,1.2,126060,53665,149,64691,17980,28,Summer,190751,71645,177,False
2015,08/23,Tampa,1.17,126817,54873,66,66986,15425,0,Summer,193803,70298,66,False
2015,08/16,Tampa,1.17,139923,50157,66,75599,17900,0,Summer,215522,68057,66,False
2015,08/09,Tampa,0.97,257930,58043,161,75694,35397,2,Summer,333624,93440,163,False
2015,08/02,Tampa,1.18,139950,50642,170,68312,15348,0,Summer,208262,65990,170,False
2015,07/26,Tampa,1.16,133615,48153,115,67480,16003,0,Summer,201095,64156,115,False
2015,07/19,Tampa,0.97,258972,61716,138,64830,35915,0,Summer,323802,97631,138,False
2015,07/12,Tampa,1.17,149510,54927,100,68163,16139,297,Summer,217673,71066,397,False
2015,07/05,Tampa,0.95,282433,71003,163,91543,36939,5,Summer,373976,107942,168,False
2015,06/28,Tampa,1.11,157030,56095,108,94295,17905,0,Summer,251325,74000,108,False
2015,06/21,Tampa,0.95,262821,58036,773,80513,36436,0,Summer,343334,94472,773,False
2015,06/14,Tampa,1.17,152836,39330,2087,82324,18385,0,Summer,235160,57715,2087,False
2015,06/07,Tampa,0.97,295793,35164,467,65864,35862,0,Summer,361657,71026,467,False
2015,05/31,Tampa,1.22,181641,18121,203,57879,15763,0,Spring,239520,33884,203,False
2015,05/24,Tampa,0.99,331416,30794,279,58346,39203,0,Spring,389762,69997,279,False
2015,05/17,Tampa,1.18,182281,18249,79,58505,16142,0,Spring,240786,34391,79,False
2015,05/10,Tampa,1.21,197831,20278,88,53035,15834,0,Spring,250866,36112,88,False
2015,05/03,Tampa,0.97,401968,37800,164,62416,55151,611,Spring,464384,92951,775,False
2015,04/26,Tampa,1.19,203078,19757,118,60977,19915,288,Spring,264055,39672,406,False
2015,04/19,Tampa,1.16,182582,19553,138,56279,21911,0,Spring,238861,41464,138,False
2015,04/12,Tampa,0.99,304622,30735,170,46251,43252,0,Spring,350873,73987,170,False
2015,04/05,Tampa,1.09,242307,26336,193,51105,34191,0,Spring,293412,60527,193,False
2015,03/29,Tampa,1.2,169276,18562,94,45155,21432,0,Spring,214431,39994,94,False
2015,03/22,Tampa,0.97,310473,32912,105,55623,40992,0,Spring,366096,73904,105,False
2015,03/15,Tampa,1.25,173099,19983,62,46495,17531,0,Spring,219594,37514,62,False
2015,03/08,Tampa,1.22,166383,19097,68,55747,18020,0,Spring,222130,37117,68,False
2015,03/01,Tampa,1.0,258084,27867,38,50762,36709,0,Spring,308846,64576,38,False
2015,02/22,Tampa,1.12,167595,22043,39,62198,16538,0,Winter,229793,38581,39,False
2015,02/15,Tampa,1.21,154111,20647,56,34123,33540,0,Winter,188234,54187,56,False
2015,02/08,Tampa,1.19,155193,21932,59,25516,33732,0,Winter,180709,55664,59,False
2015,02/01,Tampa,0.92,392037,53180,79,50530,66414,0,Winter,442567,119594,79,False
2015,01/25,Tampa,1.21,161291,30244,40,30325,38569,0,Winter,191616,68813,40,False
2015,01/18,Tampa,1.27,132142,33674,37,25006,38060,0,Winter,157148,71734,37,False
2015,01/11,Tampa,1.24,142237,36017,56,19605,37313,0,Winter,161842,73330,56,False
2015,01/04,Tampa,0.97,226346,37517,53,33447,42544,0,Winter,259793,80061,53,False
2015,12/27,WestTexNewMexico,0.71,451904,141599,15486,123158,33065,11190,Winter,575062,174664,26676,False
2015,12/20,WestTexNewMexico,0.83,389110,108176,12953,90392,23535,25716,Winter,479502,131711,38669,False
2015,12/13,WestTexNewMexico,0.78,437780,100110,13576,83053,10947,573,Winter,520833,111057,14149,False
2015,12/06,WestTexNewMexico,0.74,398871,133434,21088,68233,1604,0,Winter,467104,135038,21088,False
2015,11/29,WestTexNewMexico,0.81,335446,103635,11463,67264,1217,0,Fall,402710,104852,11463,False
2015,11/22,WestTexNewMexico,0.78,403133,122078,12008,74953,2903,0,Fall,478086,124981,12008,False
2015,11/15,WestTexNewMexico,0.71,483180,155778,12780,77112,3843,0,Fall,560292,159621,12780,False
2015,11/08,WestTexNewMexico,0.76,445281,123745,11968,79009,1402,0,Fall,524290,125147,11968,False
2015,11/01,WestTexNewMexico,0.8,350881,131576,32802,75700,1154,0,Fall,426581,132730,32802,False
2015,10/25,WestTexNewMexico,0.82,363487,166607,31960,72717,1100,0,Fall,436204,167707,31960,False
2015,10/18,WestTexNewMexico,0.81,409639,177573,15805,77611,871,0,Fall,487250,178444,15805,False
2015,10/11,WestTexNewMexico,0.89,268061,258518,31027,79841,1037,0,Fall,347902,259555,31027,False
2015,10/04,WestTexNewMexico,0.85,240183,317701,16661,72761,1742,0,Fall,312944,319443,16661,False
2015,09/27,WestTexNewMexico,0.79,255897,376232,12988,68312,1545,0,Fall,324209,377777,12988,False
2015,09/20,WestTexNewMexico,0.78,289135,352998,14247,78779,11089,0,Fall,367914,364087,14247,False
2015,09/13,WestTexNewMexico,0.75,341728,330566,26174,82932,48325,0,Fall,424660,378891,26174,False
2015,09/06,WestTexNewMexico,0.8,487551,183612,16170,91173,11912,0,Fall,578724,195524,16170,False
2015,08/30,WestTexNewMexico,0.82,518203,136374,16298,78731,1061,0,Summer,596934,137435,16298,False
2015,08/23,WestTexNewMexico,0.8,535570,100108,13332,87927,3275,0,Summer,623497,103383,13332,False
2015,08/16,WestTexNewMexico,0.77,489076,154805,20866,125836,25052,0,Summer,614912,179857,20866,False
2015,08/09,WestTexNewMexico,0.74,576883,154758,20222,100912,33107,0,Summer,677795,187865,20222,False
2015,08/02,WestTexNewMexico,0.79,573107,94633,13662,95673,18294,0,Summer,668780,112927,13662,False
2015,07/26,WestTexNewMexico,0.81,542663,96112,25086,97555,16465,0,Summer,640218,112577,25086,False
2015,07/19,WestTexNewMexico,0.76,552839,101243,16066,115237,17952,0,Summer,668076,119195,16066,False
2015,07/12,WestTexNewMexico,0.77,515150,100148,16185,107273,15914,0,Summer,622423,116062,16185,False
2015,07/05,WestTexNewMexico,0.78,606650,123465,18233,146199,18811,0,Summer,752849,142276,18233,False
2015,06/28,WestTexNewMexico,0.71,670425,108019,13077,130392,19220,0,Summer,800817,127239,13077,False
2015,06/21,WestTexNewMexico,0.74,601318,158997,13455,148132,27038,0,Summer,749450,186035,13455,False
2015,06/14,WestTexNewMexico,0.7,651120,202731,13413,126508,42198,0,Summer,777628,244929,13413,False
2015,06/07,WestTexNewMexico,0.68,750594,152736,12543,103719,34404,0,Summer,854313,187140,12543,False
2015,05/31,WestTexNewMexico,0.74,626724,124037,25328,78423,32530,0,Spring,705147,156567,25328,False
2015,05/24,WestTexNewMexico,0.75,692900,107964,14654,82335,17112,0,Spring,775235,125076,14654,False
2015,05/17,WestTexNewMexico,0.7,721087,112070,12170,74460,22520,0,Spring,795547,134590,12170,False
2015,05/10,WestTexNewMexico,0.71,774232,128168,13889,79189,23680,0,Spring,853421,151848,13889,False
2015,05/03,WestTexNewMexico,0.74,677575,166456,15065,80711,27335,0,Spring,758286,193791,15065,False
2015,04/26,WestTexNewMexico,0.74,596342,174560,14468,80697,33563,0,Spring,677039,208123,14468,False
2015,04/19,WestTexNewMexico,0.7,687794,154971,16243,76595,25396,0,Spring,764389,180367,16243,False
2015,04/12,WestTexNewMexico,0.76,564694,167105,11290,71587,25636,0,Spring,636281,192741,11290,False
2015,04/05,WestTexNewMexico,0.76,660961,163481,15530,91530,7376,0,Spring,752491,170857,15530,False
2015,03/29,WestTexNewMexico,0.74,595240,199938,18570,88599,5973,0,Spring,683839,205911,18570,False
2015,03/22,WestTexNewMexico,0.85,489678,157679,14084,89232,1900,0,Spring,578910,159579,14084,False
2015,03/15,WestTexNewMexico,0.75,610496,115089,13114,86399,2695,0,Spring,696895,117784,13114,False
2015,03/08,WestTexNewMexico,0.73,568182,137012,12344,85848,2343,0,Spring,654030,139355,12344,False
2015,03/01,WestTexNewMexico,0.84,439115,167245,28226,86800,2100,0,Spring,525915,169345,28226,False
2015,02/22,WestTexNewMexico,0.85,455087,121269,16470,86050,2531,0,Winter,541137,123800,16470,False
2015,02/15,WestTexNewMexico,0.78,520464,133695,12099,73763,3043,0,Winter,594227,136738,12099,False
2015,02/08,WestTexNewMexico,0.72,539280,175207,13717,81116,2342,0,Winter,620396,177549,13717,False
2015,02/01,WestTexNewMexico,0.71,611270,205181,14107,82065,3742,0,Winter,693335,208923,14107,False
2015,01/25,WestTexNewMexico,0.8,519142,124248,10573,65072,1762,0,Winter,584214,126010,10573,False
2015,01/18,WestTexNewMexico,0.8,516446,128438,12473,71564,873,0,Winter,588010,129311,12473,False
2015,01/11,WestTexNewMexico,0.92,347125,129717,27944,78503,1606,0,Winter,425628,131323,27944,False
2015,01/04,WestTexNewMexico,0.75,426878,147958,15267,165202,2811,0,Winter,592080,150769,15267,False
2016,12/25,Albany,1.52,3202,58280,426,11017,411,2,Winter,14219,58691,428,False
2016,12/18,Albany,1.53,3345,55949,138,8876,587,40,Winter,12221,56536,178,False
2016,12/11,Albany,1.49,2323,56545,86,12176,645,0,Winter,14499,57190,86,False
2016,12/04,Albany,1.48,6530,99746,50,6476,228,0,Winter,13006,99974,50,False
2016,11/27,Albany,1.52,2793,47106,18,7973,279,0,Fall,10766,47385,18,False
2016,11/20,Albany,1.56,3675,56898,11,9238,209,56,Fall,12913,57107,67,False
2016,11/13,Albany,1.62,3523,49837,34,9790,422,0,Fall,13313,50259,34,False
2016,11/06,Albany,1.63,3212,43024,36,10474,431,0,Fall,13686,43455,36,False
2016,10/30,Albany,1.46,3187,45898,54,9153,82,0,Fall,12340,45980,54,False
2016,10/23,Albany,1.19,4222,77537,46,10160,113,0,Fall,14382,77650,46,False
2016,10/16,Albany,1.4,4027,54186,53,10434,358,0,Fall,14461,54544,53,False
2016,10/09,Albany,1.13,3641,87174,102,9744,425,0,Fall,13385,87599,102,False
2016,10/02,Albany,1.51,4109,57515,84,13345,425,0,Fall,17454,57940,84,False
2016,09/25,Albany,1.62,7658,79425,43,9586,138,0,Fall,17244,79563,43,False
2016,09/18,Albany,1.39,6624,63384,37,8958,509,0,Fall,15582,63893,37,False
2016,09/11,Albany,1.37,6258,63511,42,10839,815,5,Fall,17097,64326,47,False
2016,09/04,Albany,1.44,14741,64966,88,15340,220,100,Fall,30081,65186,188,False
2016,08/28,Albany,1.18,34912,94928,53,14367,269,790,Summer,49279,95197,843,False
2016,08/21,Albany,1.43,14520,63416,28,15811,286,820,Summer,30331,63702,848,False
2016,08/14,Albany,1.2,24000,72970,26,12434,350,745,Summer,36434,73320,771,False
2016,08/07,Albany,1.48,14670,69054,10,14597,178,1171,Summer,29267,69232,1181,False
2016,07/31,Albany,1.61,9293,96915,25,18803,78,470,Summer,28096,96993,495,False
2016,07/24,Albany,1.46,11580,65195,13,18639,241,2650,Summer,30219,65436,2663,False
2016,07/17,Albany,1.31,9273,64260,80,13439,688,1485,Summer,22712,64948,1565,False
2016,07/10,Albany,1.11,20970,96581,46,10876,470,2685,Summer,31846,97051,2731,False
2016,07/03,Albany,1.42,8373,82122,146,21872,492,2900,Summer,30245,82614,3046,False
2016,06/26,Albany,1.5,7923,106656,37,16479,419,1570,Summer,24402,107075,1607,False
2016,06/19,Albany,1.42,6766,85374,30,18526,389,1730,Summer,25292,85763,1760,False
2016,06/12,Albany,1.38,7531,83771,81,18368,282,1360,Summer,25899,84053,1441,False
2016,06/05,Albany,1.47,4288,92055,53,17385,398,1675,Summer,21673,92453,1728,False
2016,05/29,Albany,1.49,2580,104876,103,19519,180,550,Spring,22099,105056,653,False
2016,05/22,Albany,1.34,929,74678,59,22571,20,605,Spring,23500,74698,664,False
2016,05/15,Albany,1.36,901,75847,82,19802,288,0,Spring,20703,76135,82,False
2016,05/08,Albany,1.27,1041,96137,84,22697,232,0,Spring,23738,96369,84,False
2016,05/01,Albany,1.03,884,163570,37,8918,321,48,Spring,9802,163891,85,False
2016,04/24,Albany,1.18,954,87571,43,13463,337,119,Spring,14417,87908,162,False
2016,04/17,Albany,1.22,898,70042,25,14642,712,112,Spring,15540,70754,137,False
2016,04/10,Albany,1.46,972,56128,38,12671,443,0,Spring,13643,56571,38,False
2016,04/03,Albany,0.85,676,70459,31,10058,468,0,Spring,10734,70927,31,False
2016,03/27,Albany,1.49,808,78146,36,13037,500,0,Spring,13845,78646,36,False
2016,03/20,Albany,1.32,764,97082,70,12286,198,0,Spring,13050,97280,70,False
2016,03/13,Albany,1.18,847,96117,60,10817,421,0,Spring,11664,96538,60,False
2016,03/06,Albany,1.27,972,74693,56,14476,435,0,Spring,15448,75128,56,False
2016,02/28,Albany,1.26,805,72159,63,13739,1054,0,Winter,14544,73213,63,False
2016,02/21,Albany,1.28,869,84484,24,12280,2157,0,Winter,13149,86641,24,False
2016,02/14,Albany,1.13,1640,77133,12,17663,1558,0,Winter,19303,78691,12,False
2016,02/07,Albany,1.07,2031,157271,109,9349,850,0,Winter,11380,158121,109,False
2016,01/31,Albany,1.16,1386,79881,69,19788,912,0,Winter,21174,80793,69,False
2016,01/24,Albany,1.22,545,70802,68,23926,746,0,Winter,24471,71548,68,False
2016,01/17,Albany,1.26,1202,100613,51,17980,124,0,Winter,19182,100737,51,False
2016,01/10,Albany,1.28,848,66696,109,11293,173,0,Winter,12141,66869,109,False
2016,01/03,Albany,1.03,939,139735,132,8056,173,0,Winter,8995,139908,132,False
2016,12/25,Atlanta,0.91,205855,86015,184,118884,91847,0,Winter,324739,177862,184,False
2016,12/18,Atlanta,0.94,191753,80565,283,114872,76009,0,Winter,306625,156574,283,False
2016,12/11,Atlanta,1.06,186343,56200,171,112574,66736,0,Winter,298917,122936,171,False
2016,12/04,Atlanta,1.03,210602,93414,207,67806,103784,0,Winter,278408,197198,207,False
2016,11/27,Atlanta,1.22,161631,55595,167,89194,65518,36,Fall,250825,121113,203,False
2016,11/20,Atlanta,1.14,189206,58005,167,128442,72236,877,Fall,317648,130241,1044,False
2016,11/13,Atlanta,1.25,185966,63348,180,92308,66233,223,Fall,278274,129581,403,False
2016,11/06,Atlanta,1.29,167083,65207,168,82410,78956,0,Fall,249493,144163,168,False
2016,10/30,Atlanta,1.26,162367,69366,160,94305,82115,0,Fall,256672,151481,160,False
2016,10/23,Atlanta,1.23,171215,67824,166,110435,72639,0,Fall,281650,140463,166,False
2016,10/16,Atlanta,1.16,188793,82089,103,87593,100984,0,Fall,276386,183073,103,False
2016,10/09,Atlanta,1.23,187260,69425,156,95659,99113,493,Fall,282919,168538,649,False
2016,10/02,Atlanta,1.26,182418,69411,140,104367,83706,0,Fall,286785,153117,140,False
2016,09/25,Atlanta,1.26,174532,77098,131,109841,73830,322,Fall,284373,150928,453,False
2016,09/18,Atlanta,1.01,233800,70931,132,139748,82907,180,Fall,373548,153838,312,False
2016,09/11,Atlanta,0.9,286405,54347,206,194086,62713,0,Fall,480491,117060,206,False
2016,09/04,Atlanta,0.89,356593,55475,130,126235,75979,243,Fall,482828,131454,373,False
2016,08/28,Atlanta,0.95,294240,42109,123,132127,70394,647,Summer,426367,112503,770,False
2016,08/21,Atlanta,0.94,293240,48349,82,160464,47001,0,Summer,453704,95350,82,False
2016,08/14,Atlanta,0.87,362923,60912,86,182840,59729,0,Summer,545763,120641,86,False
2016,08/07,Atlanta,1.04,252171,63197,58,131851,61075,0,Summer,384022,124272,58,False
2016,07/31,Atlanta,0.98,232640,76301,64,161931,66694,0,Summer,394571,142995,64,False
2016,07/24,Atlanta,1.0,215522,92726,110,120773,66553,0,Summer,336295,159279,110,False
2016,07/17,Atlanta,1.01,202638,82942,164,108732,78958,627,Summer,311370,161900,791,False
2016,07/10,Atlanta,0.92,240109,95457,256,146617,78213,211,Summer,386726,173670,467,False
2016,07/03,Atlanta,0.77,310551,150339,165,216115,110544,1681,Summer,526666,260883,1846,False
2016,06/26,Atlanta,0.85,272203,82764,173,199572,52123,20,Summer,471775,134887,193,False
2016,06/19,Atlanta,0.78,361697,96388,264,148946,84045,1425,Summer,510643,180433,1689,False
2016,06/12,Atlanta,0.78,313216,61563,1174,169986,55753,6691,Summer,483202,117316,7865,False
2016,06/05,Atlanta,0.75,341027,123405,561,112958,105974,7273,Summer,453985,229379,7834,False
2016,05/29,Atlanta,0.78,267460,154238,246,77155,186791,5450,Spring,344615,341029,5696,False
2016,05/22,Atlanta,0.79,206761,110884,174,91575,171020,4934,Spring,298336,281904,5108,False
2016,05/15,Atlanta,0.68,292232,166131,80,126898,169317,646,Spring,419130,335448,726,False
2016,05/08,Atlanta,0.81,199995,159036,253,77087,206444,881,Spring,277082,365480,1134,False
2016,05/01,Atlanta,0.77,241665,211776,54,64801,217337,0,Spring,306466,429113,54,False
2016,04/24,Atlanta,0.79,233878,189043,67,71926,158919,183,Spring,305804,347962,250,False
2016,04/17,Atlanta,0.89,190569,124409,106,66461,130217,583,Spring,257030,254626,689,False
2016,04/10,Atlanta,0.83,258662,141605,432,69497,119037,766,Spring,328159,260642,1198,False
2016,04/03,Atlanta,1.03,253540,69327,1349,62657,36611,0,Spring,316197,105938,1349,False
2016,03/27,Atlanta,0.98,286918,59289,1320,78824,32268,13,Spring,365742,91557,1333,False
2016,03/20,Atlanta,0.98,323216,61127,1727,75568,34551,0,Spring,398784,95678,1727,False
2016,03/13,Atlanta,0.9,336350,110105,1906,73593,66700,0,Spring,409943,176805,1906,False
2016,03/06,Atlanta,1.03,299983,61770,1499,62105,33478,0,Spring,362088,95248,1499,False
2016,02/28,Atlanta,0.9,325884,106311,1136,60231,61906,0,Winter,386115,168217,1136,False
2016,02/21,Atlanta,1.04,270173,61591,1996,55736,27708,0,Winter,325909,89299,1996,False
2016,02/14,Atlanta,0.97,313342,57925,1008,74366,34842,0,Winter,387708,92767,1008,False
2016,02/07,Atlanta,0.76,415641,134517,418,77183,94449,0,Winter,492824,228966,418,False
2016,01/31,Atlanta,1.04,290451,58974,412,54822,32830,0,Winter,345273,91804,412,False
2016,01/24,Atlanta,0.92,318372,86816,401,64716,58468,0,Winter,383088,145284,401,False
2016,01/17,Atlanta,1.04,308722,45915,654,56526,33270,0,Winter,365248,79185,654,False
2016,01/10,Atlanta,0.93,377244,67316,464,54693,58630,0,Winter,431937,125946,464,False
2016,01/03,Atlanta,1.05,350316,32958,396,43674,21906,10,Winter,393990,54864,406,False
2016,12/25,BaltimoreWashington,1.47,50818,344699,8529,142957,2629,1312,Winter,193775,347328,9841,False
2016,12/18,BaltimoreWashington,1.21,57866,487109,8751,133753,2845,682,Winter,191619,489954,9433,False
2016,12/11,BaltimoreWashington,1.35,49240,375437,9977,153476,11028,0,Winter,202716,386465,9977,False
2016,12/04,BaltimoreWashington,1.41,52095,345132,10049,157703,1738,236,Winter,209798,346870,10285,False
2016,11/27,BaltimoreWashington,1.49,46243,336731,8237,146287,1715,709,Fall,192530,338446,8946,False
2016,11/20,BaltimoreWashington,1.6,51078,309529,13095,189672,1882,901,Fall,240750,311411,13996,False
2016,11/13,BaltimoreWashington,1.73,64630,311687,28558,153317,1348,436,Fall,217947,313035,28994,False
2016,11/06,BaltimoreWashington,1.8,61458,284547,41286,149603,1048,0,Fall,211061,285595,41286,False
2016,10/30,BaltimoreWashington,1.86,58412,304616,27903,130682,565,365,Fall,189094,305181,28268,False
2016,10/23,BaltimoreWashington,1.85,56864,336433,27036,163070,382,487,Fall,219934,336815,27523,False
2016,10/16,BaltimoreWashington,1.69,63424,363924,19878,190381,1238,0,Fall,253805,365162,19878,False
2016,10/09,BaltimoreWashington,1.59,72775,395481,20639,185599,1332,361,Fall,258374,396813,21000,False
2016,10/02,BaltimoreWashington,1.66,78716,381624,19492,190861,1423,641,Fall,269577,383047,20133,False
2016,09/25,BaltimoreWashington,1.58,129774,347949,19205,180490,1251,0,Fall,310264,349200,19205,False
2016,09/18,BaltimoreWashington,1.5,151204,367425,18808,191238,3746,0,Fall,342442,371171,18808,False
2016,09/11,BaltimoreWashington,1.34,202958,494756,19881,162753,4043,1335,Fall,365711,498799,21216,False
2016,09/04,BaltimoreWashington,1.51,97714,442803,20154,198131,2898,515,Fall,295845,445701,20669,False
2016,08/28,BaltimoreWashington,1.57,72406,443668,15648,194472,3978,2370,Summer,266878,447646,18018,False
2016,08/21,BaltimoreWashington,1.48,68443,413651,21950,203758,15197,4278,Summer,272201,428848,26228,False
2016,08/14,BaltimoreWashington,1.52,68335,421188,24863,219529,6984,1390,Summer,287864,428172,26253,False
2016,08/07,BaltimoreWashington,1.52,71154,432956,28505,210316,2285,1275,Summer,281470,435241,29780,False
2016,07/31,BaltimoreWashington,1.65,64022,402053,31448,197041,706,3355,Summer,261063,402759,34803,False
2016,07/24,BaltimoreWashington,1.64,62896,422902,30142,194809,1005,7346,Summer,257705,423907,37488,False
2016,07/17,BaltimoreWashington,1.47,50831,400287,32758,233727,2257,11012,Summer,284558,402544,43770,False
2016,07/10,BaltimoreWashington,1.37,64925,489314,44218,217648,2447,12632,Summer,282573,491761,56850,False
2016,07/03,BaltimoreWashington,1.38,63050,501970,50114,214851,2969,11381,Summer,277901,504939,61495,False
2016,06/26,BaltimoreWashington,1.36,62585,509113,48949,202616,3059,3748,Summer,265201,512172,52697,False
2016,06/19,BaltimoreWashington,1.37,61789,523095,54129,203569,3085,5022,Summer,265358,526180,59151,False
2016,06/12,BaltimoreWashington,1.34,73620,507383,55744,207727,3451,2935,Summer,281347,510834,58679,False
2016,06/05,BaltimoreWashington,1.33,61074,537895,46714,203788,8328,3056,Summer,264862,546223,49770,False
2016,05/29,BaltimoreWashington,1.19,61989,577334,44265,200150,3716,2741,Spring,262139,581050,47006,False
2016,05/22,BaltimoreWashington,1.19,60638,540988,19544,211306,2950,2145,Spring,271944,543938,21689,False
2016,05/15,BaltimoreWashington,1.12,58943,629734,16372,189850,6194,594,Spring,248793,635928,16966,False
2016,05/08,BaltimoreWashington,0.95,75492,804251,16818,204118,2691,515,Spring,279610,806942,17333,False
2016,05/01,BaltimoreWashington,1.07,67682,648816,15073,194073,3244,602,Spring,261755,652060,15675,False
2016,04/24,BaltimoreWashington,1.13,61118,638833,15861,196063,3132,491,Spring,257181,641965,16352,False
2016,04/17,BaltimoreWashington,1.13,59232,576827,15881,185709,3034,1155,Spring,244941,579861,17036,False
2016,04/10,BaltimoreWashington,1.12,64549,522216,13247,186797,2536,0,Spring,251346,524752,13247,False
2016,04/03,BaltimoreWashington,1.14,61532,523512,12784,170235,2812,0,Spring,231767,526324,12784,False
2016,03/27,BaltimoreWashington,1.19,59850,523531,15295,179809,3140,0,Spring,239659,526671,15295,False
2016,03/20,BaltimoreWashington,1.1,65397,614918,16342,180891,2688,0,Spring,246288,617606,16342,False
2016,03/13,BaltimoreWashington,1.18,59401,580134,18702,184423,2913,0,Spring,243824,583047,18702,False
2016,03/06,BaltimoreWashington,1.21,62539,541218,21461,191744,2742,0,Spring,254283,543960,21461,False
2016,02/28,BaltimoreWashington,1.12,61483,641585,20335,162543,2622,0,Winter,224026,644207,20335,False
2016,02/21,BaltimoreWashington,1.2,51913,446499,54665,180041,6366,0,Winter,231954,452865,54665,False
2016,02/14,BaltimoreWashington,1.11,72824,596869,60290,168368,6791,0,Winter,241192,603660,60290,False
2016,02/07,BaltimoreWashington,1.1,73754,621956,48009,217666,4934,0,Winter,291420,626890,48009,False
2016,01/31,BaltimoreWashington,1.11,52641,506187,24482,161204,3591,0,Winter,213845,509778,24482,False
2016,01/24,BaltimoreWashington,1.09,69829,689359,24029,233609,5825,0,Winter,303438,695184,24029,False
2016,01/17,BaltimoreWashington,1.17,58788,535244,25662,213938,2591,0,Winter,272726,537835,25662,False
2016,01/10,BaltimoreWashington,1.17,60261,511067,26791,180460,2398,0,Winter,240721,513465,26791,False
2016,01/03,BaltimoreWashington,1.11,54491,583418,27147,149408,2294,0,Winter,203899,585712,27147,False
2016,12/25,Boise,1.03,27464,2892,6681,33449,662,19,Winter,60913,3554,6700,False
2016,12/18,Boise,1.02,28725,2337,5562,27464,327,4,Winter,56189,2664,5566,False
2016,12/11,Boise,0.8,30311,10382,4088,53190,319,54,Winter,83501,10701,4142,False
2016,12/04,Boise,1.01,34194,2996,3771,31278,217,12,Winter,65472,3213,3783,False
2016,11/27,Boise,1.22,23774,2187,5526,20442,0,11,Fall,44216,2187,5537,False
2016,11/20,Boise,1.27,28834,2463,7123,24091,2,11,Fall,52925,2465,7134,False
2016,11/13,Boise,1.28,32035,3042,6078,25875,140,40,Fall,57910,3182,6118,False
2016,11/06,Boise,1.37,24935,2893,7688,23558,408,103,Fall,48493,3301,7791,False
2016,10/30,Boise,1.34,25832,3018,7311,22909,622,93,Fall,48741,3640,7404,False
2016,10/23,Boise,1.17,27935,3769,6919,30914,1098,14,Fall,58849,4867,6933,False
2016,10/16,Boise,1.09,35485,2006,6689,32413,1197,11,Fall,67898,3203,6700,False
2016,10/09,Boise,1.03,38087,2089,6562,28895,8576,24,Fall,66982,10665,6586,False
2016,10/02,Boise,0.9,27542,8194,7082,55975,7430,33,Fall,83517,15624,7115,False
2016,09/25,Boise,0.91,39342,2342,5737,34566,5564,4,Fall,73908,7906,5741,False
2016,09/18,Boise,0.97,39719,2199,6951,28303,5198,6,Fall,68022,7397,6957,False
2016,09/11,Boise,0.89,41793,1783,6411,38898,927,7,Fall,80691,2710,6418,False
2016,09/04,Boise,1.01,37233,2055,7067,31599,1718,7,Fall,68832,3773,7074,False
2016,08/28,Boise,0.99,36837,1982,5918,32151,1693,15,Summer,68988,3675,5933,False
2016,08/21,Boise,0.9,40944,2078,4694,34718,1577,0,Summer,75662,3655,4694,False
2016,08/14,Boise,0.93,43525,1959,6569,36020,671,41,Summer,79545,2630,6610,False
2016,08/07,Boise,0.76,32775,2002,2,35664,246,20,Summer,68439,2248,22,False
2016,07/31,Boise,0.78,30747,1920,2,36949,0,0,Summer,67696,1920,2,False
2016,07/24,Boise,0.74,26990,1685,3,36364,16,520,Summer,63354,1701,523,False
2016,07/17,Boise,0.7,27671,1614,6,37729,799,1231,Summer,65400,2413,1237,False
2016,07/10,Boise,0.75,39211,4977,3,87357,20,941,Summer,126568,4997,944,False
2016,07/03,Boise,0.77,36208,6421,12,93645,20,69,Summer,129853,6441,81,False
2016,06/26,Boise,0.69,34024,5853,9,88025,34,15,Summer,122049,5887,24,False
2016,06/19,Boise,0.7,36119,6692,2,86107,83,15,Summer,122226,6775,17,False
2016,06/12,Boise,0.67,34791,2578,2,31094,245,8,Summer,65885,2823,10,False
2016,06/05,Boise,0.63,31280,5422,11,59206,8,18,Summer,90486,5430,29,False
2016,05/29,Boise,0.63,29694,4570,6,47343,926,8,Spring,77037,5496,14,False
2016,05/22,Boise,0.65,32112,3221,2,40606,35,18,Spring,72718,3256,20,False
2016,05/15,Boise,0.58,34103,6201,15,52268,2490,64,Spring,86371,8691,79,False
2016,05/08,Boise,0.61,43200,5397,7,57439,330,34,Spring,100639,5727,41,False
2016,05/01,Boise,0.63,32240,3928,0,46257,140,18,Spring,78497,4068,18,False
2016,04/24,Boise,0.65,36437,2849,590,39671,5,6,Spring,76108,2854,596,False
2016,04/17,Boise,0.67,41244,9075,4729,53939,14,585,Spring,95183,9089,5314,False
2016,04/10,Boise,0.82,44344,3303,5340,33662,156,89,Spring,78006,3459,5429,False
2016,04/03,Boise,0.82,45952,5362,6316,39916,94,8,Spring,85868,5456,6324,False
2016,03/27,Boise,0.81,40228,6891,9114,44763,242,27,Spring,84991,7133,9141,False
2016,03/20,Boise,0.94,41756,2697,9201,29351,62,11,Spring,71107,2759,9212,False
2016,03/13,Boise,0.83,45571,4920,6448,42383,784,36,Spring,87954,5704,6484,False
2016,03/06,Boise,0.86,41714,5373,7307,42481,527,17,Spring,84195,5900,7324,False
2016,02/28,Boise,0.89,38143,5361,8767,37217,472,20,Winter,75360,5833,8787,False
2016,02/21,Boise,0.74,37807,9084,4890,42111,50,6,Winter,79918,9134,4896,False
2016,02/14,Boise,0.94,38043,5302,6617,28012,85,9,Winter,66055,5387,6626,False
2016,02/07,Boise,0.82,42825,14822,17989,47555,452,69,Winter,90380,15274,18058,False
2016,01/31,Boise,0.94,36196,4791,8440,33947,46,332,Winter,70143,4837,8772,False
2016,01/24,Boise,0.9,18003,4208,4714,29874,1614,18,Winter,47877,5822,4732,False
2016,01/17,Boise,0.92,34302,7884,8901,40337,951,7,Winter,74639,8835,8908,False
2016,01/10,Boise,0.93,31802,8347,9065,40584,16,65,Winter,72386,8363,9130,False
2016,01/03,Boise,0.77,43868,10276,5431,46476,17,36,Winter,90344,10293,5467,False
2016,12/25,Boston,1.28,4349,346516,4183,91481,1069,0,Winter,95830,347585,4183,False
2016,12/18,Boston,1.09,6123,488107,7765,76135,1445,0,Winter,82258,489552,7765,False
2016,12/11,Boston,1.22,3711,409645,5052,90449,1634,306,Winter,94160,411279,5358,False
2016,12/04,Boston,1.26,4371,393748,3449,71377,307,173,Winter,75748,394055,3622,False
2016,11/27,Boston,1.45,4243,317090,3069,66399,31,423,Fall,70642,317121,3492,False
2016,11/20,Boston,1.39,7917,356867,4915,105940,35,0,Fall,113857,356902,4915,False
2016,11/13,Boston,1.56,5233,314434,3726,74205,0,0,Fall,79438,314434,3726,False
2016,11/06,Boston,1.62,4016,284809,3370,73804,0,175,Fall,77820,284809,3545,False
2016,10/30,Boston,1.67,5542,304461,3787,62705,3,0,Fall,68247,304464,3787,False
2016,10/23,Boston,1.58,10444,335243,6144,86922,0,795,Fall,97366,335243,6939,False
2016,10/16,Boston,1.6,6472,345051,4742,97339,0,0,Fall,103811,345051,4742,False
2016,10/09,Boston,1.49,7435,366648,3837,90213,0,0,Fall,97648,366648,3837,False
2016,10/02,Boston,1.59,20871,340342,5003,92945,0,0,Fall,113816,340342,5003,False
2016,09/25,Boston,1.53,40864,338301,6515,97375,0,0,Fall,138239,338301,6515,False
2016,09/18,Boston,1.45,39970,346155,7080,96061,332,0,Fall,136031,346487,7080,False
2016,09/11,Boston,1.27,85204,470860,9617,106090,900,0,Fall,191294,471760,9617,False
2016,09/04,Boston,1.41,23481,381830,10225,125074,665,393,Fall,148555,382495,10618,False
2016,08/28,Boston,1.37,37757,388173,7653,146015,1187,1235,Summer,183772,389360,8888,False
2016,08/21,Boston,1.31,15419,353351,7923,201033,7400,944,Summer,216452,360751,8867,False
2016,08/14,Boston,1.29,20310,353845,8194,215552,3642,1060,Summer,235862,357487,9254,False
2016,08/07,Boston,1.48,15830,335033,8735,165457,176,155,Summer,181287,335209,8890,False
2016,07/31,Boston,1.61,12550,338691,8772,147430,5,1499,Summer,159980,338696,10271,False
2016,07/24,Boston,1.52,13099,343835,10965,137804,11,3377,Summer,150903,343846,14342,False
2016,07/17,Boston,1.56,11289,320250,10381,142601,9,3975,Summer,153890,320259,14356,False
2016,07/10,Boston,1.32,17289,359933,14982,153175,49,4385,Summer,170464,359982,19367,False
2016,07/03,Boston,1.38,11397,408601,17326,143276,137,4745,Summer,154673,408738,22071,False
2016,06/26,Boston,1.33,10379,433431,28898,151759,142,2360,Summer,162138,433573,31258,False
2016,06/19,Boston,1.32,10851,456521,38655,141650,141,1840,Summer,152501,456662,40495,False
2016,06/12,Boston,1.29,12891,421978,43090,152477,87,2330,Summer,165368,422065,45420,False
2016,06/05,Boston,1.26,8833,417995,51385,155072,120,1581,Summer,163905,418115,52966,False
2016,05/29,Boston,1.08,7708,461424,72848,129466,142,1906,Spring,137174,461566,74754,False
2016,05/22,Boston,1.05,4319,430580,81859,146904,136,1285,Spring,151223,430716,83144,False
2016,05/15,Boston,1.06,5790,517840,63055,122533,198,144,Spring,128323,518038,63199,False
2016,05/08,Boston,0.85,6383,698437,80414,138862,96,0,Spring,145245,698533,80414,False
2016,05/01,Boston,1.05,4764,520369,54779,136034,54,0,Spring,140798,520423,54779,False
2016,04/24,Boston,1.07,4157,446540,51958,123011,152,1073,Spring,127168,446692,53031,False
2016,04/17,Boston,1.08,3871,438210,43926,131035,109,25,Spring,134906,438319,43951,False
2016,04/10,Boston,0.99,4326,456029,74452,117521,87,129,Spring,121847,456116,74581,False
2016,04/03,Boston,1.11,4683,406529,42112,106262,131,0,Spring,110945,406660,42112,False
2016,03/27,Boston,1.08,4253,463187,51477,120388,112,0,Spring,124641,463299,51477,False
2016,03/20,Boston,1.1,5364,490720,34714,114286,150,0,Spring,119650,490870,34714,False
2016,03/13,Boston,1.05,5420,487268,46932,111440,150,0,Spring,116860,487418,46932,False
2016,03/06,Boston,1.1,6153,434300,36352,123551,282,0,Spring,129704,434582,36352,False
2016,02/28,Boston,1.08,6632,506048,36934,102683,644,0,Winter,109315,506692,36934,False
2016,02/21,Boston,1.14,5600,388956,36873,120040,2238,0,Winter,125640,391194,36873,False
2016,02/14,Boston,0.98,7591,560259,58165,123660,1980,0,Winter,131251,562239,58165,False
2016,02/07,Boston,1.05,5986,511548,25200,134178,1896,0,Winter,140164,513444,25200,False
2016,01/31,Boston,1.03,6037,501280,25252,118219,827,0,Winter,124256,502107,25252,False
2016,01/24,Boston,1.05,3107,482030,26052,158806,378,0,Winter,161913,482408,26052,False
2016,01/17,Boston,1.02,4392,486767,32505,141307,243,0,Winter,145699,487010,32505,False
2016,01/10,Boston,1.15,4120,391873,13321,127177,182,0,Winter,131297,392055,13321,False
2016,01/03,Boston,1.01,5112,492477,21182,91579,269,0,Winter,96691,492746,21182,False
2016,12/25,BuffaloRochester,1.41,1197,64434,42,35701,1660,0,Winter,36898,66094,42,False
2016,12/18,BuffaloRochester,1.36,1276,52115,60,29696,2191,0,Winter,30972,54306,60,False
2016,12/11,BuffaloRochester,1.47,967,62963,54,23315,1736,0,Winter,24282,64699,54,False
2016,12/04,BuffaloRochester,1.66,960,54243,22,15683,1256,37,Winter,16643,55499,59,False
2016,11/27,BuffaloRochester,1.57,1006,50581,12,21641,0,19,Fall,22647,50581,31,False
2016,11/20,BuffaloRochester,1.63,1426,52281,27,24940,0,0,Fall,26366,52281,27,False
2016,11/13,BuffaloRochester,1.6,1891,56517,84,28872,0,0,Fall,30763,56517,84,False
2016,11/06,BuffaloRochester,1.64,1321,56677,79,23400,0,212,Fall,24721,56677,291,False
2016,10/30,BuffaloRochester,1.65,1130,56077,81,13874,0,0,Fall,15004,56077,81,False
2016,10/23,BuffaloRochester,1.6,1171,50973,78,58521,0,0,Fall,59692,50973,78,False
2016,10/16,BuffaloRochester,1.36,1282,61796,50,68051,0,0,Fall,69333,61796,50,False
2016,10/09,BuffaloRochester,1.37,1117,68716,112,65113,0,0,Fall,66230,68716,112,False
2016,10/02,BuffaloRochester,1.35,1119,62757,90,68176,0,0,Fall,69295,62757,90,False
2016,09/25,BuffaloRochester,1.4,4198,62355,35,67732,4,0,Fall,71930,62359,35,False
2016,09/18,BuffaloRochester,1.54,2692,70019,52,49337,806,0,Fall,52029,70825,52,False
2016,09/11,BuffaloRochester,1.38,1657,81283,65,39986,1102,0,Fall,41643,82385,65,False
2016,09/04,BuffaloRochester,1.48,3089,67790,68,24296,53,175,Fall,27385,67843,243,False
2016,08/28,BuffaloRochester,1.4,2682,64245,67,46025,0,1625,Summer,48707,64245,1692,False
2016,08/21,BuffaloRochester,1.33,1543,70785,43,46013,0,1480,Summer,47556,70785,1523,False
2016,08/14,BuffaloRochester,1.41,2645,72836,71,37629,0,1145,Summer,40274,72836,1216,False
2016,08/07,BuffaloRochester,1.5,1781,74560,42,26109,0,1820,Summer,27890,74560,1862,False
2016,07/31,BuffaloRochester,1.45,1792,64652,54,40894,0,695,Summer,42686,64652,749,False
2016,07/24,BuffaloRochester,1.44,1156,63920,61,34596,0,4390,Summer,35752,63920,4451,False
2016,07/17,BuffaloRochester,1.3,1389,71781,102,66177,0,2430,Summer,67566,71781,2532,False
2016,07/10,BuffaloRochester,1.25,1425,88105,46,89911,0,4252,Summer,91336,88105,4298,False
2016,07/03,BuffaloRochester,1.3,1424,85758,53,88472,0,4900,Summer,89896,85758,4953,False
2016,06/26,BuffaloRochester,1.26,1326,74746,83,81949,0,2700,Summer,83275,74746,2783,False
2016,06/19,BuffaloRochester,1.23,1776,80406,57,84829,0,2685,Summer,86605,80406,2742,False
2016,06/12,BuffaloRochester,1.15,4629,79865,107,95730,0,2140,Summer,100359,79865,2247,False
2016,06/05,BuffaloRochester,1.15,1451,78923,258,90282,0,2530,Summer,91733,78923,2788,False
2016,05/29,BuffaloRochester,1.19,1442,81631,353,63440,0,555,Spring,64882,81631,908,False
2016,05/22,BuffaloRochester,1.12,1532,72247,856,92304,0,1310,Spring,93836,72247,2166,False
2016,05/15,BuffaloRochester,1.09,1410,72074,1160,90144,0,0,Spring,91554,72074,1160,False
2016,05/08,BuffaloRochester,1.09,1613,97493,764,101271,0,0,Spring,102884,97493,764,False
2016,05/01,BuffaloRochester,1.11,1248,69913,1640,98638,0,0,Spring,99886,69913,1640,False
2016,04/24,BuffaloRochester,1.15,1391,69260,1784,98706,0,0,Spring,100097,69260,1784,False
2016,04/17,BuffaloRochester,1.14,1167,67584,57,100545,0,0,Spring,101712,67584,57,False
2016,04/10,BuffaloRochester,1.1,1278,55802,53,94766,113,109,Spring,96044,55915,162,False
2016,04/03,BuffaloRochester,1.04,1164,72025,18,81542,51,0,Spring,82706,72076,18,False
2016,03/27,BuffaloRochester,1.13,1511,64644,44,83262,0,0,Spring,84773,64644,44,False
2016,03/20,BuffaloRochester,1.14,1110,62343,54,76855,0,0,Spring,77965,62343,54,False
2016,03/13,BuffaloRochester,1.11,1393,77324,25,84757,0,0,Spring,86150,77324,25,False
2016,03/06,BuffaloRochester,1.36,1473,60516,32,79197,8,0,Spring,80670,60524,32,False
2016,02/28,BuffaloRochester,1.22,1658,78720,36,72861,780,0,Winter,74519,79500,36,False
2016,02/21,BuffaloRochester,1.31,1500,52665,31,69018,3322,0,Winter,70518,55987,31,False
2016,02/14,BuffaloRochester,1.29,1921,60453,40,73328,2240,0,Winter,75249,62693,40,False
2016,02/07,BuffaloRochester,1.3,2262,76308,123,97444,1771,0,Winter,99706,78079,123,False
2016,01/31,BuffaloRochester,1.21,2015,81676,88,79715,957,0,Winter,81730,82633,88,False
2016,01/24,BuffaloRochester,1.31,467,54309,131,92435,126,0,Winter,92902,54435,131,False
2016,01/17,BuffaloRochester,1.38,1778,49448,120,80938,0,0,Winter,82716,49448,120,False
2016,01/10,BuffaloRochester,1.35,1619,52034,110,80759,0,0,Winter,82378,52034,110,False
2016,01/03,BuffaloRochester,1.39,1486,57210,98,71824,0,0,Winter,73310,57210,98,False
2016,12/25,Charlotte,1.25,36125,50792,7324,51247,10232,69,Winter,87372,61024,7393,False
2016,12/18,Charlotte,1.24,35761,46276,7942,44604,10048,0,Winter,80365,56324,7942,False
2016,12/11,Charlotte,1.33,43744,40971,8696,46293,6109,0,Winter,90037,47080,8696,False
2016,12/04,Charlotte,1.34,39221,46285,9451,48016,11766,0,Winter,87237,58051,9451,False
2016,11/27,Charlotte,1.54,38976,34346,8265,44005,5861,0,Fall,82981,40207,8265,False
2016,11/20,Charlotte,1.57,44044,28907,13913,42721,6021,0,Fall,86765,34928,13913,False
2016,11/13,Charlotte,1.64,49399,26597,22714,38436,6940,0,Fall,87835,33537,22714,False
2016,11/06,Charlotte,1.57,36840,27501,25305,45861,6586,0,Fall,82701,34087,25305,False
2016,10/30,Charlotte,1.58,39376,29382,26881,40258,6816,240,Fall,79634,36198,27121,False
2016,10/23,Charlotte,1.52,54981,39749,20290,47060,5658,0,Fall,102041,45407,20290,False
2016,10/16,Charlotte,1.39,57529,56366,17531,48823,10354,240,Fall,106352,66720,17771,False
2016,10/09,Charlotte,1.51,43325,52189,19419,54704,8596,0,Fall,98029,60785,19419,False
2016,10/02,Charlotte,1.48,46364,52893,16736,53332,8258,825,Fall,99696,61151,17561,False
2016,09/25,Charlotte,1.47,54110,53593,17495,55653,8278,0,Fall,109763,61871,17495,False
2016,09/18,Charlotte,1.43,43116,54193,16563,57456,11648,0,Fall,100572,65841,16563,False
2016,09/11,Charlotte,1.42,34440,59554,17914,61214,7860,5,Fall,95654,67414,17919,False
2016,09/04,Charlotte,1.33,58888,56699,18659,62373,7805,537,Fall,121261,64504,19196,False
2016,08/28,Charlotte,1.4,54874,57122,15013,58688,1906,380,Summer,113562,59028,15393,False
2016,08/21,Charlotte,1.38,44006,62975,20731,64095,1628,155,Summer,108101,64603,20886,False
2016,08/14,Charlotte,1.4,39823,66724,23025,60859,4817,0,Summer,100682,71541,23025,False
2016,08/07,Charlotte,1.43,48639,64124,24178,55636,3787,15,Summer,104275,67911,24193,False
2016,07/31,Charlotte,1.48,39819,68964,24742,50677,3330,435,Summer,90496,72294,25177,False
2016,07/24,Charlotte,1.46,34250,68516,26839,57524,3346,3432,Summer,91774,71862,30271,False
2016,07/17,Charlotte,1.43,38199,69125,25756,58481,3223,1680,Summer,96680,72348,27436,False
2016,07/10,Charlotte,1.26,43387,79103,40460,62603,4548,3157,Summer,105990,83651,43617,False
2016,07/03,Charlotte,1.2,45220,72710,40378,64809,8290,2135,Summer,110029,81000,42513,False
2016,06/26,Charlotte,1.28,36686,68054,39268,52290,3210,1010,Summer,88976,71264,40278,False
2016,06/19,Charlotte,1.21,55097,77704,46282,52830,4841,1964,Summer,107927,82545,48246,False
2016,06/12,Charlotte,1.25,42196,74895,46176,40822,3825,1178,Summer,83018,78720,47354,False
2016,06/05,Charlotte,1.25,37431,77700,41412,45859,6333,1061,Summer,83290,84033,42473,False
2016,05/29,Charlotte,1.21,49747,92110,41274,45120,6510,245,Spring,94867,98620,41519,False
2016,05/22,Charlotte,1.26,37008,95769,20859,45579,3940,335,Spring,82587,99709,21194,False
2016,05/15,Charlotte,1.12,31853,103793,17607,51589,10963,0,Spring,83442,114756,17607,False
2016,05/08,Charlotte,1.05,55853,113811,18608,57141,7275,931,Spring,112994,121086,19539,False
2016,05/01,Charlotte,1.04,53589,112926,18934,52070,12264,0,Spring,105659,125190,18934,False
2016,04/24,Charlotte,1.12,31821,106492,18456,48775,10957,883,Spring,80596,117449,19339,False
2016,04/17,Charlotte,1.14,37150,100814,17305,50673,5886,608,Spring,87823,106700,17913,False
2016,04/10,Charlotte,1.1,39141,93571,16896,48991,11986,0,Spring,88132,105557,16896,False
2016,04/03,Charlotte,1.12,35648,87528,14614,47755,6794,0,Spring,83403,94322,14614,False
2016,03/27,Charlotte,1.14,32857,90916,15518,45385,5266,0,Spring,78242,96182,15518,False
2016,03/20,Charlotte,1.15,33581,101739,18631,45426,5987,0,Spring,79007,107726,18631,False
2016,03/13,Charlotte,1.05,39325,111943,22961,50889,11010,0,Spring,90214,122953,22961,False
2016,03/06,Charlotte,1.09,38805,98212,21768,44120,5598,0,Spring,82925,103810,21768,False
2016,02/28,Charlotte,1.05,35461,106914,19046,43150,10588,0,Winter,78611,117502,19046,False
2016,02/21,Charlotte,1.07,36397,86393,19834,45927,4579,0,Winter,82324,90972,19834,False
2016,02/14,Charlotte,1.0,45730,87862,18323,44807,7387,0,Winter,90537,95249,18323,False
2016,02/07,Charlotte,0.8,63128,160544,42056,42529,17681,0,Winter,105657,178225,42056,False
2016,01/31,Charlotte,0.95,36408,108723,25918,35669,7414,0,Winter,72077,116137,25918,False
2016,01/24,Charlotte,0.92,13436,110261,30644,42136,11481,0,Winter,55572,121742,30644,False
2016,01/17,Charlotte,0.98,29997,104174,29112,37725,5767,0,Winter,67722,109941,29112,False
2016,01/10,Charlotte,0.95,21275,94804,29602,42015,8518,0,Winter,63290,103322,29602,False
2016,01/03,Charlotte,0.96,42856,87749,31682,38144,3529,0,Winter,81000,91278,31682,False
2016,12/25,Chicago,1.22,67145,352087,110167,81570,955,4727,Winter,148715,353042,114894,False
2016,12/18,Chicago,1.18,92760,363657,101491,65277,1065,6864,Winter,158037,364722,108355,False
2016,12/11,Chicago,1.09,84616,449932,103932,87751,1102,7619,Winter,172367,451034,111551,False
2016,12/04,Chicago,1.27,90157,372929,94496,64475,621,2071,Winter,154632,373550,96567,False
2016,11/27,Chicago,1.1,151462,291205,81651,56501,797,20,Fall,207963,292002,81671,False
2016,11/20,Chicago,1.13,134284,422382,80126,55015,997,2066,Fall,189299,423379,82192,False
2016,11/13,Chicago,1.82,34384,265006,73021,63465,593,238,Fall,97849,265599,73259,False
2016,11/06,Chicago,2.07,31206,224561,61665,57803,1095,143,Fall,89009,225656,61808,False
2016,10/30,Chicago,2.07,33564,226980,60260,48140,1587,4679,Fall,81704,228567,64939,False
2016,10/23,Chicago,1.84,46708,251074,68234,55554,790,8911,Fall,102262,251864,77145,False
2016,10/16,Chicago,1.8,52200,324240,75841,61522,1047,8830,Fall,113722,325287,84671,False
2016,10/09,Chicago,1.82,40105,314006,90031,60216,968,9817,Fall,100321,314974,99848,False
2016,10/02,Chicago,1.83,37926,311085,90495,58004,530,11173,Fall,95930,311615,101668,False
2016,09/25,Chicago,1.8,40600,337874,98808,65665,744,10170,Fall,106265,338618,108978,False
2016,09/18,Chicago,1.7,74368,340540,97900,80619,802,6158,Fall,154987,341342,104058,False
2016,09/11,Chicago,1.67,80472,355228,99520,97150,2084,578,Fall,177622,357312,100098,False
2016,09/04,Chicago,1.6,77981,415924,91323,82376,2320,526,Fall,160357,418244,91849,False
2016,08/28,Chicago,1.6,54971,373442,93288,92533,4244,3235,Summer,147504,377686,96523,False
2016,08/21,Chicago,1.63,62002,372918,87449,102613,1582,1532,Summer,164615,374500,88981,False
2016,08/14,Chicago,1.67,49617,371087,102966,99833,2139,443,Summer,149450,373226,103409,False
2016,08/07,Chicago,1.68,40121,385923,103402,113969,262,991,Summer,154090,386185,104393,False
2016,07/31,Chicago,1.68,38275,373205,97843,104111,317,1185,Summer,142386,373522,99028,False
2016,07/24,Chicago,1.66,42452,386821,109032,113683,1819,5103,Summer,156135,388640,114135,False
2016,07/17,Chicago,1.51,43789,425776,108230,122026,12735,4721,Summer,165815,438511,112951,False
2016,07/10,Chicago,1.53,52540,381030,150963,118624,1894,7027,Summer,171164,382924,157990,False
2016,07/03,Chicago,1.23,55651,584813,184518,143295,378,5620,Summer,198946,585191,190138,False
2016,06/26,Chicago,1.18,80280,499474,159812,115880,457,4265,Summer,196160,499931,164077,False
2016,06/19,Chicago,1.2,64899,550499,163027,99766,1867,2013,Summer,164665,552366,165040,False
2016,06/12,Chicago,1.3,50498,478335,140924,98096,2213,773,Summer,148594,480548,141697,False
2016,06/05,Chicago,1.2,31728,606701,145606,96845,3216,1503,Summer,128573,609917,147109,False
2016,05/29,Chicago,1.15,36554,642857,145363,129034,3359,1396,Spring,165588,646216,146759,False
2016,05/22,Chicago,1.11,36568,592064,145104,121785,6544,1797,Spring,158353,598608,146901,False
2016,05/15,Chicago,1.04,49039,609294,157984,108571,4797,715,Spring,157610,614091,158699,False
2016,05/08,Chicago,0.97,43166,612339,173293,137880,4997,3061,Spring,181046,617336,176354,False
2016,05/01,Chicago,1.0,39249,587919,155289,101940,4166,1715,Spring,141189,592085,157004,False
2016,04/24,Chicago,1.08,34134,592370,151281,96823,4684,13,Spring,130957,597054,151294,False
2016,04/17,Chicago,1.08,47878,619840,137009,101842,4806,2044,Spring,149720,624646,139053,False
2016,04/10,Chicago,1.11,49679,464981,153441,91081,9926,1550,Spring,140760,474907,154991,False
2016,04/03,Chicago,1.15,36211,457314,139240,75467,3947,29,Spring,111678,461261,139269,False
2016,03/27,Chicago,0.9,33748,600796,131467,95288,4221,62,Spring,129036,605017,131529,False
2016,03/20,Chicago,1.11,36017,514604,122807,93973,3147,7,Spring,129990,517751,122814,False
2016,03/13,Chicago,1.0,39540,569733,125901,86428,2191,0,Spring,125968,571924,125901,False
2016,03/06,Chicago,1.13,35309,557026,129160,85606,2222,0,Spring,120915,559248,129160,False
2016,02/28,Chicago,1.15,32414,522790,133067,90777,1902,0,Winter,123191,524692,133067,False
2016,02/21,Chicago,1.09,39220,483562,125838,93141,10558,14,Winter,132361,494120,125852,False
2016,02/14,Chicago,1.0,45558,501188,131202,106296,18322,551,Winter,151854,519510,131753,False
2016,02/07,Chicago,0.82,68454,758581,155377,129791,21748,95,Winter,198245,780329,155472,False
2016,01/31,Chicago,1.12,35213,512608,132958,92124,1186,0,Winter,127337,513794,132958,False
2016,01/24,Chicago,1.01,23862,543471,136033,88261,2400,0,Winter,112123,545871,136033,False
2016,01/17,Chicago,1.11,35099,500623,139309,87560,15802,16,Winter,122659,516425,139325,False
2016,01/10,Chicago,1.08,44289,534404,143202,82670,39333,376,Winter,126959,573737,143578,False
2016,01/03,Chicago,0.93,77301,656386,162054,80769,21615,11540,Winter,158070,678001,173594,False
2016,12/25,CincinnatiDayton,0.82,2168,102227,970,26984,144036,0,Winter,29152,246263,970,False
2016,12/18,CincinnatiDayton,0.99,2279,100542,1472,23082,89485,18,Winter,25361,190027,1490,False
2016,12/11,CincinnatiDayton,0.77,2474,101664,753,21944,141290,38,Winter,24418,242954,791,False
2016,12/04,CincinnatiDayton,0.7,2443,132792,2845,24193,194318,23,Winter,26636,327110,2868,False
2016,11/27,CincinnatiDayton,1.09,1811,75977,690,19930,84702,65,Fall,21741,160679,755,False
2016,11/20,CincinnatiDayton,0.98,2013,85407,853,23679,130220,0,Fall,25692,215627,853,False
2016,11/13,CincinnatiDayton,1.07,2998,92084,899,23980,129104,6,Fall,26978,221188,905,False
2016,11/06,CincinnatiDayton,1.08,2895,91902,1003,16151,127193,86,Fall,19046,219095,1089,False
2016,10/30,CincinnatiDayton,1.02,2125,89381,841,11631,137691,0,Fall,13756,227072,841,False
2016,10/23,CincinnatiDayton,0.96,2790,94637,1181,18785,156407,1,Fall,21575,251044,1182,False
2016,10/16,CincinnatiDayton,1.07,6797,89324,1275,32352,117051,0,Fall,39149,206375,1275,False
2016,10/09,CincinnatiDayton,1.01,3166,100995,1223,21810,149624,0,Fall,24976,250619,1223,False
2016,10/02,CincinnatiDayton,1.03,3206,105492,1380,22840,147472,3,Fall,26046,252964,1383,False
2016,09/25,CincinnatiDayton,1.09,3821,112149,1396,23812,127624,0,Fall,27633,239773,1396,False
2016,09/18,CincinnatiDayton,0.96,6195,112907,1335,30495,137923,0,Fall,36690,250830,1335,False
2016,09/11,CincinnatiDayton,1.04,5370,122058,1567,29123,108519,80,Fall,34493,230577,1647,False
2016,09/04,CincinnatiDayton,1.12,3789,117600,2099,25361,102794,415,Fall,29150,220394,2514,False
2016,08/28,CincinnatiDayton,1.13,3862,126642,1683,27933,97229,1790,Summer,31795,223871,3473,False
2016,08/21,CincinnatiDayton,1.07,3838,118303,1922,28706,102390,1035,Summer,32544,220693,2957,False
2016,08/14,CincinnatiDayton,1.03,4691,125988,2661,35321,105549,38,Summer,40012,231537,2699,False
2016,08/07,CincinnatiDayton,1.03,5244,130022,3143,27221,100553,11,Summer,32465,230575,3154,False
2016,07/31,CincinnatiDayton,1.07,4322,129945,3804,27836,88090,690,Summer,32158,218035,4494,False
2016,07/24,CincinnatiDayton,1.1,4346,133484,7052,25436,89695,4178,Summer,29782,223179,11230,False
2016,07/17,CincinnatiDayton,1.05,5441,136098,6998,25789,101973,4240,Summer,31230,238071,11238,False
2016,07/10,CincinnatiDayton,1.06,4664,149184,6514,23189,78560,4698,Summer,27853,227744,11212,False
2016,07/03,CincinnatiDayton,0.84,4595,168217,6496,28096,118272,4504,Summer,32691,286489,11000,False
2016,06/26,CincinnatiDayton,0.92,4553,161667,9805,24577,75549,4077,Summer,29130,237216,13882,False
2016,06/19,CincinnatiDayton,0.91,7033,154162,14007,25143,105248,5532,Summer,32176,259410,19539,False
2016,06/12,CincinnatiDayton,1.05,7943,149994,7051,23417,46347,3019,Summer,31360,196341,10070,False
2016,06/05,CincinnatiDayton,0.85,4642,174172,23750,19176,81916,6686,Summer,23818,256088,30436,False
2016,05/29,CincinnatiDayton,0.84,4644,164356,7148,20884,69163,2131,Spring,25528,233519,9279,False
2016,05/22,CincinnatiDayton,0.82,4092,144150,6810,18281,74251,2800,Spring,22373,218401,9610,False
2016,05/15,CincinnatiDayton,0.88,3505,151116,21963,14077,53944,5725,Spring,17582,205060,27688,False
2016,05/08,CincinnatiDayton,0.86,4411,183121,17789,17361,87869,3688,Spring,21772,270990,21477,False
2016,05/01,CincinnatiDayton,0.94,4132,156007,9601,17965,44324,1549,Spring,22097,200331,11150,False
2016,04/24,CincinnatiDayton,0.94,4307,141433,9484,19112,41934,1974,Spring,23419,183367,11458,False
2016,04/17,CincinnatiDayton,0.93,3369,141000,25464,16055,36551,5770,Spring,19424,177551,31234,False
2016,04/10,CincinnatiDayton,0.89,4234,125252,8960,21423,49093,1344,Spring,25657,174345,10304,False
2016,04/03,CincinnatiDayton,0.89,3481,109917,10846,13780,50468,2674,Spring,17261,160385,13520,False
2016,03/27,CincinnatiDayton,0.9,3097,131467,16191,18832,52163,3734,Spring,21929,183630,19925,False
2016,03/20,CincinnatiDayton,0.9,3139,132074,16430,18928,50472,3897,Spring,22067,182546,20327,False
2016,03/13,CincinnatiDayton,0.88,3172,126850,7482,19111,52395,1892,Spring,22283,179245,9374,False
2016,03/06,CincinnatiDayton,0.85,3704,129150,24314,17632,54219,5491,Spring,21336,183369,29805,False
2016,02/28,CincinnatiDayton,0.87,4252,129161,16207,18382,56152,3438,Winter,22634,185313,19645,False
2016,02/21,CincinnatiDayton,0.86,3480,117328,5551,17167,45673,1147,Winter,20647,163001,6698,False
2016,02/14,CincinnatiDayton,0.86,3898,144374,8008,18358,53192,1378,Winter,22256,197566,9386,False
2016,02/07,CincinnatiDayton,0.81,4898,177380,30149,22076,61180,6651,Winter,26974,238560,36800,False
2016,01/31,CincinnatiDayton,0.94,3261,133276,12917,16807,33496,3246,Winter,20068,166772,16163,False
2016,01/24,CincinnatiDayton,0.89,1985,155256,23681,19633,47199,4561,Winter,21618,202455,28242,False
2016,01/17,CincinnatiDayton,0.86,3683,142145,7457,20728,53232,1613,Winter,24411,195377,9070,False
2016,01/10,CincinnatiDayton,0.92,3115,151374,7200,17942,37684,1590,Winter,21057,189058,8790,False
2016,01/03,CincinnatiDayton,0.9,2730,149327,18924,12613,29550,9387,Winter,15343,178877,28311,False
2016,12/25,Columbus,1.07,54284,24334,1538,55083,1459,33,Winter,109367,25793,1571,False
2016,12/18,Columbus,1.06,55604,31791,2522,38839,2461,102,Winter,94443,34252,2624,False
2016,12/11,Columbus,0.98,79158,19836,1302,41890,2155,11,Winter,121048,21991,1313,False
2016,12/04,Columbus,0.84,108397,42477,5532,76008,5158,65,Winter,184405,47635,5597,False
2016,11/27,Columbus,1.1,58518,19133,1296,53684,1671,1,Fall,112202,20804,1297,False
2016,11/20,Columbus,1.33,50017,21270,1335,43073,1601,0,Fall,93090,22871,1335,False
2016,11/13,Columbus,1.38,52996,26129,1460,34146,2082,0,Fall,87142,28211,1460,False
2016,11/06,Columbus,1.41,55230,23397,1603,32556,1419,0,Fall,87786,24816,1603,False
2016,10/30,Columbus,1.1,75422,16016,1373,43902,1850,0,Fall,119324,17866,1373,False
2016,10/23,Columbus,1.11,84696,21559,1763,46730,2081,0,Fall,131426,23640,1763,False
2016,10/16,Columbus,1.31,53963,22128,1875,43150,2270,0,Fall,97113,24398,1875,False
2016,10/09,Columbus,1.33,55586,23318,1900,36596,3430,0,Fall,92182,26748,1900,False
2016,10/02,Columbus,1.3,54053,25747,2077,36952,4469,0,Fall,91005,30216,2077,False
2016,09/25,Columbus,1.14,70129,37333,2426,41377,711,0,Fall,111506,38044,2426,False
2016,09/18,Columbus,1.07,85331,26634,2505,51334,1631,0,Fall,136665,28265,2505,False
2016,09/11,Columbus,1.06,89423,25412,2345,58343,1755,20,Fall,147766,27167,2365,False
2016,09/04,Columbus,1.06,73011,29161,2616,55935,466,171,Fall,128946,29627,2787,False
2016,08/28,Columbus,1.07,71113,34419,2593,57069,1842,1720,Summer,128182,36261,4313,False
2016,08/21,Columbus,1.2,69616,33284,2841,42940,4122,1310,Summer,112556,37406,4151,False
2016,08/14,Columbus,1.17,71827,34064,3156,53549,3864,0,Summer,125376,37928,3156,False
2016,08/07,Columbus,1.18,70942,37215,3955,38682,13474,10,Summer,109624,50689,3965,False
2016,07/31,Columbus,1.21,71526,31744,4294,38377,7260,600,Summer,109903,39004,4894,False
2016,07/24,Columbus,1.15,73713,34227,6083,46627,8564,4119,Summer,120340,42791,10202,False
2016,07/17,Columbus,1.18,69177,38319,6345,38846,2931,4793,Summer,108023,41250,11138,False
2016,07/10,Columbus,1.06,80019,36096,5812,32848,11536,4447,Summer,112867,47632,10259,False
2016,07/03,Columbus,0.94,118888,38361,6699,62163,4656,4206,Summer,181051,43017,10905,False
2016,06/26,Columbus,1.04,99552,37201,10852,45985,4847,3482,Summer,145537,42048,14334,False
2016,06/19,Columbus,1.13,64425,36827,15000,45124,6081,4761,Summer,109549,42908,19761,False
2016,06/12,Columbus,1.13,65443,32052,8090,49307,6081,2663,Summer,114750,38133,10753,False
2016,06/05,Columbus,1.07,62727,38734,25833,35846,6408,5495,Summer,98573,45142,31328,False
2016,05/29,Columbus,0.93,95063,36787,7985,53230,6885,1795,Spring,148293,43672,9780,False
2016,05/22,Columbus,0.83,105959,37763,6777,48049,9991,1720,Spring,154008,47754,8497,False
2016,05/15,Columbus,0.84,76164,47725,21036,33941,18532,4600,Spring,110105,66257,25636,False
2016,05/08,Columbus,0.9,90444,46435,19164,26507,15137,3516,Spring,116951,61572,22680,False
2016,05/01,Columbus,0.71,111020,47074,9592,48051,7485,1290,Spring,159071,54559,10882,False
2016,04/24,Columbus,0.72,132004,35758,10151,54682,8238,1441,Spring,186686,43996,11592,False
2016,04/17,Columbus,0.97,56381,48784,27374,27199,7590,4854,Spring,83580,56374,32228,False
2016,04/10,Columbus,0.96,57345,27302,9075,31689,9453,1038,Spring,89034,36755,10113,False
2016,04/03,Columbus,0.95,50791,28964,21041,22994,21163,2564,Spring,73785,50127,23605,False
2016,03/27,Columbus,1.01,46922,32127,29363,21567,20098,3442,Spring,68489,52225,32805,False
2016,03/20,Columbus,1.04,46047,35537,28532,22445,16153,3855,Spring,68492,51690,32387,False
2016,03/13,Columbus,1.05,47503,31781,18665,26468,14097,1727,Spring,73971,45878,20392,False
2016,03/06,Columbus,0.95,49586,42501,35277,23754,17567,5138,Spring,73340,60068,40415,False
2016,02/28,Columbus,1.03,48902,41405,28499,22422,10262,3474,Winter,71324,51667,31973,False
2016,02/21,Columbus,1.05,46771,36674,15757,19800,6111,951,Winter,66571,42785,16708,False
2016,02/14,Columbus,0.91,82198,38935,17174,27386,7182,1102,Winter,109584,46117,18276,False
2016,02/07,Columbus,0.81,99884,55303,36191,30226,6961,5337,Winter,130110,62264,41528,False
2016,01/31,Columbus,0.92,78646,38158,23466,21259,9258,2521,Winter,99905,47416,25987,False
2016,01/24,Columbus,0.89,95511,43916,35349,28562,4435,5439,Winter,124073,48351,40788,False
2016,01/17,Columbus,1.03,52491,30084,20930,23123,6492,1482,Winter,75614,36576,22412,False
2016,01/10,Columbus,0.97,82729,33601,17903,21493,6988,1260,Winter,104222,40589,19163,False
2016,01/03,Columbus,0.91,86025,40616,32940,18463,6208,8519,Winter,104488,46824,41459,False
2016,12/25,DallasFtWorth,0.76,503168,313572,3069,374905,2661,2259,Winter,878073,316233,5328,False
2016,12/18,DallasFtWorth,0.69,571587,250532,2578,315924,2246,5381,Winter,887511,252778,7959,False
2016,12/11,DallasFtWorth,0.69,643580,188669,3182,279258,2393,4223,Winter,922838,191062,7405,False
2016,12/04,DallasFtWorth,0.69,714899,187180,3035,333769,2664,3921,Winter,1048668,189844,6956,False
2016,11/27,DallasFtWorth,0.9,445308,158734,2459,242623,2390,62,Fall,687931,161124,2521,False
2016,11/20,DallasFtWorth,1.0,503088,183916,2767,219494,746,212,Fall,722582,184662,2979,False
2016,11/13,DallasFtWorth,1.08,480163,199890,3946,209726,160,113,Fall,689889,200050,4059,False
2016,11/06,DallasFtWorth,1.14,513465,163205,1932,215425,273,601,Fall,728890,163478,2533,False
2016,10/30,DallasFtWorth,1.14,432538,156225,2502,208940,806,68,Fall,641478,157031,2570,False
2016,10/23,DallasFtWorth,1.08,420151,240421,3183,323804,4850,1574,Fall,743955,245271,4757,False
2016,10/16,DallasFtWorth,0.99,526672,188632,2336,296850,3145,3390,Fall,823522,191777,5726,False
2016,10/09,DallasFtWorth,0.93,546920,283336,5584,322925,2677,889,Fall,869845,286013,6473,False
2016,10/02,DallasFtWorth,0.95,534106,186983,1901,301904,4185,4207,Fall,836010,191168,6108,False
2016,09/25,DallasFtWorth,0.92,574457,228335,1797,319927,25698,572,Fall,894384,254033,2369,False
2016,09/18,DallasFtWorth,0.8,649265,269041,2164,454623,5993,1269,Fall,1103888,275034,3433,False
2016,09/11,DallasFtWorth,0.79,714506,230292,2193,350013,9088,2876,Fall,1064519,239380,5069,False
2016,09/04,DallasFtWorth,0.74,719597,256376,2742,401417,5723,5035,Fall,1121014,262099,7777,False
2016,08/28,DallasFtWorth,0.74,624795,255433,2998,366510,2461,8486,Summer,991305,257894,11484,False
2016,08/21,DallasFtWorth,0.77,625055,231496,4763,351623,902,1319,Summer,976678,232398,6082,False
2016,08/14,DallasFtWorth,0.88,612988,240643,3600,270626,3256,997,Summer,883614,243899,4597,False
2016,08/07,DallasFtWorth,0.83,711725,241321,3385,269821,14711,3114,Summer,981546,256032,6499,False
2016,07/31,DallasFtWorth,0.88,670208,213925,4548,253660,19284,2156,Summer,923868,233209,6704,False
2016,07/24,DallasFtWorth,0.94,651630,228112,4388,281847,14107,8724,Summer,933477,242219,13112,False
2016,07/17,DallasFtWorth,0.96,542103,210287,7622,303925,2984,3426,Summer,846028,213271,11048,False
2016,07/10,DallasFtWorth,0.91,546253,205087,40097,267623,8348,12828,Summer,813876,213435,52925,False
2016,07/03,DallasFtWorth,0.89,609482,273911,95675,324924,16194,30681,Summer,934406,290105,126356,False
2016,06/26,DallasFtWorth,0.85,657914,213129,86435,298365,7080,14562,Summer,956279,220209,100997,False
2016,06/19,DallasFtWorth,0.87,633636,250585,61508,272250,12776,6064,Summer,905886,263361,67572,False
2016,06/12,DallasFtWorth,0.84,695737,219368,87625,251773,12923,4738,Summer,947510,232291,92363,False
2016,06/05,DallasFtWorth,0.82,655971,313963,74560,283260,8707,7192,Summer,939231,322670,81752,False
2016,05/29,DallasFtWorth,0.77,682737,292600,58729,301233,10985,8411,Spring,983970,303585,67140,False
2016,05/22,DallasFtWorth,0.7,596612,352914,102484,300179,21095,5602,Spring,896791,374009,108086,False
2016,05/15,DallasFtWorth,0.71,620139,308643,77616,341082,16387,2569,Spring,961221,325030,80185,False
2016,05/08,DallasFtWorth,0.72,683286,307560,130305,331925,19971,2731,Spring,1015211,327531,133036,False
2016,05/01,DallasFtWorth,0.71,671692,319831,63779,356218,21755,419,Spring,1027910,341586,64198,False
2016,04/24,DallasFtWorth,0.65,672950,327965,102387,352619,26934,66,Spring,1025569,354899,102453,False
2016,04/17,DallasFtWorth,0.69,646060,232035,113528,318316,28701,1084,Spring,964376,260736,114612,False
2016,04/10,DallasFtWorth,0.69,753607,211182,112050,316405,27732,3339,Spring,1070012,238914,115389,False
2016,04/03,DallasFtWorth,0.7,690160,245283,112749,269775,20797,443,Spring,959935,266080,113192,False
2016,03/27,DallasFtWorth,0.76,631283,291595,129805,270162,18871,21,Spring,901445,310466,129826,False
2016,03/20,DallasFtWorth,0.74,620848,317080,134806,254808,20317,23,Spring,875656,337397,134829,False
2016,03/13,DallasFtWorth,0.78,647713,217853,118454,178757,14527,3,Spring,826470,232380,118457,False
2016,03/06,DallasFtWorth,0.76,705096,198717,67156,213428,17359,10,Spring,918524,216076,67166,False
2016,02/28,DallasFtWorth,0.74,717451,207475,53555,202051,19078,17,Winter,919502,226553,53572,False
2016,02/21,DallasFtWorth,0.83,543538,221807,70976,151328,18486,43,Winter,694866,240293,71019,False
2016,02/14,DallasFtWorth,0.65,749745,306905,135347,150047,14228,2278,Winter,899792,321133,137625,False
2016,02/07,DallasFtWorth,0.71,766439,410258,143875,155052,20895,18743,Winter,921491,431153,162618,False
2016,01/31,DallasFtWorth,0.8,603099,287514,78916,121050,19753,18304,Winter,724149,307267,97220,False
2016,01/24,DallasFtWorth,1.02,187313,289208,47421,128164,12679,11245,Winter,315477,301887,58666,False
2016,01/17,DallasFtWorth,0.79,600983,369825,79252,99602,15226,45,Winter,700585,385051,79297,False
2016,01/10,DallasFtWorth,0.85,558567,394770,54920,127168,10290,19,Winter,685735,405060,54939,False
2016,01/03,DallasFtWorth,0.78,551921,411340,80184,144358,3764,357,Winter,696279,415104,80541,False
2016,12/25,Denver,1.04,123942,206365,15600,267985,151602,15,Winter,391927,357967,15615,False
2016,12/18,Denver,1.04,116069,232182,10972,246935,99582,8,Winter,363004,331764,10980,False
2016,12/11,Denver,0.95,110202,219903,11427,303762,118838,0,Winter,413964,338741,11427,False
2016,12/04,Denver,0.91,129940,277374,11512,141279,295881,0,Winter,271219,573255,11512,False
2016,11/27,Denver,1.3,86311,131940,14113,81706,141397,0,Fall,168017,273337,14113,False
2016,11/20,Denver,1.28,94899,146401,15291,164217,123006,0,Fall,259116,269407,15291,False
2016,11/13,Denver,1.18,133528,197035,16010,84341,230381,0,Fall,217869,427416,16010,False
2016,11/06,Denver,1.31,110497,148423,18858,81361,174689,117,Fall,191858,323112,18975,False
2016,10/30,Denver,1.13,99369,239345,16411,76674,144255,297,Fall,176043,383600,16708,False
2016,10/23,Denver,1.24,100519,166315,19086,67816,240555,98,Fall,168335,406870,19184,False
2016,10/16,Denver,1.15,129257,156075,16490,91676,279893,0,Fall,220933,435968,16490,False
2016,10/09,Denver,1.08,149621,240858,13026,85264,269465,0,Fall,234885,510323,13026,False
2016,10/02,Denver,1.18,124504,172835,16447,76212,287071,0,Fall,200716,459906,16447,False
2016,09/25,Denver,1.15,135131,168060,16829,91074,269661,188,Fall,226205,437721,17017,False
2016,09/18,Denver,1.02,134607,198214,16328,87026,320842,338,Fall,221633,519056,16666,False
2016,09/11,Denver,0.98,112292,227729,14432,93898,342085,1127,Fall,206190,569814,15559,False
2016,09/04,Denver,0.91,146921,254464,17239,83143,422509,0,Fall,230064,676973,17239,False
2016,08/28,Denver,0.91,138029,282568,13197,131367,390977,1325,Summer,269396,673545,14522,False
2016,08/21,Denver,1.22,150776,190694,13732,119819,127269,715,Summer,270595,317963,14447,False
2016,08/14,Denver,1.18,120449,189114,19582,100509,228324,0,Summer,220958,417438,19582,False
2016,08/07,Denver,1.14,168010,183568,18624,151220,172079,1612,Summer,319230,355647,20236,False
2016,07/31,Denver,1.15,144730,178801,19083,200378,129901,693,Summer,345108,308702,19776,False
2016,07/24,Denver,1.17,128025,187555,19241,135290,217563,3218,Summer,263315,405118,22459,False
2016,07/17,Denver,1.07,145158,204309,19016,148177,254837,105,Summer,293335,459146,19121,False
2016,07/10,Denver,1.04,190377,230361,20484,137890,252846,3155,Summer,328267,483207,23639,False
2016,07/03,Denver,1.03,170576,256861,21306,200147,162792,4015,Summer,370723,419653,25321,False
2016,06/26,Denver,0.98,165858,229712,17278,146703,213090,1033,Summer,312561,442802,18311,False
2016,06/19,Denver,1.0,188105,224899,20738,96129,260598,541,Summer,284234,485497,21279,False
2016,06/12,Denver,0.96,179533,242834,19838,91438,284376,1642,Summer,270971,527210,21480,False
2016,06/05,Denver,0.85,184534,326966,16485,83337,327755,0,Summer,267871,654721,16485,False
2016,05/29,Denver,0.85,181470,282618,33023,79916,400601,240,Spring,261386,683219,33263,False
2016,05/22,Denver,0.9,160299,266856,17526,79603,407238,623,Spring,239902,674094,18149,False
2016,05/15,Denver,0.9,159348,252574,39117,71486,427648,2179,Spring,230834,680222,41296,False
2016,05/08,Denver,0.8,181354,427697,13291,73293,416966,1310,Spring,254647,844663,14601,False
2016,05/01,Denver,0.87,153151,261525,15299,155354,231175,2604,Spring,308505,492700,17903,False
2016,04/24,Denver,0.93,132550,225788,11418,89444,200703,2006,Spring,221994,426491,13424,False
2016,04/17,Denver,0.78,171831,285967,27995,59672,461184,4612,Spring,231503,747151,32607,False
2016,04/10,Denver,0.77,127374,353040,11020,178429,311446,1505,Spring,305803,664486,12525,False
2016,04/03,Denver,0.83,153221,209188,25632,39142,402239,0,Spring,192363,611427,25632,False
2016,03/27,Denver,0.95,150919,208644,20423,47124,289789,0,Spring,198043,498433,20423,False
2016,03/20,Denver,0.73,138938,360370,10950,46784,448815,0,Spring,185722,809185,10950,False
2016,03/13,Denver,0.83,158016,261685,33866,50279,320943,1,Spring,208295,582628,33867,False
2016,03/06,Denver,0.98,145893,242906,18706,47418,216743,0,Spring,193311,459649,18706,False
2016,02/28,Denver,0.74,118099,300335,62908,43136,533591,17,Winter,161235,833926,62925,False
2016,02/21,Denver,0.73,155250,331998,14973,43379,409969,12,Winter,198629,741967,14985,False
2016,02/14,Denver,0.7,178547,277085,17992,43323,449185,0,Winter,221870,726270,17992,False
2016,02/07,Denver,0.63,230721,557897,18935,50217,507786,0,Winter,280938,1065683,18935,False
2016,01/31,Denver,0.8,167669,270481,27489,45613,381448,0,Winter,213282,651929,27489,False
2016,01/24,Denver,0.6,25727,404617,15454,43669,706052,0,Winter,69396,1110669,15454,False
2016,01/17,Denver,0.66,118599,403009,31009,43026,649528,0,Winter,161625,1052537,31009,False
2016,01/10,Denver,0.72,146631,366330,37684,44731,499568,0,Winter,191362,865898,37684,False
2016,01/03,Denver,0.6,114121,526048,10374,33033,611655,12,Winter,147154,1137703,10386,False
2016,12/25,Detroit,1.06,89825,59758,7121,161040,2191,19,Winter,250865,61949,7140,False
2016,12/18,Detroit,1.05,82536,85859,10805,117398,2071,84,Winter,199934,87930,10889,False
2016,12/11,Detroit,0.95,135589,44003,5245,145974,2039,257,Winter,281563,46042,5502,False
2016,12/04,Detroit,0.81,156549,173437,22752,188722,3634,118,Winter,345271,177071,22870,False
2016,11/27,Detroit,1.18,86557,47554,4974,121146,2289,7,Fall,207703,49843,4981,False
2016,11/20,Detroit,1.35,76104,46523,5327,114230,1381,8,Fall,190334,47904,5335,False
2016,11/13,Detroit,1.39,78974,43868,5687,107105,873,14,Fall,186079,44741,5701,False
2016,11/06,Detroit,1.4,80604,46242,5688,97805,1073,7,Fall,178409,47315,5695,False
2016,10/30,Detroit,1.4,75576,41553,4805,70936,1058,8,Fall,146512,42611,4813,False
2016,10/23,Detroit,1.35,84500,51517,8023,80684,2492,16,Fall,165184,54009,8039,False
2016,10/16,Detroit,1.26,83560,51486,6767,112344,2581,3,Fall,195904,54067,6770,False
2016,10/09,Detroit,1.27,85266,50763,6966,104611,6147,130,Fall,189877,56910,7096,False
2016,10/02,Detroit,1.25,83699,49320,7837,118414,7604,16,Fall,202113,56924,7853,False
2016,09/25,Detroit,1.24,89632,50863,8202,124695,1542,1,Fall,214327,52405,8203,False
2016,09/18,Detroit,1.1,105595,53981,8602,147793,4601,174,Fall,253388,58582,8776,False
2016,09/11,Detroit,1.09,123013,57728,10905,143846,4395,0,Fall,266859,62123,10905,False
2016,09/04,Detroit,1.08,119899,56047,11880,138186,287,35,Fall,258085,56334,11915,False
2016,08/28,Detroit,1.01,123353,54190,10761,164229,533,352,Summer,287582,54723,11113,False
2016,08/21,Detroit,1.15,121469,53707,13151,127061,108,1360,Summer,248530,53815,14511,False
2016,08/14,Detroit,1.08,127204,53136,15900,168988,1081,696,Summer,296192,54217,16596,False
2016,08/07,Detroit,1.13,127164,60621,20552,124979,18669,776,Summer,252143,79290,21328,False
2016,07/31,Detroit,1.16,133525,51178,23139,122542,5808,3981,Summer,256067,56986,27120,False
2016,07/24,Detroit,1.15,133984,39970,40559,111538,10056,18467,Summer,245522,50026,59026,False
2016,07/17,Detroit,1.17,126817,41460,41888,100212,906,16951,Summer,227029,42366,58839,False
2016,07/10,Detroit,1.18,117420,41580,38634,82669,14996,15939,Summer,200089,56576,54573,False
2016,07/03,Detroit,1.17,127175,42029,37960,113573,2084,13879,Summer,240748,44113,51839,False
2016,06/26,Detroit,1.13,116197,50835,57169,101180,242,18764,Summer,217377,51077,75933,False
2016,06/19,Detroit,1.0,149055,60807,75225,130698,1731,25442,Summer,279753,62538,100667,False
2016,06/12,Detroit,0.98,162656,38374,38384,160647,1915,12553,Summer,323303,40289,50937,False
2016,06/05,Detroit,0.92,121769,90921,123670,94467,3849,38452,Summer,216236,94770,162122,False
2016,05/29,Detroit,1.04,127403,45533,38082,122656,4439,10441,Spring,250059,49972,48523,False
2016,05/22,Detroit,1.07,118921,40268,35077,94755,4350,9956,Spring,213676,44618,45033,False
2016,05/15,Detroit,0.86,139497,86027,120894,86915,16445,35871,Spring,226412,102472,156765,False
2016,05/08,Detroit,0.96,168696,84169,107930,91310,21053,27264,Spring,260006,105222,135194,False
2016,05/01,Detroit,1.0,109542,48135,46048,97920,6527,11216,Spring,207462,54662,57264,False
2016,04/24,Detroit,1.0,116267,50906,45925,102880,6973,8156,Spring,219147,57879,54081,False
2016,04/17,Detroit,0.97,96173,116000,132061,66168,6262,30679,Spring,162341,122262,162740,False
2016,04/10,Detroit,1.03,126215,30729,44982,92085,10172,8811,Spring,218300,40901,53793,False
2016,04/03,Detroit,1.02,121653,33903,72329,65916,27480,13825,Spring,187569,61383,86154,False
2016,03/27,Detroit,1.05,80333,65448,119488,55446,37647,20067,Spring,135779,103095,139555,False
2016,03/20,Detroit,1.09,78492,67761,111819,58374,35829,19362,Spring,136866,103590,131181,False
2016,03/13,Detroit,1.12,82406,42593,65646,66513,32804,9562,Spring,148919,75397,75208,False
2016,03/06,Detroit,0.97,79240,86747,154833,47041,43570,30487,Spring,126281,130317,185320,False
2016,02/28,Detroit,1.13,82100,66020,108296,49708,19350,16989,Winter,131808,85370,125285,False
2016,02/21,Detroit,1.2,76211,42300,62843,47259,10247,8957,Winter,123470,52547,71800,False
2016,02/14,Detroit,1.0,129795,51191,71030,60254,12167,10104,Winter,190049,63358,81134,False
2016,02/07,Detroit,0.77,169611,118251,192417,58664,17270,38570,Winter,228275,135521,230987,False
2016,01/31,Detroit,1.04,131406,59678,96298,49335,12767,15125,Winter,180741,72445,111423,False
2016,01/24,Detroit,0.94,154051,95837,151279,58403,4513,25498,Winter,212454,100350,176777,False
2016,01/17,Detroit,1.11,82804,46382,78514,70769,4505,10270,Winter,153573,50887,88784,False
2016,01/10,Detroit,1.1,133286,49832,73427,57082,2453,9915,Winter,190368,52285,83342,False
2016,01/03,Detroit,0.86,165617,93942,143911,51669,2096,35462,Winter,217286,96038,179373,False
2016,12/25,GrandRapids,1.33,1345,91323,3768,47453,5227,230,Winter,48798,96550,3998,False
2016,12/18,GrandRapids,1.14,908,109288,4631,42335,3947,26,Winter,43243,113235,4657,False
2016,12/11,GrandRapids,1.2,1044,60598,2268,58703,5538,12,Winter,59747,66136,2280,False
2016,12/04,GrandRapids,0.92,1092,189101,9125,61980,2547,55,Winter,63072,191648,9180,False
2016,11/27,GrandRapids,1.44,1329,62173,2035,34494,3626,37,Fall,35823,65799,2072,False
2016,11/20,GrandRapids,1.46,1165,82541,2576,39610,1472,25,Fall,40775,84013,2601,False
2016,11/13,GrandRapids,1.59,1340,62841,2934,50551,892,5,Fall,51891,63733,2939,False
2016,11/06,GrandRapids,1.67,1858,58869,2785,34753,1713,20,Fall,36611,60582,2805,False
2016,10/30,GrandRapids,1.42,1991,80587,2821,17160,4411,41,Fall,19151,84998,2862,False
2016,10/23,GrandRapids,1.72,1234,64735,3120,26017,5758,37,Fall,27251,70493,3157,False
2016,10/16,GrandRapids,1.63,1510,69625,3811,38573,4300,20,Fall,40083,73925,3831,False
2016,10/09,GrandRapids,1.62,1531,67528,3408,39395,4580,32,Fall,40926,72108,3440,False
2016,10/02,GrandRapids,1.6,1617,67660,4166,43757,4868,20,Fall,45374,72528,4186,False
2016,09/25,GrandRapids,1.55,2757,75047,4714,47569,7490,18,Fall,50326,82537,4732,False
2016,09/18,GrandRapids,1.49,1406,82346,4837,44436,6479,5,Fall,45842,88825,4842,False
2016,09/11,GrandRapids,1.58,1710,76987,6085,46524,5159,24,Fall,48234,82146,6109,False
2016,09/04,GrandRapids,1.52,2698,79726,8313,47210,4235,728,Fall,49908,83961,9041,False
2016,08/28,GrandRapids,1.45,2477,68530,10744,54347,4939,2009,Summer,56824,73469,12753,False
2016,08/21,GrandRapids,1.63,2041,66472,18506,39617,1742,4514,Summer,41658,68214,23020,False
2016,08/14,GrandRapids,1.53,1835,61893,23661,49618,3263,7438,Summer,51453,65156,31099,False
2016,08/07,GrandRapids,1.59,2219,72545,19401,42209,3446,5385,Summer,44428,75991,24786,False
2016,07/31,GrandRapids,1.6,2218,78075,12112,44479,3058,2356,Summer,46697,81133,14468,False
2016,07/24,GrandRapids,1.6,2349,66146,26206,40486,3842,9970,Summer,42835,69988,36176,False
2016,07/17,GrandRapids,1.58,2136,69205,24890,38583,3582,8332,Summer,40719,72787,33222,False
2016,07/10,GrandRapids,1.6,1971,70502,21317,25889,4005,10061,Summer,27860,74507,31378,False
2016,07/03,GrandRapids,1.49,2334,79978,20020,42381,4598,10253,Summer,44715,84576,30273,False
2016,06/26,GrandRapids,1.26,2370,104539,14725,49679,4816,7415,Summer,52049,109355,22140,False
2016,06/19,GrandRapids,1.26,3034,130169,18998,49222,4610,10264,Summer,52256,134779,29262,False
2016,06/12,GrandRapids,1.36,3254,93760,2234,62658,4765,1030,Summer,65912,98525,3264,False
2016,06/05,GrandRapids,0.93,1814,218134,6825,76847,6582,698,Summer,78661,224716,7523,False
2016,05/29,GrandRapids,1.32,2079,117665,2496,65724,5039,453,Spring,67803,122704,2949,False
2016,05/22,GrandRapids,1.31,1949,84537,4986,50741,7308,2318,Spring,52690,91845,7304,False
2016,05/15,GrandRapids,0.88,1673,211337,6471,67998,7823,402,Spring,69671,219160,6873,False
2016,05/08,GrandRapids,1.04,1949,201017,5353,56652,6645,439,Spring,58601,207662,5792,False
2016,05/01,GrandRapids,1.12,1858,131194,3002,49040,6737,70,Spring,50898,137931,3072,False
2016,04/24,GrandRapids,1.07,2001,113325,3088,55324,8087,30,Spring,57325,121412,3118,False
2016,04/17,GrandRapids,0.89,1877,256399,8605,58861,6229,217,Spring,60738,262628,8822,False
2016,04/10,GrandRapids,1.17,2129,95776,3412,47307,5850,667,Spring,49436,101626,4079,False
2016,04/03,GrandRapids,1.1,2410,97646,3234,47054,6427,110,Spring,49464,104073,3344,False
2016,03/27,GrandRapids,0.99,2298,146037,5101,53892,9316,141,Spring,56190,155353,5242,False
2016,03/20,GrandRapids,1.07,2126,140410,4357,55984,5768,65,Spring,58110,146178,4422,False
2016,03/13,GrandRapids,1.15,2180,91194,2607,43482,9621,32,Spring,45662,100815,2639,False
2016,03/06,GrandRapids,0.91,1974,191952,7752,54011,3633,243,Spring,55985,195585,7995,False
2016,02/28,GrandRapids,1.07,2248,141141,5163,49889,3808,103,Winter,52137,144949,5266,False
2016,02/21,GrandRapids,1.16,3581,93603,4067,36166,5150,112,Winter,39747,98753,4179,False
2016,02/14,GrandRapids,1.13,3573,98244,14048,28771,6755,3583,Winter,32344,104999,17631,False
2016,02/07,GrandRapids,0.94,3935,205006,43866,23628,2405,11711,Winter,27563,207411,55577,False
2016,01/31,GrandRapids,1.13,3588,126342,14941,29860,3444,4808,Winter,33448,129786,19749,False
2016,01/24,GrandRapids,0.94,2407,195585,16377,38643,2467,5117,Winter,41050,198052,21494,False
2016,01/17,GrandRapids,1.05,3810,106814,5407,52363,2469,1300,Winter,56173,109283,6707,False
2016,01/10,GrandRapids,1.17,3614,110381,3921,38446,3621,447,Winter,42060,114002,4368,False
2016,01/03,GrandRapids,0.92,3985,191590,12294,42961,2684,5372,Winter,46946,194274,17666,False
2016,12/25,HarrisburgScranton,1.45,28999,97383,1529,55674,2560,31,Winter,84673,99943,1560,False
2016,12/18,HarrisburgScranton,1.21,25826,133480,208,50217,1184,0,Winter,76043,134664,208,False
2016,12/11,HarrisburgScranton,1.26,27491,115422,112,57170,2403,0,Winter,84661,117825,112,False
2016,12/04,HarrisburgScranton,1.4,27161,93528,71,50780,800,73,Winter,77941,94328,144,False
2016,11/27,HarrisburgScranton,1.4,26022,81008,83,47430,740,0,Fall,73452,81748,83,False
2016,11/20,HarrisburgScranton,1.37,29191,91102,117,70656,687,0,Fall,99847,91789,117,False
2016,11/13,HarrisburgScranton,1.42,39007,92584,127,65222,972,6,Fall,104229,93556,133,False
2016,11/06,HarrisburgScranton,1.55,40523,82049,151,51326,756,30,Fall,91849,82805,181,False
2016,10/30,HarrisburgScranton,1.59,35332,78894,87,56958,378,0,Fall,92290,79272,87,False
2016,10/23,HarrisburgScranton,1.6,35724,99575,113,60146,186,62,Fall,95870,99761,175,False
2016,10/16,HarrisburgScranton,1.49,43579,95964,176,65296,711,0,Fall,108875,96675,176,False
2016,10/09,HarrisburgScranton,1.42,43010,111487,218,63388,985,0,Fall,106398,112472,218,False
2016,10/02,HarrisburgScranton,1.4,42262,106682,191,64688,902,0,Fall,106950,107584,191,False
2016,09/25,HarrisburgScranton,1.37,68045,89410,183,63530,771,77,Fall,131575,90181,260,False
2016,09/18,HarrisburgScranton,1.26,75557,73638,176,69128,2196,0,Fall,144685,75834,176,False
2016,09/11,HarrisburgScranton,1.19,108308,103071,124,59029,2061,16,Fall,167337,105132,140,False
2016,09/04,HarrisburgScranton,1.15,77540,112618,230,119477,1159,150,Fall,197017,113777,380,False
2016,08/28,HarrisburgScranton,1.32,45946,114244,1086,102788,2348,2963,Summer,148734,116592,4049,False
2016,08/21,HarrisburgScranton,1.28,41521,119685,101,85855,7905,3240,Summer,127376,127590,3341,False
2016,08/14,HarrisburgScranton,1.22,49712,114887,193,98315,6769,2220,Summer,148027,121656,2413,False
2016,08/07,HarrisburgScranton,1.24,56263,109039,538,96274,1282,3685,Summer,152537,110321,4223,False
2016,07/31,HarrisburgScranton,1.37,48175,110154,346,90147,591,4255,Summer,138322,110745,4601,False
2016,07/24,HarrisburgScranton,1.36,42713,103033,272,92482,553,8220,Summer,135195,103586,8492,False
2016,07/17,HarrisburgScranton,1.25,37155,99016,207,100384,1258,11095,Summer,137539,100274,11302,False
2016,07/10,HarrisburgScranton,1.21,43879,118215,436,102165,1667,8418,Summer,146044,119882,8854,False
2016,07/03,HarrisburgScranton,1.23,41551,129783,762,103961,867,10761,Summer,145512,130650,11523,False
2016,06/26,HarrisburgScranton,1.24,38571,141142,592,91756,984,4430,Summer,130327,142126,5022,False
2016,06/19,HarrisburgScranton,1.26,41124,132642,298,86477,1092,5600,Summer,127601,133734,5898,False
2016,06/12,HarrisburgScranton,1.24,43253,114426,124,85233,1541,5650,Summer,128486,115967,5774,False
2016,06/05,HarrisburgScranton,1.23,40843,134735,191,84588,5236,1630,Summer,125431,139971,1821,False
2016,05/29,HarrisburgScranton,1.13,44168,143022,136,79281,12975,430,Spring,123449,155997,566,False
2016,05/22,HarrisburgScranton,1.12,40865,124677,182,90017,775,1080,Spring,130882,125452,1262,False
2016,05/15,HarrisburgScranton,1.08,34543,159858,227,73289,2719,0,Spring,107832,162577,227,False
2016,05/08,HarrisburgScranton,0.91,47270,247409,357,77855,651,0,Spring,125125,248060,357,False
2016,05/01,HarrisburgScranton,0.99,52276,185445,362,76346,1979,0,Spring,128622,187424,362,False
2016,04/24,HarrisburgScranton,1.09,50495,157366,235,74325,1112,0,Spring,124820,158478,235,False
2016,04/17,HarrisburgScranton,1.05,42204,135971,137,76854,2575,0,Spring,119058,138546,137,False
2016,04/10,HarrisburgScranton,1.05,42096,116591,168,75903,2379,0,Spring,117999,118970,168,False
2016,04/03,HarrisburgScranton,1.13,36366,88833,90,59419,1962,0,Spring,95785,90795,90,False
2016,03/27,HarrisburgScranton,1.15,35550,135847,156,74484,1349,0,Spring,110034,137196,156,False
2016,03/20,HarrisburgScranton,1.08,35428,159452,270,72833,1472,0,Spring,108261,160924,270,False
2016,03/13,HarrisburgScranton,1.13,35473,148078,202,71738,1293,0,Spring,107211,149371,202,False
2016,03/06,HarrisburgScranton,1.17,40527,130174,211,68304,1631,0,Spring,108831,131805,211,False
2016,02/28,HarrisburgScranton,1.11,36910,157390,213,58909,1530,0,Winter,95819,158920,213,False
2016,02/21,HarrisburgScranton,1.15,33667,136616,158,62779,2217,0,Winter,96446,138833,158,False
2016,02/14,HarrisburgScranton,1.09,39983,155336,224,67077,2282,0,Winter,107060,157618,224,False
2016,02/07,HarrisburgScranton,1.1,42668,186545,334,78497,2120,0,Winter,121165,188665,334,False
2016,01/31,HarrisburgScranton,1.07,30150,141567,148,67727,1318,0,Winter,97877,142885,148,False
2016,01/24,HarrisburgScranton,1.13,30857,145118,187,92434,1261,0,Winter,123291,146379,187,False
2016,01/17,HarrisburgScranton,1.15,37242,127825,215,85284,1204,0,Winter,122526,129029,215,False
2016,01/10,HarrisburgScranton,1.14,38270,113995,142,77645,1205,0,Winter,115915,115200,142,False
2016,01/03,HarrisburgScranton,1.09,36241,157969,315,57475,691,0,Winter,93716,158660,315,False
2016,12/25,HartfordSpringfield,1.49,2977,178949,7914,47076,865,317,Winter,50053,179814,8231,False
2016,12/18,HartfordSpringfield,1.22,4769,256345,995,41573,224,142,Winter,46342,256569,1137,False
2016,12/11,HartfordSpringfield,1.42,3321,186954,2350,51964,839,290,Winter,55285,187793,2640,False
2016,12/04,HartfordSpringfield,1.54,3426,160247,591,42957,124,135,Winter,46383,160371,726,False
2016,11/27,HartfordSpringfield,1.57,4269,149413,119,41408,9,0,Fall,45677,149422,119,False
2016,11/20,HartfordSpringfield,1.62,4755,168091,122,66362,1324,0,Fall,71117,169415,122,False
2016,11/13,HartfordSpringfield,1.82,3119,129123,107,52391,187,0,Fall,55510,129310,107,False
2016,11/06,HartfordSpringfield,1.83,3070,119662,161,50160,565,0,Fall,53230,120227,161,False
2016,10/30,HartfordSpringfield,1.81,2704,130995,191,46140,79,0,Fall,48844,131074,191,False
2016,10/23,HartfordSpringfield,1.78,4201,152903,194,56074,104,69,Fall,60275,153007,263,False
2016,10/16,HartfordSpringfield,1.82,4396,148210,239,56021,98,0,Fall,60417,148308,239,False
2016,10/09,HartfordSpringfield,1.62,7855,171100,274,51617,39,175,Fall,59472,171139,449,False
2016,10/02,HartfordSpringfield,1.69,17695,145719,620,52592,190,0,Fall,70287,145909,620,False
2016,09/25,HartfordSpringfield,1.63,42274,125999,127,55353,628,10,Fall,97627,126627,137,False
2016,09/18,HartfordSpringfield,1.51,37691,130354,132,64310,1375,5,Fall,102001,131729,137,False
2016,09/11,HartfordSpringfield,1.22,84826,225724,197,52152,1137,15,Fall,136978,226861,212,False
2016,09/04,HartfordSpringfield,1.54,10730,199814,842,67173,733,334,Fall,77903,200547,1176,False
2016,08/28,HartfordSpringfield,1.59,3266,209240,277,72124,1646,1073,Summer,75390,210886,1350,False
2016,08/21,HartfordSpringfield,1.46,2617,191018,223,100062,4268,1355,Summer,102679,195286,1578,False
2016,08/14,HartfordSpringfield,1.46,6429,186844,655,100492,2318,1275,Summer,106921,189162,1930,False
2016,08/07,HartfordSpringfield,1.5,4285,183604,565,99391,119,190,Summer,103676,183723,755,False
2016,07/31,HartfordSpringfield,1.72,3820,170920,200,78539,340,1205,Summer,82359,171260,1405,False
2016,07/24,HartfordSpringfield,1.7,3244,165702,149,82571,738,2280,Summer,85815,166440,2429,False
2016,07/17,HartfordSpringfield,1.63,3078,173492,287,78534,347,3676,Summer,81612,173839,3963,False
2016,07/10,HartfordSpringfield,1.46,3434,192338,700,90776,1638,3723,Summer,94210,193976,4423,False
2016,07/03,HartfordSpringfield,1.47,3261,212724,1330,88150,547,3881,Summer,91411,213271,5211,False
2016,06/26,HartfordSpringfield,1.41,3520,245341,263,77811,318,2365,Summer,81331,245659,2628,False
2016,06/19,HartfordSpringfield,1.5,4764,253641,308,73922,882,2185,Summer,78686,254523,2493,False
2016,06/12,HartfordSpringfield,1.47,7760,242441,318,71188,584,2670,Summer,78948,243025,2988,False
2016,06/05,HartfordSpringfield,1.46,4757,219463,245,75889,577,2185,Summer,80646,220040,2430,False
2016,05/29,HartfordSpringfield,1.15,5717,310084,433,63033,1485,1690,Spring,68750,311569,2123,False
2016,05/22,HartfordSpringfield,1.26,3701,224262,521,66397,940,1070,Spring,70098,225202,1591,False
2016,05/15,HartfordSpringfield,1.24,5224,353742,778,55425,1053,40,Spring,60649,354795,818,False
2016,05/08,HartfordSpringfield,0.86,6157,449501,436,64704,1765,0,Spring,70861,451266,436,False
2016,05/01,HartfordSpringfield,1.18,4163,286951,246,59813,2064,0,Spring,63976,289015,246,False
2016,04/24,HartfordSpringfield,1.25,4251,277215,684,59633,982,28,Spring,63884,278197,712,False
2016,04/17,HartfordSpringfield,1.18,3817,212803,95,66917,802,43,Spring,70734,213605,138,False
2016,04/10,HartfordSpringfield,1.17,4510,213983,172,61560,283,220,Spring,66070,214266,392,False
2016,04/03,HartfordSpringfield,1.36,4183,204807,449,44065,566,128,Spring,48248,205373,577,False
2016,03/27,HartfordSpringfield,1.31,3703,234448,196,55053,1199,0,Spring,58756,235647,196,False
2016,03/20,HartfordSpringfield,1.17,5155,315607,278,51367,963,0,Spring,56522,316570,278,False
2016,03/13,HartfordSpringfield,1.3,4317,253676,179,56230,990,0,Spring,60547,254666,179,False
2016,03/06,HartfordSpringfield,1.27,4867,241128,295,64019,1189,3,Spring,68886,242317,298,False
2016,02/28,HartfordSpringfield,1.17,5558,305866,232,43903,1941,0,Winter,49461,307807,232,False
2016,02/21,HartfordSpringfield,1.28,4492,214537,279,66444,2422,0,Winter,70936,216959,279,False
2016,02/14,HartfordSpringfield,1.1,6064,326486,316,61273,4299,0,Winter,67337,330785,316,False
2016,02/07,HartfordSpringfield,1.16,4834,306373,530,78438,3684,3,Winter,83272,310057,533,False
2016,01/31,HartfordSpringfield,1.12,5276,322397,255,59996,2208,0,Winter,65272,324605,255,False
2016,01/24,HartfordSpringfield,1.27,2330,234916,304,75964,4411,5,Winter,78294,239327,309,False
2016,01/17,HartfordSpringfield,1.18,4186,265631,222,81352,1079,0,Winter,85538,266710,222,False
2016,01/10,HartfordSpringfield,1.26,3361,213814,238,64792,1911,0,Winter,68153,215725,238,False
2016,01/03,HartfordSpringfield,1.07,4199,275680,297,41477,1096,0,Winter,45676,276776,297,False
2016,12/25,Houston,0.72,571303,238201,3257,144114,169972,0,Winter,715417,408173,3257,False
2016,12/18,Houston,0.63,576578,258779,2885,155393,219296,0,Winter,731971,478075,2885,False
2016,12/11,Houston,0.73,413907,275659,3480,70239,252687,0,Winter,484146,528346,3480,False
2016,12/04,Houston,0.71,592360,274633,4508,64285,195107,0,Winter,656645,469740,4508,False
2016,11/27,Houston,0.82,525324,173401,3567,81852,70483,0,Fall,607176,243884,3567,False
2016,11/20,Houston,0.99,466960,202860,4070,58525,94915,13,Fall,525485,297775,4083,False
2016,11/13,Houston,1.05,431731,231630,4850,61276,99274,102,Fall,493007,330904,4952,False
2016,11/06,Houston,1.12,430098,168814,2921,78827,102248,0,Fall,508925,271062,2921,False
2016,10/30,Houston,1.15,346283,181578,3192,47722,131112,0,Fall,394005,312690,3192,False
2016,10/23,Houston,1.0,371566,145059,2488,197398,61335,0,Fall,568964,206394,2488,False
2016,10/16,Houston,0.98,492462,223737,3348,132407,141036,0,Fall,624869,364773,3348,False
2016,10/09,Houston,0.98,483285,344448,9670,121027,116836,34,Fall,604312,461284,9704,False
2016,10/02,Houston,0.98,446276,260176,3196,129091,184288,0,Fall,575367,444464,3196,False
2016,09/25,Houston,0.96,463607,266059,2894,101363,193857,0,Fall,564970,459916,2894,False
2016,09/18,Houston,0.83,702367,203949,3023,126297,91451,20,Fall,828664,295400,3043,False
2016,09/11,Houston,0.76,729949,188318,2466,216413,79968,230,Fall,946362,268286,2696,False
2016,09/04,Houston,0.72,782982,265697,3439,208800,88824,1905,Fall,991782,354521,5344,False
2016,08/28,Houston,0.88,610762,216733,3065,124173,58652,8220,Summer,734935,275385,11285,False
2016,08/21,Houston,0.9,583161,248160,5697,132615,76539,333,Summer,715776,324699,6030,False
2016,08/14,Houston,0.9,590138,218435,3815,123193,79430,250,Summer,713331,297865,4065,False
2016,08/07,Houston,0.92,614770,239657,5032,121223,60268,0,Summer,735993,299925,5032,False
2016,07/31,Houston,0.98,547468,203888,4165,117560,64239,3743,Summer,665028,268127,7908,False
2016,07/24,Houston,0.96,555709,218179,5208,163969,39623,2337,Summer,719678,257802,7545,False
2016,07/17,Houston,0.92,551921,219856,8567,189089,37549,0,Summer,741010,257405,8567,False
2016,07/10,Houston,0.89,607069,208421,41628,201545,39452,3425,Summer,808614,247873,45053,False
2016,07/03,Houston,0.92,545799,245931,139911,201099,39117,17928,Summer,746898,285048,157839,False
2016,06/26,Houston,0.88,586635,216133,113474,165598,86483,18366,Summer,752233,302616,131840,False
2016,06/19,Houston,0.89,627217,228843,74763,139198,70961,12600,Summer,766415,299804,87363,False
2016,06/12,Houston,0.83,589477,236621,110054,114672,149147,10023,Summer,704149,385768,120077,False
2016,06/05,Houston,0.85,555561,242491,110457,92784,170943,10603,Summer,648345,413434,121060,False
2016,05/29,Houston,0.82,554092,247279,116263,91661,110662,8640,Spring,645753,357941,124903,False
2016,05/22,Houston,0.68,569011,339100,169713,125723,165911,9301,Spring,694734,505011,179014,False
2016,05/15,Houston,0.69,614769,335853,95672,102106,192425,2739,Spring,716875,528278,98411,False
2016,05/08,Houston,0.65,670565,293098,185667,107635,146298,3018,Spring,778200,439396,188685,False
2016,05/01,Houston,0.68,601670,368703,89821,84090,159461,4866,Spring,685760,528164,94687,False
2016,04/24,Houston,0.67,656322,324423,163347,100132,144364,4451,Spring,756454,468787,167798,False
2016,04/17,Houston,0.69,782313,191432,153134,119863,57278,6655,Spring,902176,248710,159789,False
2016,04/10,Houston,0.7,757578,188936,151966,117792,50449,5018,Spring,875370,239385,156984,False
2016,04/03,Houston,0.72,684633,264272,181951,56499,66016,3546,Spring,741132,330288,185497,False
2016,03/27,Houston,0.75,553962,406713,177919,75819,124377,7073,Spring,629781,531090,184992,False
2016,03/20,Houston,0.76,538380,327365,121838,62893,103044,8503,Spring,601273,430409,130341,False
2016,03/13,Houston,0.76,585649,247461,185545,63280,48440,6586,Spring,648929,295901,192131,False
2016,03/06,Houston,0.76,698789,182050,86477,77568,39418,7126,Spring,776357,221468,93603,False
2016,02/28,Houston,0.76,674833,180298,85511,77330,24043,6286,Winter,752163,204341,91797,False
2016,02/21,Houston,0.8,566062,200934,90645,64626,38634,6086,Winter,630688,239568,96731,False
2016,02/14,Houston,0.67,518192,334137,210029,67726,55041,6225,Winter,585918,389178,216254,False
2016,02/07,Houston,0.69,528669,424427,203797,71538,75749,19306,Winter,600207,500176,223103,False
2016,01/31,Houston,0.74,484446,348542,161506,68193,46086,22807,Winter,552639,394628,184313,False
2016,01/24,Houston,0.91,259465,363892,79193,83636,63963,17144,Winter,343101,427855,96337,False
2016,01/17,Houston,0.83,447913,369479,116440,82818,50110,4376,Winter,530731,419589,120816,False
2016,01/10,Houston,0.84,434471,437751,85368,78471,58067,1156,Winter,512942,495818,86524,False
2016,01/03,Houston,0.78,356962,454200,113069,87330,49677,326,Winter,444292,503877,113395,False
2016,12/25,Indianapolis,1.13,9560,59100,1962,39632,25547,44,Winter,49192,84647,2006,False
2016,12/18,Indianapolis,1.19,9114,56820,1973,33414,20669,43,Winter,42528,77489,2016,False
2016,12/11,Indianapolis,1.17,10029,61398,2771,38874,20249,156,Winter,48903,81647,2927,False
2016,12/04,Indianapolis,1.18,9441,70441,5143,34658,24180,867,Winter,44099,94621,6010,False
2016,11/27,Indianapolis,1.34,8422,43655,1231,26198,24221,0,Fall,34620,67876,1231,False
2016,11/20,Indianapolis,1.29,9062,52842,1517,28999,32251,0,Fall,38061,85093,1517,False
2016,11/13,Indianapolis,1.29,8852,56481,1724,31532,28946,41,Fall,40384,85427,1765,False
2016,11/06,Indianapolis,1.37,9100,55557,1578,30459,29180,329,Fall,39559,84737,1907,False
2016,10/30,Indianapolis,1.2,9278,61450,1682,26068,41094,0,Fall,35346,102544,1682,False
2016,10/23,Indianapolis,1.31,7986,65584,2219,28373,38779,1,Fall,36359,104363,2220,False
2016,10/16,Indianapolis,1.27,10968,60049,1952,35703,30247,0,Fall,46671,90296,1952,False
2016,10/09,Indianapolis,1.2,11357,61269,2173,36546,32111,452,Fall,47903,93380,2625,False
2016,10/02,Indianapolis,1.31,14488,66598,2091,36081,27445,3,Fall,50569,94043,2094,False
2016,09/25,Indianapolis,1.39,16855,68404,2557,37497,25490,0,Fall,54352,93894,2557,False
2016,09/18,Indianapolis,1.26,16666,67688,2707,40788,25360,0,Fall,57454,93048,2707,False
2016,09/11,Indianapolis,1.29,17414,70736,3134,44187,21859,0,Fall,61601,92595,3134,False
2016,09/04,Indianapolis,1.31,17530,75640,3252,47772,16371,105,Fall,65302,92011,3357,False
2016,08/28,Indianapolis,1.27,13732,78138,2802,49838,21877,1013,Summer,63570,100015,3815,False
2016,08/21,Indianapolis,1.3,15022,73966,3405,44089,24244,240,Summer,59111,98210,3645,False
2016,08/14,Indianapolis,1.27,15863,79507,4255,39950,28559,1285,Summer,55813,108066,5540,False
2016,08/07,Indianapolis,1.33,20926,77899,5741,36453,21522,795,Summer,57379,99421,6536,False
2016,07/31,Indianapolis,1.27,16079,80211,6277,34005,22328,671,Summer,50084,102539,6948,False
2016,07/24,Indianapolis,1.2,14627,82110,9886,37248,29877,4640,Summer,51875,111987,14526,False
2016,07/17,Indianapolis,1.08,15914,93315,9427,39495,32642,4914,Summer,55409,125957,14341,False
2016,07/10,Indianapolis,1.12,15126,96588,9530,39858,25082,5599,Summer,54984,121670,15129,False
2016,07/03,Indianapolis,1.1,15757,97347,9152,47612,29634,6058,Summer,63369,126981,15210,False
2016,06/26,Indianapolis,1.15,14452,90386,15029,41778,16248,5659,Summer,56230,106634,20688,False
2016,06/19,Indianapolis,1.13,17469,91178,19044,34458,25319,6063,Summer,51927,116497,25107,False
2016,06/12,Indianapolis,1.12,19442,89225,19115,39160,13630,6148,Summer,58602,102855,25263,False
2016,06/05,Indianapolis,1.05,16444,100386,21893,39935,23087,6339,Summer,56379,123473,28232,False
2016,05/29,Indianapolis,1.01,13152,109784,12495,47279,24844,2830,Spring,60431,134628,15325,False
2016,05/22,Indianapolis,0.87,10857,105336,17819,46352,29562,4917,Spring,57209,134898,22736,False
2016,05/15,Indianapolis,0.88,11249,98565,23505,46726,27196,5564,Spring,57975,125761,29069,False
2016,05/08,Indianapolis,0.93,17356,106300,18838,54973,27766,3365,Spring,72329,134066,22203,False
2016,05/01,Indianapolis,0.92,16727,106590,12071,43567,26781,1749,Spring,60294,133371,13820,False
2016,04/24,Indianapolis,0.95,12802,116190,22243,32258,30147,4092,Spring,45060,146337,26335,False
2016,04/17,Indianapolis,0.97,15361,113832,24253,27683,33415,3691,Spring,43044,147247,27944,False
2016,04/10,Indianapolis,1.07,15421,84833,11125,29065,26374,1188,Spring,44486,111207,12313,False
2016,04/03,Indianapolis,0.99,13073,73683,14509,23047,26829,2955,Spring,36120,100512,17464,False
2016,03/27,Indianapolis,0.99,10457,103261,23242,26546,27197,4667,Spring,37003,130458,27909,False
2016,03/20,Indianapolis,1.12,12095,91015,16824,27044,18685,3221,Spring,39139,109700,20045,False
2016,03/13,Indianapolis,1.03,11923,97729,17713,28612,19278,3809,Spring,40535,117007,21522,False
2016,03/06,Indianapolis,0.96,11773,116609,24630,26420,23929,4920,Spring,38193,140538,29550,False
2016,02/28,Indianapolis,0.99,11031,107091,16742,26221,23948,3042,Winter,37252,131039,19784,False
2016,02/21,Indianapolis,1.03,10806,91309,8892,23611,17284,1594,Winter,34417,108593,10486,False
2016,02/14,Indianapolis,0.83,13525,133956,15621,27240,27220,2307,Winter,40765,161176,17928,False
2016,02/07,Indianapolis,0.88,13926,145591,27708,24152,25269,3588,Winter,38078,170860,31296,False
2016,01/31,Indianapolis,0.98,8329,102864,22380,20098,17062,4874,Winter,28427,119926,27254,False
2016,01/24,Indianapolis,0.93,1803,93613,23023,23374,21450,4769,Winter,25177,115063,27792,False
2016,01/17,Indianapolis,0.97,5231,105606,12443,26459,19618,2046,Winter,31690,125224,14489,False
2016,01/10,Indianapolis,1.0,4590,101117,18454,25431,20246,3397,Winter,30021,121363,21851,False
2016,01/03,Indianapolis,0.95,5974,109973,25839,15993,19313,7575,Winter,21967,129286,33414,False
2016,12/25,Jacksonville,0.81,70779,31213,208,30893,54708,0,Winter,101672,85921,208,False
2016,12/18,Jacksonville,0.84,49886,27329,104,26270,58844,68,Winter,76156,86173,172,False
2016,12/11,Jacksonville,1.17,33585,18098,126,27971,36270,0,Winter,61556,54368,126,False
2016,12/04,Jacksonville,0.89,63726,35344,132,33108,73697,0,Winter,96834,109041,132,False
2016,11/27,Jacksonville,1.36,32944,18661,94,19808,40162,0,Fall,52752,58823,94,False
2016,11/20,Jacksonville,1.36,35506,19385,192,22359,40052,0,Fall,57865,59437,192,False
2016,11/13,Jacksonville,1.31,51958,22430,212,26430,39670,0,Fall,78388,62100,212,False
2016,11/06,Jacksonville,1.41,43990,21710,289,16137,45767,0,Fall,60127,67477,289,False
2016,10/30,Jacksonville,1.41,38168,20158,206,13461,43127,0,Fall,51629,63285,206,False
2016,10/23,Jacksonville,1.35,42784,22755,212,11698,42388,0,Fall,54482,65143,212,False
2016,10/16,Jacksonville,1.12,48624,36096,228,11681,60621,77,Fall,60305,96717,305,False
2016,10/09,Jacksonville,1.31,43060,35355,143,16656,40303,0,Fall,59716,75658,143,False
2016,10/02,Jacksonville,1.31,54429,29513,93,23304,52235,0,Fall,77733,81748,93,False
2016,09/25,Jacksonville,1.26,58289,21092,145,29683,48982,0,Fall,87972,70074,145,False
2016,09/18,Jacksonville,1.05,72171,27540,84,23455,52677,0,Fall,95626,80217,84,False
2016,09/11,Jacksonville,1.1,70095,23109,148,22375,34565,0,Fall,92470,57674,148,False
2016,09/04,Jacksonville,0.94,128269,34369,158,29049,47399,0,Fall,157318,81768,158,False
2016,08/28,Jacksonville,1.14,90634,32154,113,29304,24543,550,Summer,119938,56697,663,False
2016,08/21,Jacksonville,1.11,90679,36441,188,34193,26027,2170,Summer,124872,62468,2358,False
2016,08/14,Jacksonville,1.11,98779,43133,217,22538,39347,2600,Summer,121317,82480,2817,False
2016,08/07,Jacksonville,1.23,70054,30914,331,21944,24593,3915,Summer,91998,55507,4246,False
2016,07/31,Jacksonville,1.23,67403,31854,440,25243,23054,4781,Summer,92646,54908,5221,False
2016,07/24,Jacksonville,1.21,69899,39377,493,21263,21141,4141,Summer,91162,60518,4634,False
2016,07/17,Jacksonville,1.22,77112,34464,413,25220,23917,4324,Summer,102332,58381,4737,False
2016,07/10,Jacksonville,1.19,78117,34028,680,26529,19443,5881,Summer,104646,53471,6561,False
2016,07/03,Jacksonville,0.93,137102,48698,1134,37396,41823,5995,Summer,174498,90521,7129,False
2016,06/26,Jacksonville,1.19,75055,31811,748,24644,23012,3855,Summer,99699,54823,4603,False
2016,06/19,Jacksonville,0.94,115507,41557,1508,23712,39989,4500,Summer,139219,81546,6008,False
2016,06/12,Jacksonville,1.2,75763,28484,982,20061,22605,3530,Summer,95824,51089,4512,False
2016,06/05,Jacksonville,0.95,124676,32124,784,19483,40946,3129,Summer,144159,73070,3913,False
2016,05/29,Jacksonville,0.92,141300,36410,981,22104,40394,976,Spring,163404,76804,1957,False
2016,05/22,Jacksonville,1.17,83011,27437,356,20619,27239,1986,Spring,103630,54676,2342,False
2016,05/15,Jacksonville,0.79,98256,59901,275,19409,77620,1906,Spring,117665,137521,2181,False
2016,05/08,Jacksonville,0.8,113354,34526,280,30053,46304,0,Spring,143407,80830,280,False
2016,05/01,Jacksonville,0.68,169412,70592,248,37625,92767,0,Spring,207037,163359,248,False
2016,04/24,Jacksonville,0.8,104786,61113,134,21102,79512,576,Spring,125888,140625,710,False
2016,04/17,Jacksonville,1.0,88552,31279,185,23218,41247,344,Spring,111770,72526,529,False
2016,04/10,Jacksonville,0.8,106314,54201,196,19744,79967,656,Spring,126058,134168,852,False
2016,04/03,Jacksonville,1.01,84765,27201,149,27121,42424,0,Spring,111886,69625,149,False
2016,03/27,Jacksonville,1.06,70255,27911,402,19304,40449,0,Spring,89559,68360,402,False
2016,03/20,Jacksonville,1.07,59970,26015,269,19113,34933,0,Spring,79083,60948,269,False
2016,03/13,Jacksonville,0.81,103139,47856,316,18010,72329,0,Spring,121149,120185,316,False
2016,03/06,Jacksonville,1.06,71185,26487,503,17429,40049,0,Spring,88614,66536,503,False
2016,02/28,Jacksonville,0.77,108080,43494,217,23364,78332,0,Winter,131444,121826,217,False
2016,02/21,Jacksonville,1.01,63676,22329,211,18439,36679,0,Winter,82115,59008,211,False
2016,02/14,Jacksonville,0.95,74835,23877,377,20566,32067,0,Winter,95401,55944,377,False
2016,02/07,Jacksonville,0.54,191441,57532,594,53302,66879,8,Winter,244743,124411,602,False
2016,01/31,Jacksonville,1.04,76816,21968,256,21691,30513,0,Winter,98507,52481,256,False
2016,01/24,Jacksonville,0.93,116713,18557,473,27533,28916,0,Winter,144246,47473,473,False
2016,01/17,Jacksonville,1.21,73496,9811,302,21732,12888,0,Winter,95228,22699,302,False
2016,01/10,Jacksonville,0.95,122360,10625,273,20677,27648,0,Winter,143037,38273,273,False
2016,01/03,Jacksonville,1.09,103296,8714,487,20713,15387,0,Winter,124009,24101,487,False
2016,12/25,LasVegas,0.82,107317,43301,7606,54017,79794,0,Winter,161334,123095,7606,False
2016,12/18,LasVegas,0.81,88443,49295,7072,58263,94430,0,Winter,146706,143725,7072,False
2016,12/11,LasVegas,0.83,83682,55352,6832,68316,125144,0,Winter,151998,180496,6832,False
2016,12/04,LasVegas,0.91,93963,56502,5327,49383,109472,398,Winter,143346,165974,5725,False
2016,11/27,LasVegas,0.86,104641,41992,4857,44172,59992,0,Fall,148813,101984,4857,False
2016,11/20,LasVegas,1.12,94282,29776,5608,54759,52714,0,Fall,149041,82490,5608,False
2016,11/13,LasVegas,1.1,114475,32698,6683,51797,53891,0,Fall,166272,86589,6683,False
2016,11/06,LasVegas,1.2,84137,29997,8196,52182,50534,252,Fall,136319,80531,8448,False
2016,10/30,LasVegas,1.16,79018,31778,7157,42630,62503,0,Fall,121648,94281,7157,False
2016,10/23,LasVegas,1.13,67268,48015,8491,47831,83393,0,Fall,115099,131408,8491,False
2016,10/16,LasVegas,1.08,88625,51473,5356,74347,95941,0,Fall,162972,147414,5356,False
2016,10/09,LasVegas,1.16,121482,40083,5060,66103,43300,0,Fall,187585,83383,5060,False
2016,10/02,LasVegas,1.22,93430,45096,5876,58716,43393,0,Fall,152146,88489,5876,False
2016,09/25,LasVegas,1.2,98373,44921,5906,51564,41533,0,Fall,149937,86454,5906,False
2016,09/18,LasVegas,1.12,117939,57221,5318,38957,59042,0,Fall,156896,116263,5318,False
2016,09/11,LasVegas,0.89,200297,70912,5572,46478,55604,0,Fall,246775,126516,5572,False
2016,09/04,LasVegas,1.03,158224,69349,5841,44439,57325,0,Fall,202663,126674,5841,False
2016,08/28,LasVegas,1.03,123739,56927,6192,55035,46529,0,Summer,178774,103456,6192,False
2016,08/21,LasVegas,1.0,141809,50486,5836,60675,43900,0,Summer,202484,94386,5836,False
2016,08/14,LasVegas,1.08,129727,53954,6997,63416,41439,0,Summer,193143,95393,6997,False
2016,08/07,LasVegas,1.11,144862,57549,7063,64258,37604,194,Summer,209120,95153,7257,False
2016,07/31,LasVegas,1.17,125462,54745,7320,59985,37052,0,Summer,185447,91797,7320,False
2016,07/24,LasVegas,1.15,110868,58714,7525,66233,40005,516,Summer,177101,98719,8041,False
2016,07/17,LasVegas,1.08,118910,52023,7495,71629,31540,1473,Summer,190539,83563,8968,False
2016,07/10,LasVegas,1.0,153905,69545,7716,78101,47342,1175,Summer,232006,116887,8891,False
2016,07/03,LasVegas,1.0,135214,82726,9480,88177,46537,0,Summer,223391,129263,9480,False
2016,06/26,LasVegas,0.94,130217,74316,12079,88463,47330,0,Summer,218680,121646,12079,False
2016,06/19,LasVegas,0.91,164910,76172,11019,64076,47966,109,Summer,228986,124138,11128,False
2016,06/12,LasVegas,0.94,146589,75379,18141,62277,45519,115,Summer,208866,120898,18256,False
2016,06/05,LasVegas,0.89,156235,109763,13189,55548,76033,0,Summer,211783,185796,13189,False
2016,05/29,LasVegas,0.89,131708,115790,11869,46240,86165,219,Spring,177948,201955,12088,False
2016,05/22,LasVegas,0.93,122331,89286,15173,37169,54951,0,Spring,159500,144237,15173,False
2016,05/15,LasVegas,0.86,131370,107124,1468,41031,36627,0,Spring,172401,143751,1468,False
2016,05/08,LasVegas,0.83,170359,144990,8687,46595,56942,0,Spring,216954,201932,8687,False
2016,05/01,LasVegas,0.85,122124,115747,8420,65345,51258,208,Spring,187469,167005,8628,False
2016,04/24,LasVegas,0.83,125412,120811,8101,45051,60495,0,Spring,170463,181306,8101,False
2016,04/17,LasVegas,0.81,143900,110596,6531,44934,73501,0,Spring,188834,184097,6531,False
2016,04/10,LasVegas,0.87,151862,91833,6305,48046,56050,0,Spring,199908,147883,6305,False
2016,04/03,LasVegas,0.84,158984,62625,6877,47115,23108,0,Spring,206099,85733,6877,False
2016,03/27,LasVegas,0.85,155872,72324,7121,41425,37523,0,Spring,197297,109847,7121,False
2016,03/20,LasVegas,0.82,127949,116701,13632,36410,37589,0,Spring,164359,154290,13632,False
2016,03/13,LasVegas,0.79,130879,109512,6824,41534,55862,0,Spring,172413,165374,6824,False
2016,03/06,LasVegas,0.91,139919,86200,6809,51367,27106,0,Spring,191286,113306,6809,False
2016,02/28,LasVegas,0.86,122523,98920,14452,43897,36769,0,Winter,166420,135689,14452,False
2016,02/21,LasVegas,0.83,121214,124295,6447,40526,44918,0,Winter,161740,169213,6447,False
2016,02/14,LasVegas,0.79,144507,110749,7330,47967,60912,0,Winter,192474,171661,7330,False
2016,02/07,LasVegas,0.74,191144,142489,10624,51889,41598,0,Winter,243033,184087,10624,False
2016,01/31,LasVegas,0.92,117236,87109,14509,48986,17209,0,Winter,166222,104318,14509,False
2016,01/24,LasVegas,1.08,9727,81835,6141,44326,16948,0,Winter,54053,98783,6141,False
2016,01/17,LasVegas,0.88,108072,98543,12497,42600,27584,0,Winter,150672,126127,12497,False
2016,01/10,LasVegas,0.83,118958,110549,6133,40601,32973,0,Winter,159559,143522,6133,False
2016,01/03,LasVegas,0.8,103710,138142,15505,36619,38993,0,Winter,140329,177135,15505,False
2016,12/25,LosAngeles,0.84,794840,669585,65359,1032762,49937,29290,Winter,1827602,719522,94649,False
2016,12/18,LosAngeles,0.84,767981,513487,56245,961115,55112,23857,Winter,1729096,568599,80102,False
2016,12/11,LosAngeles,0.75,917098,631013,59599,1086150,80411,19643,Winter,2003248,711424,79242,False
2016,12/04,LosAngeles,0.78,1076282,476162,53729,1135570,17964,20918,Winter,2211852,494126,74647,False
2016,11/27,LosAngeles,1.01,865743,416437,50949,868269,34138,21732,Fall,1734012,450575,72681,False
2016,11/20,LosAngeles,1.1,880344,456709,60511,808238,43041,23178,Fall,1688582,499750,83689,False
2016,11/13,LosAngeles,1.29,696410,436388,71033,639521,44270,25867,Fall,1335931,480658,96900,False
2016,11/06,LosAngeles,1.52,543331,423351,77064,497726,26542,26995,Fall,1041057,449893,104059,False
2016,10/30,LosAngeles,1.48,533137,383974,59596,487013,16418,19146,Fall,1020150,400392,78742,False
2016,10/23,LosAngeles,1.23,768315,427296,44807,840269,32386,20487,Fall,1608584,459682,65294,False
2016,10/16,LosAngeles,1.17,922290,501532,56116,996105,43825,28817,Fall,1918395,545357,84933,False
2016,10/09,LosAngeles,1.16,1153907,559077,61747,915276,51156,25365,Fall,2069183,610233,87112,False
2016,10/02,LosAngeles,1.06,1337602,471344,62565,931963,40145,22123,Fall,2269565,511489,84688,False
2016,09/25,LosAngeles,1.0,1328968,468792,62737,1087085,34496,24991,Fall,2416053,503288,87728,False
2016,09/18,LosAngeles,1.06,999948,457932,55346,1008961,36400,30720,Fall,2008909,494332,86066,False
2016,09/11,LosAngeles,0.95,1217417,534763,49050,1065540,46332,26600,Fall,2282957,581095,75650,False
2016,09/04,LosAngeles,0.88,1409249,626922,43844,1295162,32720,23777,Fall,2704411,659642,67621,False
2016,08/28,LosAngeles,0.81,1471105,537892,57212,1436818,32450,27789,Summer,2907923,570342,85001,False
2016,08/21,LosAngeles,0.93,1264167,480926,57962,1204789,43207,35113,Summer,2468956,524133,93075,False
2016,08/14,LosAngeles,1.03,1050808,605409,73825,1066852,53237,29085,Summer,2117660,658646,102910,False
2016,08/07,LosAngeles,1.0,1137248,632756,67934,1158711,63574,34136,Summer,2295959,696330,102070,False
2016,07/31,LosAngeles,1.06,961494,562612,70783,1135205,64811,31927,Summer,2096699,627423,102710,False
2016,07/24,LosAngeles,1.01,1163035,629930,83979,1073915,60000,22467,Summer,2236950,689930,106446,False
2016,07/17,LosAngeles,0.97,1201992,630743,84008,1079717,73173,22599,Summer,2281709,703916,106607,False
2016,07/10,LosAngeles,0.93,1217453,678995,81637,1201242,85231,28664,Summer,2418695,764226,110301,False
2016,07/03,LosAngeles,0.95,1317678,746045,107625,1147086,96717,34207,Summer,2464764,842762,141832,False
2016,06/26,LosAngeles,0.85,1295216,655947,105879,1091515,84463,25161,Summer,2386731,740410,131040,False
2016,06/19,LosAngeles,0.9,1322109,593238,114307,1102265,80776,25149,Summer,2424374,674014,139456,False
2016,06/12,LosAngeles,0.83,1439519,529969,105646,1064384,84760,24489,Summer,2503903,614729,130135,False
2016,06/05,LosAngeles,0.76,1596545,650812,121002,1196472,124721,25903,Summer,2793017,775533,146905,False
2016,05/29,LosAngeles,0.83,1214455,691108,113180,1038686,119446,27057,Spring,2253141,810554,140237,False
2016,05/22,LosAngeles,0.76,1084784,782144,89228,1068850,87973,21324,Spring,2153634,870117,110552,False
2016,05/15,LosAngeles,0.82,1134719,643464,95527,871562,104146,17435,Spring,2006281,747610,112962,False
2016,05/08,LosAngeles,0.64,1416928,929683,107683,1104179,362931,20647,Spring,2521107,1292614,128330,False
2016,05/01,LosAngeles,0.62,1355793,1047924,98634,1011875,334016,15070,Spring,2367668,1381940,113704,False
2016,04/24,LosAngeles,0.75,1115902,704492,102738,1010395,185289,18064,Spring,2126297,889781,120802,False
2016,04/17,LosAngeles,0.76,1245344,643220,100883,1114858,61746,19176,Spring,2360202,704966,120059,False
2016,04/10,LosAngeles,0.77,1130642,715739,95958,1196713,132341,16961,Spring,2327355,848080,112919,False
2016,04/03,LosAngeles,0.82,865503,683860,101584,980989,145602,16441,Spring,1846492,829462,118025,False
2016,03/27,LosAngeles,0.73,982736,836002,94366,1349458,185190,20008,Spring,2332194,1021192,114374,False
2016,03/20,LosAngeles,0.74,928106,901464,91298,1301235,134711,18060,Spring,2229341,1036175,109358,False
2016,03/13,LosAngeles,0.79,767298,657175,96884,1318493,129444,18097,Spring,2085791,786619,114981,False
2016,03/06,LosAngeles,0.76,821036,680884,90068,1369895,155333,21619,Spring,2190931,836217,111687,False
2016,02/28,LosAngeles,0.72,812808,750266,95505,1459896,196813,17288,Winter,2272704,947079,112793,False
2016,02/21,LosAngeles,0.76,842358,671213,83794,1501295,119573,14654,Winter,2343653,790786,98448,False
2016,02/14,LosAngeles,0.65,931605,837742,90043,1567442,222150,15105,Winter,2499047,1059892,105148,False
2016,02/07,LosAngeles,0.58,1262681,1447533,98684,1911608,245385,16806,Winter,3174289,1692918,115490,False
2016,01/31,LosAngeles,0.74,1004134,721988,75111,1288253,94240,14059,Winter,2292387,816228,89170,False
2016,01/24,LosAngeles,0.76,666019,779056,92941,1520603,99946,14941,Winter,2186622,879002,107882,False
2016,01/17,LosAngeles,0.76,804573,854485,84389,1079975,111405,17747,Winter,1884548,965890,102136,False
2016,01/10,LosAngeles,0.74,841326,803197,88909,1228427,194492,16084,Winter,2069753,997689,104993,False
2016,01/03,LosAngeles,0.64,1232109,992212,90511,1415836,226121,10317,Winter,2647945,1218333,100828,False
2016,12/25,Louisville,1.01,1337,35234,179,16333,28748,0,Winter,17670,63982,179,False
2016,12/18,Louisville,1.1,1247,33646,433,13133,19258,0,Winter,14380,52904,433,False
2016,12/11,Louisville,0.79,1367,44377,142,11915,47411,12,Winter,13282,91788,154,False
2016,12/04,Louisville,0.83,1234,60677,664,11670,52954,0,Winter,12904,113631,664,False
2016,11/27,Louisville,1.26,1047,26662,141,10325,19588,0,Fall,11372,46250,141,False
2016,11/20,Louisville,1.43,1429,29056,159,11694,16870,0,Fall,13123,45926,159,False
2016,11/13,Louisville,1.34,1469,30443,215,11501,21328,0,Fall,12970,51771,215,False
2016,11/06,Louisville,1.27,1606,34663,236,9517,24857,0,Fall,11123,59520,236,False
2016,10/30,Louisville,1.28,1769,35446,162,7816,24943,0,Fall,9585,60389,162,False
2016,10/23,Louisville,1.23,1616,37427,314,10839,25395,0,Fall,12455,62822,314,False
2016,10/16,Louisville,1.1,1538,37516,282,11941,30429,0,Fall,13479,67945,282,False
2016,10/09,Louisville,1.15,1705,36812,328,11916,27498,0,Fall,13621,64310,328,False
2016,10/02,Louisville,1.24,1351,37151,487,12611,23401,0,Fall,13962,60552,487,False
2016,09/25,Louisville,1.37,1967,41728,413,13833,17570,0,Fall,15800,59298,413,False
2016,09/18,Louisville,1.26,2114,48962,565,13498,22492,0,Fall,15612,71454,565,False
2016,09/11,Louisville,1.21,3359,51733,634,13618,20735,5,Fall,16977,72468,639,False
2016,09/04,Louisville,1.11,2682,45780,769,14894,18599,215,Fall,17576,64379,984,False
2016,08/28,Louisville,1.13,1887,48991,614,15323,14585,1260,Summer,17210,63576,1874,False
2016,08/21,Louisville,1.16,1980,50039,735,16968,19306,340,Summer,18948,69345,1075,False
2016,08/14,Louisville,1.25,2056,54112,772,17081,11518,10,Summer,19137,65630,782,False
2016,08/07,Louisville,1.3,3573,53453,1058,13895,8739,276,Summer,17468,62192,1334,False
2016,07/31,Louisville,1.24,2355,53669,1144,13632,13603,1625,Summer,15987,67272,2769,False
2016,07/24,Louisville,1.19,2352,57404,1995,15345,15463,2439,Summer,17697,72867,4434,False
2016,07/17,Louisville,1.13,2414,60191,2110,14971,19863,2412,Summer,17385,80054,4522,False
2016,07/10,Louisville,1.15,2784,62213,2084,15928,8353,3226,Summer,18712,70566,5310,False
2016,07/03,Louisville,1.0,2398,64636,1810,18047,15818,3888,Summer,20445,80454,5698,False
2016,06/26,Louisville,1.06,2762,56614,3534,16663,15457,3045,Summer,19425,72071,6579,False
2016,06/19,Louisville,1.09,2648,54424,5024,13083,19034,4074,Summer,15731,73458,9098,False
2016,06/12,Louisville,1.16,5365,50561,2495,14528,9635,2340,Summer,19893,60196,4835,False
2016,06/05,Louisville,1.09,2153,56150,9893,15423,12558,2999,Summer,17576,68708,12892,False
2016,05/29,Louisville,0.99,2052,71648,2467,14675,17510,706,Spring,16727,89158,3173,False
2016,05/22,Louisville,0.91,2002,77719,2243,13628,17376,823,Spring,15630,95095,3066,False
2016,05/15,Louisville,0.86,2286,62308,6837,12021,20894,1929,Spring,14307,83202,8766,False
2016,05/08,Louisville,0.86,2523,87801,6925,12978,27788,1457,Spring,15501,115589,8382,False
2016,05/01,Louisville,0.88,2499,81916,3924,12605,26367,795,Spring,15104,108283,4719,False
2016,04/24,Louisville,0.93,2116,55939,3819,14568,15363,746,Spring,16684,71302,4565,False
2016,04/17,Louisville,0.92,2120,55695,9698,12091,13959,1908,Spring,14211,69654,11606,False
2016,04/10,Louisville,0.9,1824,49692,2962,12371,16274,379,Spring,14195,65966,3341,False
2016,04/03,Louisville,0.85,2091,52626,3898,9614,22101,1127,Spring,11705,74727,5025,False
2016,03/27,Louisville,0.89,1969,74446,6188,12424,23482,1568,Spring,14393,97928,7756,False
2016,03/20,Louisville,0.95,1893,76888,6365,12950,23671,1672,Spring,14843,100559,8037,False
2016,03/13,Louisville,1.07,1951,47340,3216,12899,13596,806,Spring,14850,60936,4022,False
2016,03/06,Louisville,1.02,2028,49580,8998,12369,12597,2528,Spring,14397,62177,11526,False
2016,02/28,Louisville,0.94,2152,63256,5795,11801,17869,1321,Winter,13953,81125,7116,False
2016,02/21,Louisville,0.86,2368,75573,2285,10663,23456,469,Winter,13031,99029,2754,False
2016,02/14,Louisville,0.86,2921,81575,3867,12729,22781,774,Winter,15650,104356,4641,False
2016,02/07,Louisville,0.85,2805,98136,10193,12782,22422,2364,Winter,15587,120558,12557,False
2016,01/31,Louisville,0.92,2539,70021,4774,10918,12100,1265,Winter,13457,82121,6039,False
2016,01/24,Louisville,0.89,1672,72603,9688,14236,20197,1905,Winter,15908,92800,11593,False
2016,01/17,Louisville,0.9,2202,48151,2801,14859,14857,815,Winter,17061,63008,3616,False
2016,01/10,Louisville,0.89,2088,63265,2594,14248,17270,488,Winter,16336,80535,3082,False
2016,01/03,Louisville,0.88,2673,73869,6301,11090,20808,1620,Winter,13763,94677,7921,False
2016,12/25,MiamiFtLauderdale,0.97,257456,148591,827,87168,154236,79,Winter,344624,302827,906,False
2016,12/18,MiamiFtLauderdale,0.97,237194,158602,3459,81459,181796,143,Winter,318653,340398,3602,False
2016,12/11,MiamiFtLauderdale,1.39,177620,97259,159,67684,103274,140,Winter,245304,200533,299,False
2016,12/04,MiamiFtLauderdale,0.98,267955,173005,50,89646,197097,435,Winter,357601,370102,485,False
2016,11/27,MiamiFtLauderdale,1.49,159915,89345,120,61614,93846,243,Fall,221529,183191,363,False
2016,11/20,MiamiFtLauderdale,1.52,179988,102113,44,70029,109061,0,Fall,250017,211174,44,False
2016,11/13,MiamiFtLauderdale,1.43,195573,101415,255,74065,106744,251,Fall,269638,208159,506,False
2016,11/06,MiamiFtLauderdale,1.51,176243,96964,232,53017,99149,551,Fall,229260,196113,783,False
2016,10/30,MiamiFtLauderdale,1.57,169008,98080,247,41406,94572,341,Fall,210414,192652,588,False
2016,10/23,MiamiFtLauderdale,1.59,164118,125399,247,39215,108323,183,Fall,203333,233722,430,False
2016,10/16,MiamiFtLauderdale,1.28,191040,158620,235,42989,144763,320,Fall,234029,303383,555,False
2016,10/09,MiamiFtLauderdale,1.49,153136,112103,169,50604,94167,0,Fall,203740,206270,169,False
2016,10/02,MiamiFtLauderdale,1.51,221783,125421,360,71779,120229,0,Fall,293562,245650,360,False
2016,09/25,MiamiFtLauderdale,1.43,251034,108280,180,80169,118396,488,Fall,331203,226676,668,False
2016,09/18,MiamiFtLauderdale,1.19,237187,103912,281,83963,114378,1308,Fall,321150,218290,1589,False
2016,09/11,MiamiFtLauderdale,1.2,226500,89642,194,77110,85586,1701,Fall,303610,175228,1895,False
2016,09/04,MiamiFtLauderdale,0.97,525593,140626,218,88544,106501,911,Fall,614137,247127,1129,False
2016,08/28,MiamiFtLauderdale,1.22,290432,131832,259,86796,48344,1163,Summer,377228,180176,1422,False
2016,08/21,MiamiFtLauderdale,1.23,296954,128877,95,82057,51085,6755,Summer,379011,179962,6850,False
2016,08/14,MiamiFtLauderdale,1.17,400660,142475,138,62925,83815,5214,Summer,463585,226290,5352,False
2016,08/07,MiamiFtLauderdale,1.25,253093,125026,114,80129,46177,10641,Summer,333222,171203,10755,False
2016,07/31,MiamiFtLauderdale,1.3,247196,112882,177,75629,46683,13940,Summer,322825,159565,14117,False
2016,07/24,MiamiFtLauderdale,1.28,250298,132336,164,78153,46751,12791,Summer,328451,179087,12955,False
2016,07/17,MiamiFtLauderdale,1.24,241386,136077,190,79192,43113,16755,Summer,320578,179190,16945,False
2016,07/10,MiamiFtLauderdale,1.24,277354,142734,151,87649,46987,12012,Summer,365003,189721,12163,False
2016,07/03,MiamiFtLauderdale,0.96,479975,184172,129,95020,92318,17369,Summer,574995,276490,17498,False
2016,06/26,MiamiFtLauderdale,1.25,283281,130937,165,78005,32132,15683,Summer,361286,163069,15848,False
2016,06/19,MiamiFtLauderdale,0.99,474374,182509,115,67085,74179,14070,Summer,541459,256688,14185,False
2016,06/12,MiamiFtLauderdale,1.28,271970,107339,77,59675,49302,14710,Summer,331645,156641,14787,False
2016,06/05,MiamiFtLauderdale,0.99,474319,149114,252,56515,98746,7122,Summer,530834,247860,7374,False
2016,05/29,MiamiFtLauderdale,0.97,513204,167161,248,64610,93591,10280,Spring,577814,260752,10528,False
2016,05/22,MiamiFtLauderdale,1.26,273987,103459,257,56006,54738,9370,Spring,329993,158197,9627,False
2016,05/15,MiamiFtLauderdale,0.88,408466,227686,223,64835,185705,2440,Spring,473301,413391,2663,False
2016,05/08,MiamiFtLauderdale,1.01,349383,137741,173,70856,94280,1409,Spring,420239,232021,1582,False
2016,05/01,MiamiFtLauderdale,0.79,526288,260626,584,71215,220080,0,Spring,597503,480706,584,False
2016,04/24,MiamiFtLauderdale,0.88,419775,227523,547,61116,186258,1623,Spring,480891,413781,2170,False
2016,04/17,MiamiFtLauderdale,1.12,281531,117780,101,62016,97104,419,Spring,343547,214884,520,False
2016,04/10,MiamiFtLauderdale,0.87,399737,193376,155,54479,193376,605,Spring,454216,386752,760,False
2016,04/03,MiamiFtLauderdale,1.15,287271,103462,72,54721,97707,0,Spring,341992,201169,72,False
2016,03/27,MiamiFtLauderdale,1.17,240096,99290,128,52473,76647,0,Spring,292569,175937,128,False
2016,03/20,MiamiFtLauderdale,1.13,267187,105076,142,47086,88086,0,Spring,314273,193162,142,False
2016,03/13,MiamiFtLauderdale,0.88,399729,176357,181,49544,174179,0,Spring,449273,350536,181,False
2016,03/06,MiamiFtLauderdale,1.16,223851,93574,93,48944,81587,0,Spring,272795,175161,93,False
2016,02/28,MiamiFtLauderdale,0.83,428974,169811,702,56123,166790,0,Winter,485097,336601,702,False
2016,02/21,MiamiFtLauderdale,1.1,244778,102684,78,48792,85370,0,Winter,293570,188054,78,False
2016,02/14,MiamiFtLauderdale,1.12,219037,101866,75,54765,70886,0,Winter,273802,172752,75,False
2016,02/07,MiamiFtLauderdale,0.59,649646,241271,231,71559,217921,0,Winter,721205,459192,231,False
2016,01/31,MiamiFtLauderdale,1.11,287032,79763,168,59045,66681,0,Winter,346077,146444,168,False
2016,01/24,MiamiFtLauderdale,0.96,416813,61067,259,68930,64486,0,Winter,485743,125553,259,False
2016,01/17,MiamiFtLauderdale,1.2,276253,62106,292,61025,30401,0,Winter,337278,92507,292,False
2016,01/10,MiamiFtLauderdale,0.97,493952,82027,249,58416,68080,0,Winter,552368,150107,249,False
2016,01/03,MiamiFtLauderdale,1.13,349992,44399,40,64404,43746,0,Winter,414396,88145,40,False
2016,12/25,Nashville,0.93,63236,18070,66,67429,16683,1000,Winter,130665,34753,1066,False
2016,12/18,Nashville,0.92,66411,16272,104,57450,16375,1410,Winter,123861,32647,1514,False
2016,12/11,Nashville,0.9,84856,12359,158,83236,10921,2180,Winter,168092,23280,2338,False
2016,12/04,Nashville,0.96,82751,20042,853,60604,23948,1325,Winter,143355,43990,2178,False
2016,11/27,Nashville,1.24,50379,12290,177,55387,11098,604,Fall,105766,23388,781,False
2016,11/20,Nashville,1.33,53849,12277,98,54104,10860,415,Fall,107953,23137,513,False
2016,11/13,Nashville,1.39,59293,13161,181,56865,10715,1170,Fall,116158,23876,1351,False
2016,11/06,Nashville,1.31,66594,13756,126,54846,11172,440,Fall,121440,24928,566,False
2016,10/30,Nashville,1.18,65786,17343,165,54539,12436,1445,Fall,120325,29779,1610,False
2016,10/23,Nashville,1.19,66511,28375,125,57360,9383,1260,Fall,123871,37758,1385,False
2016,10/16,Nashville,1.06,78566,21640,233,56615,20373,180,Fall,135181,42013,413,False
2016,10/09,Nashville,1.2,77153,15555,127,41727,21913,0,Fall,118880,37468,127,False
2016,10/02,Nashville,1.15,76163,15615,85,63579,17310,0,Fall,139742,32925,85,False
2016,09/25,Nashville,1.16,79738,20581,188,59330,14930,0,Fall,139068,35511,188,False
2016,09/18,Nashville,1.01,98830,16914,80,55278,20256,0,Fall,154108,37170,80,False
2016,09/11,Nashville,0.75,144886,12777,342,70618,21540,0,Fall,215504,34317,342,False
2016,09/04,Nashville,0.73,172938,14374,371,89643,15574,0,Fall,262581,29948,371,False
2016,08/28,Nashville,1.09,104278,12600,347,52255,3275,0,Summer,156533,15875,347,False
2016,08/21,Nashville,1.09,102330,15916,193,62586,3705,0,Summer,164916,19621,193,False
2016,08/14,Nashville,1.06,102665,19071,173,67507,13415,0,Summer,170172,32486,173,False
2016,08/07,Nashville,1.12,95351,25466,161,46061,20976,0,Summer,141412,46442,161,False
2016,07/31,Nashville,1.1,88436,29435,250,58584,9715,97,Summer,147020,39150,347,False
2016,07/24,Nashville,1.07,87692,31317,255,59470,12991,0,Summer,147162,44308,255,False
2016,07/17,Nashville,1.07,90032,33912,220,63132,9476,0,Summer,153164,43388,220,False
2016,07/10,Nashville,1.0,88754,37966,320,51675,19523,0,Summer,140429,57489,320,False
2016,07/03,Nashville,0.87,106013,46053,354,74730,23750,0,Summer,180743,69803,354,False
2016,06/26,Nashville,0.98,100031,25602,243,60658,8683,251,Summer,160689,34285,494,False
2016,06/19,Nashville,0.89,135024,19715,436,62256,13376,1273,Summer,197280,33091,1709,False
2016,06/12,Nashville,0.97,119783,12815,905,46174,9199,2043,Summer,165957,22014,2948,False
2016,06/05,Nashville,0.88,136409,17532,727,52919,14359,1420,Summer,189328,31891,2147,False
2016,05/29,Nashville,0.87,144140,21273,993,56072,15057,1086,Spring,200212,36330,2079,False
2016,05/22,Nashville,0.92,115616,18839,712,56097,11396,1465,Spring,171713,30235,2177,False
2016,05/15,Nashville,0.81,103729,31344,975,55828,27611,125,Spring,159557,58955,1100,False
2016,05/08,Nashville,0.88,114895,26341,745,51755,18956,25,Spring,166650,45297,770,False
2016,05/01,Nashville,0.81,117137,37442,1425,49536,32137,0,Spring,166673,69579,1425,False
2016,04/24,Nashville,0.81,111614,33820,1474,60106,26635,106,Spring,171720,60455,1580,False
2016,04/17,Nashville,0.9,96001,23421,1199,40772,16972,2,Spring,136773,40393,1201,False
2016,04/10,Nashville,0.82,98423,31061,3073,43662,30601,7,Spring,142085,61662,3080,False
2016,04/03,Nashville,0.95,94345,19391,6467,26413,18970,0,Spring,120758,38361,6467,False
2016,03/27,Nashville,0.93,98386,20112,6373,33537,13157,0,Spring,131923,33269,6373,False
2016,03/20,Nashville,0.93,100108,21586,6535,35369,15704,2,Spring,135477,37290,6537,False
2016,03/13,Nashville,0.87,91631,32085,5965,27726,31069,0,Spring,119357,63154,5965,False
2016,03/06,Nashville,0.97,87362,20762,5969,29901,15758,0,Spring,117263,36520,5969,False
2016,02/28,Nashville,0.88,99189,31558,7034,27927,24552,0,Winter,127116,56110,7034,False
2016,02/21,Nashville,0.94,101831,25448,9518,33528,11699,0,Winter,135359,37147,9518,False
2016,02/14,Nashville,0.88,103368,42830,8627,32189,16189,0,Winter,135557,59019,8627,False
2016,02/07,Nashville,0.77,124530,59611,7759,39458,37249,0,Winter,163988,96860,7759,False
2016,01/31,Nashville,0.95,90482,33297,8012,27523,14373,0,Winter,118005,47670,8012,False
2016,01/24,Nashville,0.87,78105,33125,6297,25723,23907,0,Winter,103828,57032,6297,False
2016,01/17,Nashville,0.95,98888,30227,6427,32109,13707,0,Winter,130997,43934,6427,False
2016,01/10,Nashville,0.9,123086,29886,7579,31952,20246,0,Winter,155038,50132,7579,False
2016,01/03,Nashville,0.98,131286,11153,7695,26143,9037,0,Winter,157429,20190,7695,False
2016,12/25,NewOrleansMobile,0.94,117054,23166,258,59964,19594,5458,Winter,177018,42760,5716,False
2016,12/18,NewOrleansMobile,1.08,83700,21081,430,51001,17159,9730,Winter,134701,38240,10160,False
2016,12/11,NewOrleansMobile,1.21,89506,18892,205,53845,11187,3945,Winter,143351,30079,4150,False
2016,12/04,NewOrleansMobile,1.05,143482,24486,120,62849,19437,2865,Winter,206331,43923,2985,False
2016,11/27,NewOrleansMobile,1.38,76603,17900,50,40901,12685,396,Fall,117504,30585,446,False
2016,11/20,NewOrleansMobile,1.35,86431,23609,51,44174,12726,240,Fall,130605,36335,291,False
2016,11/13,NewOrleansMobile,1.26,133593,30401,102,45125,15814,683,Fall,178718,46215,785,False
2016,11/06,NewOrleansMobile,1.49,98949,22891,95,43571,17499,534,Fall,142520,40390,629,False
2016,10/30,NewOrleansMobile,1.48,71230,22081,373,43587,16789,9448,Fall,114817,38870,9821,False
2016,10/23,NewOrleansMobile,1.44,102352,30817,245,50403,15594,4025,Fall,152755,46411,4270,False
2016,10/16,NewOrleansMobile,1.36,112346,27293,501,54473,16752,11345,Fall,166819,44045,11846,False
2016,10/09,NewOrleansMobile,1.25,114410,41719,401,49871,16720,10775,Fall,164281,58439,11176,False
2016,10/02,NewOrleansMobile,1.29,108880,32258,338,51156,14452,7605,Fall,160036,46710,7943,False
2016,09/25,NewOrleansMobile,1.19,141795,34973,892,58016,14213,14835,Fall,199811,49186,15727,False
2016,09/18,NewOrleansMobile,1.18,126047,32908,447,58161,16384,10965,Fall,184208,49292,11412,False
2016,09/11,NewOrleansMobile,1.13,141311,37594,252,58389,9139,3805,Fall,199700,46733,4057,False
2016,09/04,NewOrleansMobile,0.94,172989,65043,274,63878,12704,9260,Fall,236867,77747,9534,False
2016,08/28,NewOrleansMobile,1.02,171213,49486,363,64573,16041,7560,Summer,235786,65527,7923,False
2016,08/21,NewOrleansMobile,1.04,187528,43283,305,61315,12616,9525,Summer,248843,55899,9830,False
2016,08/14,NewOrleansMobile,1.11,148300,48204,189,52182,14285,2375,Summer,200482,62489,2564,False
2016,08/07,NewOrleansMobile,1.13,153070,52769,333,62537,9693,8709,Summer,215607,62462,9042,False
2016,07/31,NewOrleansMobile,1.2,141489,39957,239,58784,13783,625,Summer,200273,53740,864,False
2016,07/24,NewOrleansMobile,1.16,127608,41610,397,68532,10508,12835,Summer,196140,52118,13232,False
2016,07/17,NewOrleansMobile,1.09,141466,40877,271,86821,13213,2275,Summer,228287,54090,2546,False
2016,07/10,NewOrleansMobile,1.06,149481,41307,335,79378,10060,11414,Summer,228859,51367,11749,False
2016,07/03,NewOrleansMobile,0.93,194809,44367,320,98981,15078,6861,Summer,293790,59445,7181,False
2016,06/26,NewOrleansMobile,1.05,137323,37595,396,73510,9280,9010,Summer,210833,46875,9406,False
2016,06/19,NewOrleansMobile,0.97,162451,39328,267,70450,16416,4425,Summer,232901,55744,4692,False
2016,06/12,NewOrleansMobile,0.95,163474,35055,495,63204,9379,12312,Summer,226678,44434,12807,False
2016,06/05,NewOrleansMobile,0.89,176829,26539,557,59274,15485,12804,Summer,236103,42024,13361,False
2016,05/29,NewOrleansMobile,0.85,167413,47486,355,65115,14412,5295,Spring,232528,61898,5650,False
2016,05/22,NewOrleansMobile,0.96,152790,32548,495,67298,13429,4992,Spring,220088,45977,5487,False
2016,05/15,NewOrleansMobile,0.86,156109,35603,455,62286,33790,0,Spring,218395,69393,455,False
2016,05/08,NewOrleansMobile,0.63,304801,41988,455,128875,19610,0,Spring,433676,61598,455,False
2016,05/01,NewOrleansMobile,0.58,341116,60230,1500,118421,43469,0,Spring,459537,103699,1500,False
2016,04/24,NewOrleansMobile,0.87,150931,33965,3088,77956,29557,0,Spring,228887,63522,3088,False
2016,04/17,NewOrleansMobile,0.87,181796,32868,380,89653,19210,0,Spring,271449,52078,380,False
2016,04/10,NewOrleansMobile,0.87,166398,34799,612,81778,28883,0,Spring,248176,63682,612,False
2016,04/03,NewOrleansMobile,0.89,183584,29117,4574,80521,18910,0,Spring,264105,48027,4574,False
2016,03/27,NewOrleansMobile,0.94,138523,31627,1281,79866,12283,0,Spring,218389,43910,1281,False
2016,03/20,NewOrleansMobile,0.94,148492,30606,1534,77772,15240,0,Spring,226264,45846,1534,False
2016,03/13,NewOrleansMobile,0.91,160965,38522,455,80240,23873,0,Spring,241205,62395,455,False
2016,03/06,NewOrleansMobile,0.97,150786,27025,565,74664,14911,0,Spring,225450,41936,565,False
2016,02/28,NewOrleansMobile,0.8,173568,35255,991,84691,25835,0,Winter,258259,61090,991,False
2016,02/21,NewOrleansMobile,0.89,142078,31665,322,71315,17675,0,Winter,213393,49340,322,False
2016,02/14,NewOrleansMobile,0.81,175416,29031,379,51330,13161,0,Winter,226746,42192,379,False
2016,02/07,NewOrleansMobile,0.58,348348,55886,566,114075,23873,0,Winter,462423,79759,566,False
2016,01/31,NewOrleansMobile,0.88,164436,33071,347,74926,10152,0,Winter,239362,43223,347,False
2016,01/24,NewOrleansMobile,0.9,101029,36030,403,77619,13004,0,Winter,178648,49034,403,False
2016,01/17,NewOrleansMobile,0.88,158616,41109,499,77817,8819,0,Winter,236433,49928,499,False
2016,01/10,NewOrleansMobile,0.9,160167,24063,440,67742,12063,0,Winter,227909,36126,440,False
2016,01/03,NewOrleansMobile,0.86,159513,40902,352,65954,7775,0,Winter,225467,48677,352,False
2016,12/25,NewYork,1.36,11329,713042,84414,241335,36654,1207,Winter,252664,749696,85621,False
2016,12/18,NewYork,1.26,14178,954802,15428,215851,39174,1946,Winter,230029,993976,17374,False
2016,12/11,NewYork,1.32,10994,793989,5247,247566,104392,1506,Winter,258560,898381,6753,False
2016,12/04,NewYork,1.52,13893,696042,2350,214068,33668,453,Winter,227961,729710,2803,False
2016,11/27,NewYork,1.56,15264,696848,2022,223707,32610,298,Fall,238971,729458,2320,False
2016,11/20,NewYork,1.59,16970,732069,2999,303438,35803,1816,Fall,320408,767872,4815,False
2016,11/13,NewYork,1.9,12169,523321,2970,248573,42984,0,Fall,260742,566305,2970,False
2016,11/06,NewYork,1.93,10277,460230,3519,250705,42457,0,Fall,260982,502687,3519,False
2016,10/30,NewYork,1.99,9264,435952,1595,148756,21484,1225,Fall,158020,457436,2820,False
2016,10/23,NewYork,1.95,11212,512038,2086,275967,5009,1250,Fall,287179,517047,3336,False
2016,10/16,NewYork,1.89,15611,636341,1794,279470,35805,823,Fall,295081,672146,2617,False
2016,10/09,NewYork,1.76,20086,688905,1806,272661,47381,218,Fall,292747,736286,2024,False
2016,10/02,NewYork,1.72,33926,658467,3847,310800,50151,737,Fall,344726,708618,4584,False
2016,09/25,NewYork,1.62,121477,566149,2002,333527,37136,838,Fall,455004,603285,2840,False
2016,09/18,NewYork,1.5,112702,551448,1664,390220,52277,133,Fall,502922,603725,1797,False
2016,09/11,NewYork,1.26,239517,883865,2148,384183,48239,457,Fall,623700,932104,2605,False
2016,09/04,NewYork,1.47,23916,832269,12219,355517,53778,1048,Fall,379433,886047,13267,False
2016,08/28,NewYork,1.58,19257,715527,37849,378940,57956,2868,Summer,398197,773483,40717,False
2016,08/21,NewYork,1.47,15005,771413,4586,487247,52652,4033,Summer,502252,824065,8619,False
2016,08/14,NewYork,1.49,18600,714407,13049,496919,31781,1194,Summer,515519,746188,14243,False
2016,08/07,NewYork,1.54,22522,668121,26114,496292,40991,2876,Summer,518814,709112,28990,False
2016,07/31,NewYork,1.7,16312,609412,21053,453444,19392,2547,Summer,469756,628804,23600,False
2016,07/24,NewYork,1.68,14628,650141,22932,466170,21057,5442,Summer,480798,671198,28374,False
2016,07/17,NewYork,1.64,12881,611445,28823,365760,50850,6497,Summer,378641,662295,35320,False
2016,07/10,NewYork,1.51,15424,700324,38821,423617,84322,3688,Summer,439041,784646,42509,False
2016,07/03,NewYork,1.53,14732,746733,49981,401172,62447,5657,Summer,415904,809180,55638,False
2016,06/26,NewYork,1.2,16027,1130566,30501,385977,56319,2758,Summer,402004,1186885,33259,False
2016,06/19,NewYork,1.5,16094,901972,28828,366851,55746,3118,Summer,382945,957718,31946,False
2016,06/12,NewYork,1.44,19083,976390,21103,404818,60441,3803,Summer,423901,1036831,24906,False
2016,06/05,NewYork,1.47,15757,955311,23821,387456,63464,1769,Summer,403213,1018775,25590,False
2016,05/29,NewYork,1.08,19729,1354634,24551,357118,70667,398,Spring,376847,1425301,24949,False
2016,05/22,NewYork,1.14,16781,1157504,16382,362726,32847,405,Spring,379507,1190351,16787,False
2016,05/15,NewYork,1.14,17964,1274098,16601,343885,52450,1730,Spring,361849,1326548,18331,False
2016,05/08,NewYork,0.77,26384,2283465,21633,349589,59095,419,Spring,375973,2342560,22052,False
2016,05/01,NewYork,1.22,16424,1106990,11518,321936,79106,134,Spring,338360,1186096,11652,False
2016,04/24,NewYork,1.12,19783,1290475,12409,331784,62792,811,Spring,351567,1353267,13220,False
2016,04/17,NewYork,1.08,16212,582843,4694,350600,74702,1734,Spring,366812,657545,6428,False
2016,04/10,NewYork,1.09,19209,588026,2136,337797,38411,2316,Spring,357006,626437,4452,False
2016,04/03,NewYork,1.31,15436,912292,1685,269122,42071,0,Spring,284558,954363,1685,False
2016,03/27,NewYork,1.32,17761,1008215,1438,316529,51617,0,Spring,334290,1059832,1438,False
2016,03/20,NewYork,1.09,23278,1269404,1917,407712,40881,0,Spring,430990,1310285,1917,False
2016,03/13,NewYork,1.17,28599,1237674,2800,287983,43358,0,Spring,316582,1281032,2800,False
2016,03/06,NewYork,1.24,18107,1074827,2066,317977,42677,0,Spring,336084,1117504,2066,False
2016,02/28,NewYork,1.15,18295,1282457,2027,249147,42500,0,Winter,267442,1324957,2027,False
2016,02/21,NewYork,1.21,15028,930110,3071,323061,43906,0,Winter,338089,974016,3071,False
2016,02/14,NewYork,1.09,23786,1388157,1219,326948,66868,0,Winter,350734,1455025,1219,False
2016,02/07,NewYork,0.95,23983,1630429,2999,502578,42137,0,Winter,526561,1672566,2999,False
2016,01/31,NewYork,1.02,18769,1284268,1383,269851,41190,2,Winter,288620,1325458,1385,False
2016,01/24,NewYork,1.3,16058,993964,1854,345620,71745,0,Winter,361678,1065709,1854,False
2016,01/17,NewYork,1.01,18562,1422978,4948,349479,44375,0,Winter,368041,1467353,4948,False
2016,01/10,NewYork,1.15,16165,1012218,1669,278109,56109,0,Winter,294274,1068327,1669,False
2016,01/03,NewYork,1.07,16972,1192875,1462,205535,37308,8,Winter,222507,1230183,1470,False
2016,12/25,NorthernNewEngland,1.24,12140,257987,2878,52623,4,0,Winter,64763,257991,2878,False
2016,12/18,NorthernNewEngland,1.19,14139,293062,5316,44559,396,33,Winter,58698,293458,5349,False
2016,12/11,NorthernNewEngland,1.29,9683,246740,3080,50026,894,0,Winter,59709,247634,3080,False
2016,12/04,NorthernNewEngland,1.12,24617,378804,2349,35218,0,0,Winter,59835,378804,2349,False
2016,11/27,NorthernNewEngland,1.41,11304,210220,2392,38831,0,0,Fall,50135,210220,2392,False
2016,11/20,NorthernNewEngland,1.39,15322,247461,3473,49526,0,0,Fall,64848,247461,3473,False
2016,11/13,NorthernNewEngland,1.48,11996,211327,2651,42414,0,0,Fall,54410,211327,2651,False
2016,11/06,NorthernNewEngland,1.47,10727,179547,2261,50130,0,0,Fall,60857,179547,2261,False
2016,10/30,NorthernNewEngland,1.52,12252,185280,2879,55043,0,0,Fall,67295,185280,2879,False
2016,10/23,NorthernNewEngland,1.48,17405,223021,4022,46935,0,0,Fall,64340,223021,4022,False
2016,10/16,NorthernNewEngland,1.47,14794,224368,3353,48368,0,0,Fall,63162,224368,3353,False
2016,10/09,NorthernNewEngland,1.4,14886,239615,2844,48160,0,0,Fall,63046,239615,2844,False
2016,10/02,NorthernNewEngland,1.52,18423,222357,3193,47207,3,0,Fall,65630,222360,3193,False
2016,09/25,NorthernNewEngland,1.58,23189,236472,3706,52018,11,0,Fall,75207,236483,3706,False
2016,09/18,NorthernNewEngland,1.48,24643,235008,4265,52433,548,80,Fall,77076,235556,4345,False
2016,09/11,NorthernNewEngland,1.44,35007,237320,7204,63234,537,10,Fall,98241,237857,7214,False
2016,09/04,NorthernNewEngland,1.38,83711,209147,6202,75401,0,440,Fall,159112,209147,6642,False
2016,08/28,NorthernNewEngland,1.08,211564,287750,4901,67069,22,2030,Summer,278633,287772,6931,False
2016,08/21,NorthernNewEngland,1.34,95074,197872,4669,114415,30,1435,Summer,209489,197902,6104,False
2016,08/14,NorthernNewEngland,1.21,114823,226795,5813,114464,0,1755,Summer,229287,226795,7568,False
2016,08/07,NorthernNewEngland,1.41,113313,241098,5883,96888,0,245,Summer,210201,241098,6128,False
2016,07/31,NorthernNewEngland,1.49,79930,239638,6617,107009,3,1930,Summer,186939,239641,8547,False
2016,07/24,NorthernNewEngland,1.36,83734,244441,7567,122744,3,4570,Summer,206478,244444,12137,False
2016,07/17,NorthernNewEngland,1.37,75192,228099,7593,94129,0,7371,Summer,169321,228099,14964,False
2016,07/10,NorthernNewEngland,1.06,134476,339263,10102,77486,4,7995,Summer,211962,339267,18097,False
2016,07/03,NorthernNewEngland,1.29,78903,321186,14095,102068,7,9655,Summer,180971,321193,23750,False
2016,06/26,NorthernNewEngland,1.28,63778,323719,20456,85807,0,4055,Summer,149585,323719,24511,False
2016,06/19,NorthernNewEngland,1.26,53199,322695,27247,80128,0,2675,Summer,133327,322695,29922,False
2016,06/12,NorthernNewEngland,1.19,48479,307758,30137,82839,0,2805,Summer,131318,307758,32942,False
2016,06/05,NorthernNewEngland,1.18,32955,314403,35125,86447,0,2425,Summer,119402,314403,37550,False
2016,05/29,NorthernNewEngland,1.1,19245,337329,58060,83274,4,2030,Spring,102519,337333,60090,False
2016,05/22,NorthernNewEngland,1.02,2888,280360,64720,82259,7,3015,Spring,85147,280367,67735,False
2016,05/15,NorthernNewEngland,1.07,3333,314998,47340,77840,3,0,Spring,81173,315001,47340,False
2016,05/08,NorthernNewEngland,0.97,3368,370026,55130,118297,14,0,Spring,121665,370040,55130,False
2016,05/01,NorthernNewEngland,1.02,2527,538037,37533,50354,0,59,Spring,52881,538037,37592,False
2016,04/24,NorthernNewEngland,1.07,2993,326907,39188,62471,55,0,Spring,65464,326962,39188,False
2016,04/17,NorthernNewEngland,1.12,2033,303891,29548,63501,33,65,Spring,65534,303924,29613,False
2016,04/10,NorthernNewEngland,1.04,2856,291174,50624,64557,14,0,Spring,67413,291188,50624,False
2016,04/03,NorthernNewEngland,0.99,3194,411414,26852,45255,0,0,Spring,48449,411414,26852,False
2016,03/27,NorthernNewEngland,1.13,2320,327259,29091,64585,0,0,Spring,66905,327259,29091,False
2016,03/20,NorthernNewEngland,1.14,3204,325110,25614,60671,3,0,Spring,63875,325113,25614,False
2016,03/13,NorthernNewEngland,1.01,3165,382630,36964,53859,14,0,Spring,57024,382644,36964,False
2016,03/06,NorthernNewEngland,1.08,4140,303581,26686,71471,51,0,Spring,75611,303632,26686,False
2016,02/28,NorthernNewEngland,1.1,4257,288178,26834,67323,556,0,Winter,71580,288734,26834,False
2016,02/21,NorthernNewEngland,1.16,3997,278339,26089,70056,1943,0,Winter,74053,280282,26089,False
2016,02/14,NorthernNewEngland,0.99,4686,316152,41374,91688,2536,0,Winter,96374,318688,41374,False
2016,02/07,NorthernNewEngland,0.97,3738,531499,16922,51858,1828,0,Winter,55596,533327,16922,False
2016,01/31,NorthernNewEngland,1.07,3328,292519,18558,104227,1151,0,Winter,107555,293670,18558,False
2016,01/24,NorthernNewEngland,1.07,852,319014,22047,111162,483,0,Winter,112014,319497,22047,False
2016,01/17,NorthernNewEngland,1.08,3556,328749,22335,92437,0,0,Winter,95993,328749,22335,False
2016,01/10,NorthernNewEngland,1.24,2398,270035,11133,59836,3,0,Winter,62234,270038,11133,False
2016,01/03,NorthernNewEngland,0.96,3485,492915,17575,39852,0,0,Winter,43337,492915,17575,False
2016,12/25,Orlando,0.94,131616,81351,133,65955,79804,144,Winter,197571,161155,277,False
2016,12/18,Orlando,0.92,113248,76982,118,63529,79119,94,Winter,176777,156101,212,False
2016,12/11,Orlando,1.22,84080,48772,67,61197,53441,100,Winter,145277,102213,167,False
2016,12/04,Orlando,0.97,129743,95284,114,65178,108538,0,Winter,194921,203822,114,False
2016,11/27,Orlando,1.46,76751,48667,121,44616,51217,0,Fall,121367,99884,121,False
2016,11/20,Orlando,1.46,83653,50316,91,49247,56065,0,Fall,132900,106381,91,False
2016,11/13,Orlando,1.4,97337,50337,167,48419,54377,0,Fall,145756,104714,167,False
2016,11/06,Orlando,1.47,93321,53545,149,34250,55431,0,Fall,127571,108976,149,False
2016,10/30,Orlando,1.54,82399,52975,143,30132,57103,469,Fall,112531,110078,612,False
2016,10/23,Orlando,1.52,83780,68746,134,28494,54609,734,Fall,112274,123355,868,False
2016,10/16,Orlando,1.23,104391,87927,151,24825,94068,0,Fall,129216,181995,151,False
2016,10/09,Orlando,1.44,91531,81061,129,39055,55621,0,Fall,130586,136682,129,False
2016,10/02,Orlando,1.45,117406,66860,189,50462,66632,387,Fall,167868,133492,576,False
2016,09/25,Orlando,1.4,122725,54807,134,61486,62514,1140,Fall,184211,117321,1274,False
2016,09/18,Orlando,1.16,133279,59374,90,57821,68979,0,Fall,191100,128353,90,False
2016,09/11,Orlando,1.18,150964,55134,63,50283,55821,0,Fall,201247,110955,63,False
2016,09/04,Orlando,0.97,275859,75406,171,59356,66507,0,Fall,335215,141913,171,False
2016,08/28,Orlando,1.18,163536,80917,91,58695,21860,1811,Summer,222231,102777,1902,False
2016,08/21,Orlando,1.19,170496,87311,83,60961,23780,4930,Summer,231457,111091,5013,False
2016,08/14,Orlando,1.14,210918,92045,131,53991,54647,4960,Summer,264909,146692,5091,False
2016,08/07,Orlando,1.23,143759,84662,114,52784,35583,10262,Summer,196543,120245,10376,False
2016,07/31,Orlando,1.24,137791,80412,90,59130,33276,9300,Summer,196921,113688,9390,False
2016,07/24,Orlando,1.22,145903,92078,142,53516,34306,10420,Summer,199419,126384,10562,False
2016,07/17,Orlando,1.17,141751,90770,104,72463,31198,12030,Summer,214214,121968,12134,False
2016,07/10,Orlando,1.17,143563,84546,129,71803,29184,12305,Summer,215366,113730,12434,False
2016,07/03,Orlando,0.93,277838,118092,278,87341,50692,19396,Summer,365179,168784,19674,False
2016,06/26,Orlando,1.18,143186,76177,94,68453,35165,10490,Summer,211639,111342,10584,False
2016,06/19,Orlando,0.97,238794,98795,250,52416,52961,11060,Summer,291210,151756,11310,False
2016,06/12,Orlando,1.24,143222,64910,142,44014,32645,8876,Summer,187236,97555,9018,False
2016,06/05,Orlando,0.97,262311,71419,231,45382,58692,10079,Summer,307693,130111,10310,False
2016,05/29,Orlando,0.95,283442,82501,344,48638,62353,3788,Spring,332080,144854,4132,False
2016,05/22,Orlando,1.17,163428,55452,307,44788,40285,8269,Spring,208216,95737,8576,False
2016,05/15,Orlando,0.83,218691,121577,378,46050,121150,4991,Spring,264741,242727,5369,False
2016,05/08,Orlando,0.95,213997,80588,259,60411,77481,0,Spring,274408,158069,259,False
2016,05/01,Orlando,0.76,301117,142408,403,70814,152706,368,Spring,371931,295114,771,False
2016,04/24,Orlando,0.83,230753,124208,745,46440,130991,691,Spring,277193,255199,1436,False
2016,04/17,Orlando,1.06,172247,69222,225,44830,61355,0,Spring,217077,130577,225,False
2016,04/10,Orlando,0.83,229924,113252,213,43958,129928,0,Spring,273882,243180,213,False
2016,04/03,Orlando,1.05,178043,55773,251,49626,65426,0,Spring,227669,121199,251,False
2016,03/27,Orlando,1.06,152991,56406,62,45393,56717,0,Spring,198384,113123,62,False
2016,03/20,Orlando,1.09,136450,56331,89,39885,58998,0,Spring,176335,115329,89,False
2016,03/13,Orlando,0.84,216899,97078,450,42925,122602,0,Spring,259824,219680,450,False
2016,03/06,Orlando,1.08,142948,51358,39,46058,51327,0,Spring,189006,102685,39,False
2016,02/28,Orlando,0.82,233309,93393,222,51303,118744,0,Winter,284612,212137,222,False
2016,02/21,Orlando,1.05,145443,50580,89,42824,57992,0,Winter,188267,108572,89,False
2016,02/14,Orlando,0.96,168683,50342,103,42330,50811,0,Winter,211013,101153,103,False
2016,02/07,Orlando,0.58,370221,119918,221,50078,155928,0,Winter,420299,275846,221,False
2016,01/31,Orlando,1.03,163156,61348,159,45442,59520,0,Winter,208598,120868,159,False
2016,01/24,Orlando,0.93,234746,54289,325,54036,56341,11,Winter,288782,110630,336,False
2016,01/17,Orlando,1.19,155452,21801,83,50177,20509,14,Winter,205629,42310,97,False
2016,01/10,Orlando,0.96,279393,31582,198,49854,52384,0,Winter,329247,83966,198,False
2016,01/03,Orlando,1.11,201918,31729,234,46089,28739,0,Winter,248007,60468,234,False
2016,12/25,Philadelphia,1.43,11217,202764,18780,91017,5380,333,Winter,102234,208144,19113,False
2016,12/18,Philadelphia,1.38,11534,231497,2123,84390,6638,82,Winter,95924,238135,2205,False
2016,12/11,Philadelphia,1.37,12147,231524,735,92567,19741,0,Winter,104714,251265,735,False
2016,12/04,Philadelphia,1.54,12336,195612,845,86813,5539,182,Winter,99149,201151,1027,False
2016,11/27,Philadelphia,1.57,10693,180338,859,82183,5056,0,Fall,92876,185394,859,False
2016,11/20,Philadelphia,1.57,13380,207065,1486,101912,4632,79,Fall,115292,211697,1565,False
2016,11/13,Philadelphia,1.72,14610,177197,1839,94328,5876,0,Fall,108938,183073,1839,False
2016,11/06,Philadelphia,1.86,14395,162910,1465,83528,7238,231,Fall,97923,170148,1696,False
2016,10/30,Philadelphia,1.83,13468,150271,701,86874,3107,0,Fall,100342,153378,701,False
2016,10/23,Philadelphia,1.89,13407,179712,664,97636,1958,0,Fall,111043,181670,664,False
2016,10/16,Philadelphia,1.74,15915,192515,718,119365,6892,0,Fall,135280,199407,718,False
2016,10/09,Philadelphia,1.71,16118,203203,964,127432,7948,0,Fall,143550,211151,964,False
2016,10/02,Philadelphia,1.61,18332,195428,898,143701,7790,82,Fall,162033,203218,980,False
2016,09/25,Philadelphia,1.54,42044,166762,776,151162,5459,0,Fall,193206,172221,776,False
2016,09/18,Philadelphia,1.41,47548,167573,747,177935,9260,0,Fall,225483,176833,747,False
2016,09/11,Philadelphia,1.24,73604,218301,955,197316,9482,0,Fall,270920,227783,955,False
2016,09/04,Philadelphia,1.3,47716,240344,4082,186793,9073,452,Fall,234509,249417,4534,False
2016,08/28,Philadelphia,1.49,21609,200120,13529,171925,10097,1459,Summer,193534,210217,14988,False
2016,08/21,Philadelphia,1.45,14771,215056,2558,156783,17277,2042,Summer,171554,232333,4600,False
2016,08/14,Philadelphia,1.43,21070,201588,5607,176028,9698,1107,Summer,197098,211286,6714,False
2016,08/07,Philadelphia,1.45,23405,189679,12191,174613,8525,2836,Summer,198018,198204,15027,False
2016,07/31,Philadelphia,1.57,15974,180678,12676,161291,3766,1965,Summer,177265,184444,14641,False
2016,07/24,Philadelphia,1.56,13780,184981,13602,167882,4319,4968,Summer,181662,189300,18570,False
2016,07/17,Philadelphia,1.52,14420,190535,17208,152288,9333,8255,Summer,166708,199868,25463,False
2016,07/10,Philadelphia,1.47,15583,211189,20445,154560,14058,4218,Summer,170143,225247,24663,False
2016,07/03,Philadelphia,1.47,14355,219161,25016,151090,10879,6821,Summer,165445,230040,31837,False
2016,06/26,Philadelphia,1.24,15053,279488,21092,150878,9866,2496,Summer,165931,289354,23588,False
2016,06/19,Philadelphia,1.46,14408,245061,18156,132625,8901,2376,Summer,147033,253962,20532,False
2016,06/12,Philadelphia,1.44,14257,236401,16971,143582,12724,2735,Summer,157839,249125,19706,False
2016,06/05,Philadelphia,1.44,15486,264044,17989,137882,14692,250,Summer,153368,278736,18239,False
2016,05/29,Philadelphia,1.18,15832,300578,17074,129416,21385,0,Spring,145248,321963,17074,False
2016,05/22,Philadelphia,1.2,15264,282262,10911,143071,8469,0,Spring,158335,290731,10911,False
2016,05/15,Philadelphia,1.22,14393,313358,10279,121275,15195,431,Spring,135668,328553,10710,False
2016,05/08,Philadelphia,0.91,20316,511600,16821,137318,12438,105,Spring,157634,524038,16926,False
2016,05/01,Philadelphia,1.21,16264,304614,11522,130517,15349,115,Spring,146781,319963,11637,False
2016,04/24,Philadelphia,1.17,18439,329515,11453,132114,13166,272,Spring,150553,342681,11725,False
2016,04/17,Philadelphia,1.17,17062,199176,5216,129029,15823,140,Spring,146091,214999,5356,False
2016,04/10,Philadelphia,1.17,18475,188452,2461,128214,8406,70,Spring,146689,196858,2531,False
2016,04/03,Philadelphia,1.28,17215,231664,409,112323,9141,0,Spring,129538,240805,409,False
2016,03/27,Philadelphia,1.29,17180,254821,500,135645,9721,0,Spring,152825,264542,500,False
2016,03/20,Philadelphia,1.05,17109,287549,615,230449,7854,0,Spring,247558,295403,615,False
2016,03/13,Philadelphia,1.1,27514,380794,775,115167,9250,0,Spring,142681,390044,775,False
2016,03/06,Philadelphia,1.33,16299,278369,636,112636,9742,3,Spring,128935,288111,639,False
2016,02/28,Philadelphia,1.27,14691,293977,820,100246,10145,0,Winter,114937,304122,820,False
2016,02/21,Philadelphia,1.26,14147,268801,1816,114098,10289,0,Winter,128245,279090,1816,False
2016,02/14,Philadelphia,1.19,15846,283607,1006,132177,12591,0,Winter,148023,296198,1006,False
2016,02/07,Philadelphia,0.96,16403,385630,1418,261473,10906,0,Winter,277876,396536,1418,False
2016,01/31,Philadelphia,1.04,18326,344188,504,97222,9447,0,Winter,115548,353635,504,False
2016,01/24,Philadelphia,1.34,12982,287750,692,134138,13219,0,Winter,147120,300969,692,False
2016,01/17,Philadelphia,1.14,15195,340075,2771,124208,10314,0,Winter,139403,350389,2771,False
2016,01/10,Philadelphia,1.23,14091,271291,700,115949,11192,0,Winter,130040,282483,700,False
2016,01/03,Philadelphia,1.19,13858,309377,918,89684,7254,0,Winter,103542,316631,918,False
2016,12/25,PhoenixTucson,0.64,595085,215902,17008,115069,165813,73,Winter,710154,381715,17081,False
2016,12/18,PhoenixTucson,0.56,733772,203894,14396,135028,148667,444,Winter,868800,352561,14840,False
2016,12/11,PhoenixTucson,0.67,508911,226307,14222,154962,152350,51,Winter,663873,378657,14273,False
2016,12/04,PhoenixTucson,0.63,731182,187418,11915,117120,115108,1281,Winter,848302,302526,13196,False
2016,11/27,PhoenixTucson,0.72,464034,212695,11542,95631,123302,309,Fall,559665,335997,11851,False
2016,11/20,PhoenixTucson,0.7,753470,183315,14661,110584,164013,80,Fall,864054,347328,14741,False
2016,11/13,PhoenixTucson,0.94,437810,189026,15106,106369,163055,0,Fall,544179,352081,15106,False
2016,11/06,PhoenixTucson,1.0,334096,154480,16680,103302,125873,0,Fall,437398,280353,16680,False
2016,10/30,PhoenixTucson,1.11,261889,135479,15843,108153,123199,87,Fall,370042,258678,15930,False
2016,10/23,PhoenixTucson,1.02,250712,188686,16864,127647,115800,0,Fall,378359,304486,16864,False
2016,10/16,PhoenixTucson,1.03,273642,223809,13628,147692,171739,608,Fall,421334,395548,14236,False
2016,10/09,PhoenixTucson,0.99,382978,208869,10640,153973,128733,466,Fall,536951,337602,11106,False
2016,10/02,PhoenixTucson,1.03,345171,206765,11411,130376,121767,220,Fall,475547,328532,11631,False
2016,09/25,PhoenixTucson,1.04,354470,208122,12131,120712,115507,995,Fall,475182,323629,13126,False
2016,09/18,PhoenixTucson,1.0,377761,206297,11915,93337,137426,0,Fall,471098,343723,11915,False
2016,09/11,PhoenixTucson,0.88,504499,216559,11582,123900,105452,3,Fall,628399,322011,11585,False
2016,09/04,PhoenixTucson,0.64,947924,261415,13070,91284,142076,0,Fall,1039208,403491,13070,False
2016,08/28,PhoenixTucson,0.79,590085,207913,10716,103197,112886,0,Summer,693282,320799,10716,False
2016,08/21,PhoenixTucson,0.58,991649,202899,9204,122310,133221,625,Summer,1113959,336120,9829,False
2016,08/14,PhoenixTucson,0.69,795943,228315,11523,136243,153947,0,Summer,932186,382262,11523,False
2016,08/07,PhoenixTucson,0.64,1031124,214144,11938,132055,132129,977,Summer,1163179,346273,12915,False
2016,07/31,PhoenixTucson,1.0,392455,202783,11881,118231,125777,166,Summer,510686,328560,12047,False
2016,07/24,PhoenixTucson,0.94,423672,201696,12392,144445,139836,481,Summer,568117,341532,12873,False
2016,07/17,PhoenixTucson,0.92,410870,188086,11537,145310,108636,75,Summer,556180,296722,11612,False
2016,07/10,PhoenixTucson,0.89,485473,213070,11651,149012,135677,462,Summer,634485,348747,12113,False
2016,07/03,PhoenixTucson,0.77,539428,249521,14795,148736,117119,304,Summer,688164,366640,15099,False
2016,06/26,PhoenixTucson,0.6,848508,230322,16235,151847,113195,58,Summer,1000355,343517,16293,False
2016,06/19,PhoenixTucson,0.62,852657,231636,17320,128068,119121,86,Summer,980725,350757,17406,False
2016,06/12,PhoenixTucson,0.81,471620,222420,22944,151226,123010,0,Summer,622846,345430,22944,False
2016,06/05,PhoenixTucson,0.67,644911,271580,17419,131405,131926,34,Summer,776316,403506,17453,False
2016,05/29,PhoenixTucson,0.58,823222,251166,18217,105242,143894,1081,Spring,928464,395060,19298,False
2016,05/22,PhoenixTucson,0.68,616427,233772,22533,59067,131561,48,Spring,675494,365333,22581,False
2016,05/15,PhoenixTucson,0.55,877701,266908,13478,60965,99187,690,Spring,938666,366095,14168,False
2016,05/08,PhoenixTucson,0.57,941813,325967,29263,80064,109498,2662,Spring,1021877,435465,31925,False
2016,05/01,PhoenixTucson,0.62,657384,324709,14202,109463,72200,38,Spring,766847,396909,14240,False
2016,04/24,PhoenixTucson,0.54,884293,264603,14665,104062,83420,1450,Spring,988355,348023,16115,False
2016,04/17,PhoenixTucson,0.61,662946,286552,14462,93837,108208,0,Spring,756783,394760,14462,False
2016,04/10,PhoenixTucson,0.56,924031,246403,37714,102611,75964,1245,Spring,1026642,322367,38959,False
2016,04/03,PhoenixTucson,0.61,690115,244434,17172,83416,56080,15,Spring,773531,300514,17187,False
2016,03/27,PhoenixTucson,0.54,952967,252486,35478,102042,80965,0,Spring,1055009,333451,35478,False
2016,03/20,PhoenixTucson,0.56,877807,283972,21555,91822,64370,0,Spring,969629,348342,21555,False
2016,03/13,PhoenixTucson,0.64,670917,256531,16153,90790,68717,0,Spring,761707,325248,16153,False
2016,03/06,PhoenixTucson,0.51,1037699,259846,14567,76814,54045,0,Spring,1114513,313891,14567,False
2016,02/28,PhoenixTucson,0.57,816554,311746,22261,69825,69633,0,Winter,886379,381379,22261,False
2016,02/21,PhoenixTucson,0.67,560568,347498,15354,79744,95801,0,Winter,640312,443299,15354,False
2016,02/14,PhoenixTucson,0.61,788381,243842,22140,77572,77920,0,Winter,865953,321762,22140,False
2016,02/07,PhoenixTucson,0.55,1093424,286748,57213,88259,83549,0,Winter,1181683,370297,57213,False
2016,01/31,PhoenixTucson,0.64,663697,293461,21553,83060,51983,0,Winter,746757,345444,21553,False
2016,01/24,PhoenixTucson,0.61,537695,293418,15408,88066,82131,0,Winter,625761,375549,15408,False
2016,01/17,PhoenixTucson,0.71,632962,272231,19499,96088,49193,0,Winter,729050,321424,19499,False
2016,01/10,PhoenixTucson,0.59,868817,252752,12047,91807,50703,0,Winter,960624,303455,12047,False
2016,01/03,PhoenixTucson,0.62,692403,250115,20950,79896,48699,0,Winter,772299,298814,20950,False
2016,12/25,Pittsburgh,1.26,21519,23868,961,30455,3884,0,Winter,51974,27752,961,False
2016,12/18,Pittsburgh,1.02,47067,38353,1974,27858,8301,0,Winter,74925,46654,1974,False
2016,12/11,Pittsburgh,1.21,22587,22461,1185,33381,4529,0,Winter,55968,26990,1185,False
2016,12/04,Pittsburgh,1.27,22112,22668,1314,30145,4345,145,Winter,52257,27013,1459,False
2016,11/27,Pittsburgh,1.27,17971,18776,1117,25667,3915,0,Fall,43638,22691,1117,False
2016,11/20,Pittsburgh,1.27,21811,24291,1050,33341,4732,0,Fall,55152,29023,1050,False
2016,11/13,Pittsburgh,1.26,22929,26629,1041,31047,4657,0,Fall,53976,31286,1041,False
2016,11/06,Pittsburgh,1.25,24892,27433,1137,34250,4944,0,Fall,59142,32377,1137,False
2016,10/30,Pittsburgh,1.25,25336,21347,1150,33736,5198,51,Fall,59072,26545,1201,False
2016,10/23,Pittsburgh,1.3,25223,26247,1185,32229,5482,0,Fall,57452,31729,1185,False
2016,10/16,Pittsburgh,1.27,23294,24183,994,34191,4838,0,Fall,57485,29021,994,False
2016,10/09,Pittsburgh,1.29,24596,27239,953,32322,4395,0,Fall,56918,31634,953,False
2016,10/02,Pittsburgh,1.3,27733,31201,1368,27626,4552,0,Fall,55359,35753,1368,False
2016,09/25,Pittsburgh,1.01,62848,67362,3010,23313,8642,0,Fall,86161,76004,3010,False
2016,09/18,Pittsburgh,1.27,28022,40377,1331,20132,1434,0,Fall,48154,41811,1331,False
2016,09/11,Pittsburgh,1.33,22513,30643,925,24205,1920,0,Fall,46718,32563,925,False
2016,09/04,Pittsburgh,1.23,18723,37833,1349,34860,902,219,Fall,53583,38735,1568,False
2016,08/28,Pittsburgh,1.4,10388,43896,1021,30513,2362,1065,Summer,40901,46258,2086,False
2016,08/21,Pittsburgh,1.42,1802,51710,1003,26056,8896,480,Summer,27858,60606,1483,False
2016,08/14,Pittsburgh,1.42,1543,52111,1001,29043,8460,1255,Summer,30586,60571,2256,False
2016,08/07,Pittsburgh,1.37,1678,53440,1000,27914,10405,3520,Summer,29592,63845,4520,False
2016,07/31,Pittsburgh,1.42,1433,52790,943,27719,10802,863,Summer,29152,63592,1806,False
2016,07/24,Pittsburgh,1.35,1548,55308,1232,31287,10654,4387,Summer,32835,65962,5619,False
2016,07/17,Pittsburgh,1.25,1416,54927,1132,39074,10590,6515,Summer,40490,65517,7647,False
2016,07/10,Pittsburgh,1.29,1536,57549,1294,37858,10065,3610,Summer,39394,67614,4904,False
2016,07/03,Pittsburgh,1.36,1481,68197,1266,40468,11865,4835,Summer,41949,80062,6101,False
2016,06/26,Pittsburgh,1.39,1415,59568,1294,32965,13454,2075,Summer,34380,73022,3369,False
2016,06/19,Pittsburgh,1.42,2063,59252,1172,27767,12371,1500,Summer,29830,71623,2672,False
2016,06/12,Pittsburgh,1.41,3377,56238,1171,28750,11099,1775,Summer,32127,67337,2946,False
2016,06/05,Pittsburgh,1.38,2020,61595,1293,30730,15178,320,Summer,32750,76773,1613,False
2016,05/29,Pittsburgh,1.4,1336,68421,1567,29242,16522,396,Spring,30578,84943,1963,False
2016,05/22,Pittsburgh,1.17,1083,68958,1536,21961,19066,1250,Spring,23044,88024,2786,False
2016,05/15,Pittsburgh,0.87,1504,113018,2930,16500,31690,88,Spring,18004,144708,3018,False
2016,05/08,Pittsburgh,0.89,1847,97359,2818,24483,18304,0,Spring,26330,115663,2818,False
2016,05/01,Pittsburgh,0.92,1981,114448,2935,35865,14253,0,Spring,37846,128701,2935,False
2016,04/24,Pittsburgh,1.02,1300,52354,1239,42500,12026,0,Spring,43800,64380,1239,False
2016,04/17,Pittsburgh,1.17,1300,64912,1800,27639,11618,0,Spring,28939,76530,1800,False
2016,04/10,Pittsburgh,1.18,1736,57325,1600,28213,13807,0,Spring,29949,71132,1600,False
2016,04/03,Pittsburgh,1.26,1591,57684,1735,15060,11919,0,Spring,16651,69603,1735,False
2016,03/27,Pittsburgh,1.15,1246,53507,1504,20111,17237,0,Spring,21357,70744,1504,False
2016,03/20,Pittsburgh,1.17,1457,50816,1224,23273,11110,0,Spring,24730,61926,1224,False
2016,03/13,Pittsburgh,1.17,1630,52730,1333,26767,8651,0,Spring,28397,61381,1333,False
2016,03/06,Pittsburgh,1.18,1555,58262,1403,33427,4900,0,Spring,34982,63162,1403,False
2016,02/28,Pittsburgh,1.21,1210,58767,1383,29726,5395,0,Winter,30936,64162,1383,False
2016,02/21,Pittsburgh,1.23,1353,57902,1371,18779,5348,0,Winter,20132,63250,1371,False
2016,02/14,Pittsburgh,1.14,2425,52891,1332,19080,11498,0,Winter,21505,64389,1332,False
2016,02/07,Pittsburgh,1.18,3398,72083,1740,21916,6666,0,Winter,25314,78749,1740,False
2016,01/31,Pittsburgh,1.22,2259,61619,1456,17454,5763,0,Winter,19713,67382,1456,False
2016,01/24,Pittsburgh,1.2,106,63654,1741,24102,6882,0,Winter,24208,70536,1741,False
2016,01/17,Pittsburgh,1.22,1565,56551,1254,23178,12421,0,Winter,24743,68972,1254,False
2016,01/10,Pittsburgh,1.23,1767,67788,1611,23259,15711,16,Winter,25026,83499,1627,False
2016,01/03,Pittsburgh,1.27,1511,61042,1389,16737,9620,220,Winter,18248,70662,1609,False
2016,12/25,Portland,0.94,104032,135602,13342,272606,44,302,Winter,376638,135646,13644,False
2016,12/18,Portland,0.93,103822,135172,11774,270658,907,164,Winter,374480,136079,11938,False
2016,12/11,Portland,0.7,97136,256730,11762,554442,1653,1297,Winter,651578,258383,13059,False
2016,12/04,Portland,1.0,109778,143749,11803,325918,2557,440,Winter,435696,146306,12243,False
2016,11/27,Portland,1.22,72973,104741,11472,214541,501,158,Fall,287514,105242,11630,False
2016,11/20,Portland,1.23,80040,114101,13948,246808,500,217,Fall,326848,114601,14165,False
2016,11/13,Portland,1.22,90571,119196,15746,261272,376,599,Fall,351843,119572,16345,False
2016,11/06,Portland,1.35,83618,116112,14247,252412,665,377,Fall,336030,116777,14624,False
2016,10/30,Portland,1.4,70232,109965,15009,207419,4075,344,Fall,277651,114040,15353,False
2016,10/23,Portland,1.12,77057,127808,12872,349205,1375,277,Fall,426262,129183,13149,False
2016,10/16,Portland,1.16,106966,107928,13597,329875,5211,145,Fall,436841,113139,13742,False
2016,10/09,Portland,1.08,107796,124430,15502,284345,65755,203,Fall,392141,190185,15705,False
2016,10/02,Portland,0.83,93260,187759,15822,481756,175641,496,Fall,575016,363400,16318,False
2016,09/25,Portland,0.87,122350,123793,16380,324254,107460,49,Fall,446604,231253,16429,False
2016,09/18,Portland,0.94,125312,146731,13568,302546,14940,135,Fall,427858,161671,13703,False
2016,09/11,Portland,0.88,155407,156920,15697,343446,104,242,Fall,498853,157024,15939,False
2016,09/04,Portland,1.01,131619,166648,13319,300935,312,223,Fall,432554,166960,13542,False
2016,08/28,Portland,0.99,119829,173787,12315,315111,336,78,Summer,434940,174123,12393,False
2016,08/21,Portland,0.92,135899,156327,11483,362521,1691,80,Summer,498420,158018,11563,False
2016,08/14,Portland,0.98,134421,139971,15590,331448,1897,299,Summer,465869,141868,15889,False
2016,08/07,Portland,0.96,140180,166749,15567,335811,831,67,Summer,475991,167580,15634,False
2016,07/31,Portland,1.02,135646,130929,15066,324790,1778,402,Summer,460436,132707,15468,False
2016,07/24,Portland,0.97,135877,142590,16246,305237,2006,127,Summer,441114,144596,16373,False
2016,07/17,Portland,0.93,138377,140619,16322,316116,946,190,Summer,454493,141565,16512,False
2016,07/10,Portland,0.98,158448,152086,15965,342068,1006,98,Summer,500516,153092,16063,False
2016,07/03,Portland,0.98,162120,189257,20839,355095,1172,194,Summer,517215,190429,21033,False
2016,06/26,Portland,0.92,139894,158417,19975,340794,1498,1565,Summer,480688,159915,21540,False
2016,06/19,Portland,0.86,154975,168948,19367,337166,1625,596,Summer,492141,170573,19963,False
2016,06/12,Portland,0.85,159711,167508,19531,277038,2380,56,Summer,436749,169888,19587,False
2016,06/05,Portland,0.78,153775,234869,23659,524889,5116,463,Summer,678664,239985,24122,False
2016,05/29,Portland,0.77,145240,204586,19960,459278,3483,320,Spring,604518,208069,20280,False
2016,05/22,Portland,0.78,140269,157857,18037,367615,5623,327,Spring,507884,163480,18364,False
2016,05/15,Portland,0.75,139703,220231,18398,491056,14194,1197,Spring,630759,234425,19595,False
2016,05/08,Portland,0.75,155346,244456,20852,544998,3539,588,Spring,700344,247995,21440,False
2016,05/01,Portland,0.76,148329,219777,18792,461966,2894,359,Spring,610295,222671,19151,False
2016,04/24,Portland,0.79,147879,194071,18734,349814,3823,51,Spring,497693,197894,18785,False
2016,04/17,Portland,0.69,80084,285327,20489,518252,12155,1379,Spring,598336,297482,21868,False
2016,04/10,Portland,0.88,115155,233413,21804,309162,150,1746,Spring,424317,233563,23550,False
2016,04/03,Portland,0.79,89147,249613,23098,442760,1405,239,Spring,531907,251018,23337,False
2016,03/27,Portland,0.71,82569,247868,17851,455581,2381,333,Spring,538150,250249,18184,False
2016,03/20,Portland,0.94,89989,177624,17767,269468,1435,215,Spring,359457,179059,17982,False
2016,03/13,Portland,0.79,89366,223410,19425,415276,2895,361,Spring,504642,226305,19786,False
2016,03/06,Portland,0.83,93795,207462,32885,434179,841,332,Spring,527974,208303,33217,False
2016,02/28,Portland,0.83,83579,209750,18299,411116,2953,228,Winter,494695,212703,18527,False
2016,02/21,Portland,0.71,65380,277280,14447,439612,26245,218,Winter,504992,303525,14665,False
2016,02/14,Portland,0.87,98599,169228,15639,283183,392,134,Winter,381782,169620,15773,False
2016,02/07,Portland,0.72,90313,340413,17669,498461,1358,622,Winter,588774,341771,18291,False
2016,01/31,Portland,0.88,83566,223504,18005,346063,1781,1452,Winter,429629,225285,19457,False
2016,01/24,Portland,0.9,60000,208201,17305,307475,3800,206,Winter,367475,212001,17511,False
2016,01/17,Portland,0.87,91788,249094,16915,366756,6677,152,Winter,458544,255771,17067,False
2016,01/10,Portland,0.88,100449,241994,20422,363944,4247,543,Winter,464393,246241,20965,False
2016,01/03,Portland,0.75,101180,291667,22086,402710,11447,970,Winter,503890,303114,23056,False
2016,12/25,RaleighGreensboro,1.24,57636,63983,6997,76469,2793,161,Winter,134105,66776,7158,False
2016,12/18,RaleighGreensboro,1.26,60411,60081,8199,66189,2173,0,Winter,126600,62254,8199,False
2016,12/11,RaleighGreensboro,1.24,77872,51720,8646,75275,1623,0,Winter,153147,53343,8646,False
2016,12/04,RaleighGreensboro,1.31,80765,51555,8087,71739,3930,0,Winter,152504,55485,8087,False
2016,11/27,RaleighGreensboro,1.49,64281,41537,6927,61452,1562,0,Fall,125733,43099,6927,False
2016,11/20,RaleighGreensboro,1.56,66026,40837,11043,63280,1846,293,Fall,129306,42683,11336,False
2016,11/13,RaleighGreensboro,1.47,87802,39962,22904,58852,1886,0,Fall,146654,41848,22904,False
2016,11/06,RaleighGreensboro,1.53,79225,42184,25755,66193,1987,0,Fall,145418,44171,25755,False
2016,10/30,RaleighGreensboro,1.42,84333,42819,23850,59019,1933,0,Fall,143352,44752,23850,False
2016,10/23,RaleighGreensboro,1.4,88588,53189,21782,74210,1668,305,Fall,162798,54857,22087,False
2016,10/16,RaleighGreensboro,1.37,91951,64317,17584,70168,3635,0,Fall,162119,67952,17584,False
2016,10/09,RaleighGreensboro,1.39,85813,67026,20238,77169,3278,568,Fall,162982,70304,20806,False
2016,10/02,RaleighGreensboro,1.36,81422,79271,17415,79781,3059,936,Fall,161203,82330,18351,False
2016,09/25,RaleighGreensboro,1.35,88405,70494,15699,77829,2614,0,Fall,166234,73108,15699,False
2016,09/18,RaleighGreensboro,1.27,92754,82984,15056,82483,4723,127,Fall,175237,87707,15183,False
2016,09/11,RaleighGreensboro,1.31,55464,81087,19102,88122,4475,5,Fall,143586,85562,19107,False
2016,09/04,RaleighGreensboro,1.27,90299,90747,19654,84861,1764,0,Fall,175160,92511,19654,False
2016,08/28,RaleighGreensboro,1.29,88767,100303,13156,77895,434,1201,Summer,166662,100737,14357,False
2016,08/21,RaleighGreensboro,1.29,67590,102580,21071,87548,299,0,Summer,155138,102879,21071,False
2016,08/14,RaleighGreensboro,1.27,69869,113633,23428,86927,1447,0,Summer,156796,115080,23428,False
2016,08/07,RaleighGreensboro,1.31,64077,115112,25307,71564,3510,970,Summer,135641,118622,26277,False
2016,07/31,RaleighGreensboro,1.33,59207,116645,25331,68455,1258,3052,Summer,127662,117903,28383,False
2016,07/24,RaleighGreensboro,1.31,52638,114295,26360,77643,3640,4580,Summer,130281,117935,30940,False
2016,07/17,RaleighGreensboro,1.28,47084,109983,29372,82748,685,9568,Summer,129832,110668,38940,False
2016,07/10,RaleighGreensboro,1.2,43145,124463,42699,80207,2107,10935,Summer,123352,126570,53634,False
2016,07/03,RaleighGreensboro,1.14,64011,107878,44752,79393,1461,9717,Summer,143404,109339,54469,False
2016,06/26,RaleighGreensboro,1.12,63248,110539,43580,77775,657,1750,Summer,141023,111196,45330,False
2016,06/19,RaleighGreensboro,1.12,69174,116061,48615,78077,958,870,Summer,147251,117019,49485,False
2016,06/12,RaleighGreensboro,1.09,61649,111257,47593,75397,408,2211,Summer,137046,111665,49804,False
2016,06/05,RaleighGreensboro,1.11,69779,115207,42240,78796,800,1225,Summer,148575,116007,43465,False
2016,05/29,RaleighGreensboro,1.18,56828,118782,41393,77273,834,245,Spring,134101,119616,41638,False
2016,05/22,RaleighGreensboro,1.16,58844,123522,19570,85455,307,675,Spring,144299,123829,20245,False
2016,05/15,RaleighGreensboro,1.1,57225,131575,15602,86768,1193,1154,Spring,143993,132768,16756,False
2016,05/08,RaleighGreensboro,1.07,56914,154919,16994,86964,1553,1177,Spring,143878,156472,18171,False
2016,05/01,RaleighGreensboro,1.06,77783,143133,17389,86752,1406,2,Spring,164535,144539,17391,False
2016,04/24,RaleighGreensboro,1.07,69533,135696,18008,87008,1191,0,Spring,156541,136887,18008,False
2016,04/17,RaleighGreensboro,1.11,47754,137649,17999,80748,733,9,Spring,128502,138382,18008,False
2016,04/10,RaleighGreensboro,1.09,62706,112390,16301,81149,1688,9,Spring,143855,114078,16310,False
2016,04/03,RaleighGreensboro,1.13,60612,113708,14035,73697,755,0,Spring,134309,114463,14035,False
2016,03/27,RaleighGreensboro,1.14,44251,129664,15425,70533,612,0,Spring,114784,130276,15425,False
2016,03/20,RaleighGreensboro,1.13,57433,140113,17215,73376,726,0,Spring,130809,140839,17215,False
2016,03/13,RaleighGreensboro,1.08,65417,142777,20693,73420,1470,0,Spring,138837,144247,20693,False
2016,03/06,RaleighGreensboro,1.08,66431,140242,22198,68588,626,0,Spring,135019,140868,22198,False
2016,02/28,RaleighGreensboro,1.08,59637,136706,19136,63934,1646,0,Winter,123571,138352,19136,False
2016,02/21,RaleighGreensboro,1.05,55054,118359,19436,69867,431,0,Winter,124921,118790,19436,False
2016,02/14,RaleighGreensboro,0.99,71137,118416,18499,73208,2699,0,Winter,144345,121115,18499,False
2016,02/07,RaleighGreensboro,0.86,82796,207314,41708,66876,5151,2,Winter,149672,212465,41710,False
2016,01/31,RaleighGreensboro,0.96,61313,145758,26481,52157,4923,0,Winter,113470,150681,26481,False
2016,01/24,RaleighGreensboro,0.96,20211,135264,26788,59121,1127,0,Winter,79332,136391,26788,False
2016,01/17,RaleighGreensboro,1.0,47604,140274,27591,56176,601,0,Winter,103780,140875,27591,False
2016,01/10,RaleighGreensboro,0.99,42069,120386,29658,64396,1479,0,Winter,106465,121865,29658,False
2016,01/03,RaleighGreensboro,0.92,65934,127743,29344,56645,667,0,Winter,122579,128410,29344,False
2016,12/25,RichmondNorfolk,1.2,57197,58578,2184,57397,745,0,Winter,114594,59323,2184,False
2016,12/18,RichmondNorfolk,1.15,64259,54299,2892,51586,1171,0,Winter,115845,55470,2892,False
2016,12/11,RichmondNorfolk,1.1,67313,51724,2894,63970,591,0,Winter,131283,52315,2894,False
2016,12/04,RichmondNorfolk,1.18,82393,49249,2714,49474,40,0,Winter,131867,49289,2714,False
2016,11/27,RichmondNorfolk,1.21,47392,48587,2115,56074,29,0,Fall,103466,48616,2115,False
2016,11/20,RichmondNorfolk,1.29,61550,49335,3168,63057,0,0,Fall,124607,49335,3168,False
2016,11/13,RichmondNorfolk,1.33,81429,47266,4975,43970,0,0,Fall,125399,47266,4975,False
2016,11/06,RichmondNorfolk,1.39,73480,43301,6292,46648,0,0,Fall,120128,43301,6292,False
2016,10/30,RichmondNorfolk,1.28,80899,43431,5927,44106,33,3,Fall,125005,43464,5930,False
2016,10/23,RichmondNorfolk,1.34,70435,54871,5858,46850,497,0,Fall,117285,55368,5858,False
2016,10/16,RichmondNorfolk,1.28,75896,67555,4957,53622,1057,0,Fall,129518,68612,4957,False
2016,10/09,RichmondNorfolk,1.25,90443,66361,4535,51541,578,0,Fall,141984,66939,4535,False
2016,10/02,RichmondNorfolk,1.19,95732,68003,5204,59496,901,0,Fall,155228,68904,5204,False
2016,09/25,RichmondNorfolk,1.27,88120,66843,4599,51224,4,0,Fall,139344,66847,4599,False
2016,09/18,RichmondNorfolk,1.18,99451,78464,4204,54657,2070,0,Fall,154108,80534,4204,False
2016,09/11,RichmondNorfolk,1.13,96272,71790,5966,63212,3389,0,Fall,159484,75179,5966,False
2016,09/04,RichmondNorfolk,1.11,100753,86557,6483,69754,113,160,Fall,170507,86670,6643,False
2016,08/28,RichmondNorfolk,1.06,87612,85621,5087,70265,178,1670,Summer,157877,85799,6757,False
2016,08/21,RichmondNorfolk,1.11,86900,84501,6791,57801,79,275,Summer,144701,84580,7066,False
2016,08/14,RichmondNorfolk,1.12,89131,80717,8138,69444,108,60,Summer,158575,80825,8198,False
2016,08/07,RichmondNorfolk,1.1,98312,93057,8281,60015,4302,2205,Summer,158327,97359,10486,False
2016,07/31,RichmondNorfolk,1.17,85721,86666,9342,60284,2603,755,Summer,146005,89269,10097,False
2016,07/24,RichmondNorfolk,1.07,96397,91585,9256,64454,6622,4410,Summer,160851,98207,13666,False
2016,07/17,RichmondNorfolk,1.06,82855,92471,9386,69396,683,9460,Summer,152251,93154,18846,False
2016,07/10,RichmondNorfolk,1.02,87547,117236,12340,69248,2121,8115,Summer,156795,119357,20455,False
2016,07/03,RichmondNorfolk,0.99,89753,116413,14142,77055,0,8035,Summer,166808,116413,22177,False
2016,06/26,RichmondNorfolk,1.0,74356,104881,13640,61487,26,4890,Summer,135843,104907,18530,False
2016,06/19,RichmondNorfolk,0.99,67619,122627,15409,67694,83,4745,Summer,135313,122710,20154,False
2016,06/12,RichmondNorfolk,0.96,83555,108482,15693,69331,158,2970,Summer,152886,108640,18663,False
2016,06/05,RichmondNorfolk,0.98,67444,117809,13829,66487,784,2420,Summer,133931,118593,16249,False
2016,05/29,RichmondNorfolk,1.0,81287,106696,14413,68403,746,2555,Spring,149690,107442,16968,False
2016,05/22,RichmondNorfolk,0.96,79353,105907,5994,78267,6,2450,Spring,157620,105913,8444,False
2016,05/15,RichmondNorfolk,1.0,63701,121474,5701,59227,152,94,Spring,122928,121626,5795,False
2016,05/08,RichmondNorfolk,0.9,89111,158033,6247,78934,1724,69,Spring,168045,159757,6316,False
2016,05/01,RichmondNorfolk,0.95,67526,132271,6670,77132,2,56,Spring,144658,132273,6726,False
2016,04/24,RichmondNorfolk,0.98,73890,118253,6402,74660,2,0,Spring,148550,118255,6402,False
2016,04/17,RichmondNorfolk,0.99,58573,119481,6469,67277,1,0,Spring,125850,119482,6469,False
2016,04/10,RichmondNorfolk,1.01,60884,82433,6103,70654,0,24,Spring,131538,82433,6127,False
2016,04/03,RichmondNorfolk,1.03,58169,74249,5176,52393,0,0,Spring,110562,74249,5176,False
2016,03/27,RichmondNorfolk,1.02,61031,109864,4986,57703,5,13,Spring,118734,109869,4999,False
2016,03/20,RichmondNorfolk,0.99,65822,127367,5712,65341,3,0,Spring,131163,127370,5712,False
2016,03/13,RichmondNorfolk,1.02,53660,125742,6975,59722,9,0,Spring,113382,125751,6975,False
2016,03/06,RichmondNorfolk,0.99,69078,117735,7265,61329,9,0,Spring,130407,117744,7265,False
2016,02/28,RichmondNorfolk,1.04,68025,107712,6324,47964,233,0,Winter,115989,107945,6324,False
2016,02/21,RichmondNorfolk,0.98,57431,101387,5839,46939,3027,0,Winter,104370,104414,5839,False
2016,02/14,RichmondNorfolk,0.92,69755,118256,4864,58227,3507,0,Winter,127982,121763,4864,False
2016,02/07,RichmondNorfolk,0.78,145746,168148,11393,65402,3770,0,Winter,211148,171918,11393,False
2016,01/31,RichmondNorfolk,0.98,52910,115933,7356,43577,2637,0,Winter,96487,118570,7356,False
2016,01/24,RichmondNorfolk,0.97,81685,131405,7716,50993,513,0,Winter,132678,131918,7716,False
2016,01/17,RichmondNorfolk,0.97,102087,115257,8461,46788,0,0,Winter,148875,115257,8461,False
2016,01/10,RichmondNorfolk,0.97,81955,97007,8835,55900,6,0,Winter,137855,97013,8835,False
2016,01/03,RichmondNorfolk,0.96,79192,102411,8338,45411,264,0,Winter,124603,102675,8338,False
2016,12/25,Roanoke,1.16,27393,28263,95,47522,529,0,Winter,74915,28792,95,False
2016,12/18,Roanoke,1.15,29593,26460,125,35874,1052,0,Winter,65467,27512,125,False
2016,12/11,Roanoke,1.04,36799,27761,129,47917,786,0,Winter,84716,28547,129,False
2016,12/04,Roanoke,1.17,43234,26047,160,35680,486,122,Winter,78914,26533,282,False
2016,11/27,Roanoke,1.31,23710,23786,86,34948,286,0,Fall,58658,24072,86,False
2016,11/20,Roanoke,1.33,31583,25266,88,41990,304,0,Fall,73573,25570,88,False
2016,11/13,Roanoke,1.41,36639,25755,133,35306,240,0,Fall,71945,25995,133,False
2016,11/06,Roanoke,1.39,39065,23895,156,40762,290,0,Fall,79827,24185,156,False
2016,10/30,Roanoke,1.26,43905,21234,183,39530,754,0,Fall,83435,21988,183,False
2016,10/23,Roanoke,1.26,40459,29276,171,35715,1607,0,Fall,76174,30883,171,False
2016,10/16,Roanoke,1.22,42680,32596,130,43935,2448,0,Fall,86615,35044,130,False
2016,10/09,Roanoke,1.23,46103,34296,198,35482,2853,0,Fall,81585,37149,198,False
2016,10/02,Roanoke,1.13,48667,35464,183,45781,3084,0,Fall,94448,38548,183,False
2016,09/25,Roanoke,1.07,50868,39269,116,51504,372,0,Fall,102372,39641,116,False
2016,09/18,Roanoke,1.06,57840,38597,92,43287,4444,10,Fall,101127,43041,102,False
2016,09/11,Roanoke,1.02,59141,38349,164,52831,6321,25,Fall,111972,44670,189,False
2016,09/04,Roanoke,1.01,51973,42949,107,64633,2359,335,Fall,116606,45308,442,False
2016,08/28,Roanoke,1.03,48406,43349,108,59304,1999,1860,Summer,107710,45348,1968,False
2016,08/21,Roanoke,1.04,45315,46239,64,52711,2759,870,Summer,98026,48998,934,False
2016,08/14,Roanoke,1.04,42321,41576,89,57870,3331,125,Summer,100191,44907,214,False
2016,08/07,Roanoke,1.04,43871,45988,170,42151,9020,965,Summer,86022,55008,1135,False
2016,07/31,Roanoke,1.07,44288,43886,92,49803,4396,600,Summer,94091,48282,692,False
2016,07/24,Roanoke,1.04,45204,41843,61,49239,9662,4115,Summer,94443,51505,4176,False
2016,07/17,Roanoke,1.04,42725,45126,138,49605,1761,5590,Summer,92330,46887,5728,False
2016,07/10,Roanoke,1.01,46152,54601,140,47150,5153,5763,Summer,93302,59754,5903,False
2016,07/03,Roanoke,0.99,42474,55215,153,59666,1708,5365,Summer,102140,56923,5518,False
2016,06/26,Roanoke,1.02,37010,52754,110,48166,4,3360,Summer,85176,52758,3470,False
2016,06/19,Roanoke,1.0,38806,58287,134,57154,32,3810,Summer,95960,58319,3944,False
2016,06/12,Roanoke,0.99,41650,52625,144,54131,277,3319,Summer,95781,52902,3463,False
2016,06/05,Roanoke,0.96,39705,56076,113,53294,747,1435,Summer,92999,56823,1548,False
2016,05/29,Roanoke,0.93,51556,52308,199,56109,1204,1239,Spring,107665,53512,1438,False
2016,05/22,Roanoke,0.9,55226,50049,230,62687,1307,1687,Spring,117913,51356,1917,False
2016,05/15,Roanoke,0.94,41009,55894,199,42432,2073,106,Spring,83441,57967,305,False
2016,05/08,Roanoke,0.87,46723,76766,277,56454,4373,0,Spring,103177,81139,277,False
2016,05/01,Roanoke,0.87,42590,71617,715,61577,1986,0,Spring,104167,73603,715,False
2016,04/24,Roanoke,0.91,42884,57628,97,60645,3145,9,Spring,103529,60773,106,False
2016,04/17,Roanoke,0.93,38226,59221,100,51084,2273,3,Spring,89310,61494,103,False
2016,04/10,Roanoke,0.93,41262,31989,135,58125,1834,33,Spring,99387,33823,168,False
2016,04/03,Roanoke,0.97,37271,32720,169,41615,1252,0,Spring,78886,33972,169,False
2016,03/27,Roanoke,0.96,45215,50007,72,43175,1198,0,Spring,88390,51205,72,False
2016,03/20,Roanoke,0.96,52022,55818,140,48248,54,0,Spring,100270,55872,140,False
2016,03/13,Roanoke,0.99,37199,57106,147,44871,335,0,Spring,82070,57441,147,False
2016,03/06,Roanoke,0.98,49400,51284,111,39867,1362,0,Spring,89267,52646,111,False
2016,02/28,Roanoke,0.99,52420,48195,149,33709,1148,0,Winter,86129,49343,149,False
2016,02/21,Roanoke,0.98,32921,45911,102,33666,3273,0,Winter,66587,49184,102,False
2016,02/14,Roanoke,0.9,47759,55674,185,52052,4085,0,Winter,99811,59759,185,False
2016,02/07,Roanoke,0.91,60920,79535,179,53859,3517,0,Winter,114779,83052,179,False
2016,01/31,Roanoke,0.99,32756,52095,135,34167,2323,0,Winter,66923,54418,135,False
2016,01/24,Roanoke,0.99,47641,55634,180,39026,162,370,Winter,86667,55796,550,False
2016,01/17,Roanoke,0.98,64687,51993,98,40764,0,73,Winter,105451,51993,171,False
2016,01/10,Roanoke,0.97,55844,42998,178,44595,17,70,Winter,100439,43015,248,False
2016,01/03,Roanoke,0.91,59481,58348,182,37521,31,1133,Winter,97002,58379,1315,False
2016,12/25,Sacramento,1.07,119611,263467,811,39136,2868,2352,Winter,158747,266335,3163,False
2016,12/18,Sacramento,1.04,125324,218206,887,32583,5207,2240,Winter,157907,223413,3127,False
2016,12/11,Sacramento,1.03,106959,275886,1253,43426,5504,1537,Winter,150385,281390,2790,False
2016,12/04,Sacramento,1.29,110569,156812,1306,45560,382,1325,Winter,156129,157194,2631,False
2016,11/27,Sacramento,1.43,89558,150298,1111,35372,716,2275,Fall,124930,151014,3386,False
2016,11/20,Sacramento,1.53,94610,151992,1201,41822,141,5,Fall,136432,152133,1206,False
2016,11/13,Sacramento,1.62,93242,144958,1255,38273,5,0,Fall,131515,144963,1255,False
2016,11/06,Sacramento,1.78,93518,137695,1450,33675,5,0,Fall,127193,137700,1450,False
2016,10/30,Sacramento,1.79,97713,118831,1177,20196,435,345,Fall,117909,119266,1522,False
2016,10/23,Sacramento,1.59,82312,127356,1930,36824,2029,2710,Fall,119136,129385,4640,False
2016,10/16,Sacramento,1.61,102990,180666,2661,41539,1035,1320,Fall,144529,181701,3981,False
2016,10/09,Sacramento,1.49,133617,190297,4510,41780,206,10,Fall,175397,190503,4520,False
2016,10/02,Sacramento,1.35,136133,191756,4079,48791,0,1231,Fall,184924,191756,5310,False
2016,09/25,Sacramento,1.34,135264,230423,3263,46655,704,3763,Fall,181919,231127,7026,False
2016,09/18,Sacramento,1.39,124962,234689,3771,40849,1176,2363,Fall,165811,235865,6134,False
2016,09/11,Sacramento,1.34,140888,229037,4350,57595,0,600,Fall,198483,229037,4950,False
2016,09/04,Sacramento,1.32,153239,247684,4575,66372,2,215,Fall,219611,247686,4790,False
2016,08/28,Sacramento,1.33,150624,225695,5537,39589,5,130,Summer,190213,225700,5667,False
2016,08/21,Sacramento,1.27,181120,217955,10652,46759,8,258,Summer,227879,217963,10910,False
2016,08/14,Sacramento,1.19,154532,299818,14039,44453,0,0,Summer,198985,299818,14039,False
2016,08/07,Sacramento,1.37,149607,239914,13055,51032,13,0,Summer,200639,239927,13055,False
2016,07/31,Sacramento,1.4,140605,255278,16262,53547,10,390,Summer,194152,255288,16652,False
2016,07/24,Sacramento,1.42,123359,253984,18157,55394,0,0,Summer,178753,253984,18157,False
2016,07/17,Sacramento,1.31,150251,237468,16900,67069,8,0,Summer,217320,237476,16900,False
2016,07/10,Sacramento,1.26,164624,231260,20004,72950,8,250,Summer,237574,231268,20254,False
2016,07/03,Sacramento,1.24,163405,303029,24533,74049,0,0,Summer,237454,303029,24533,False
2016,06/26,Sacramento,1.25,147821,228939,20249,66812,0,623,Summer,214633,228939,20872,False
2016,06/19,Sacramento,1.2,157354,276855,18508,54341,0,975,Summer,211695,276855,19483,False
2016,06/12,Sacramento,1.15,158599,263137,22373,56671,13,365,Summer,215270,263150,22738,False
2016,06/05,Sacramento,1.17,169293,269555,25618,56921,18,0,Summer,226214,269573,25618,False
2016,05/29,Sacramento,1.18,166777,252374,18823,51287,4,70,Spring,218064,252378,18893,False
2016,05/22,Sacramento,1.1,156352,253576,20549,55547,0,2173,Spring,211899,253576,22722,False
2016,05/15,Sacramento,1.17,137852,224842,27155,48442,7,8,Spring,186294,224849,27163,False
2016,05/08,Sacramento,1.0,171748,307614,19761,69357,5,1222,Spring,241105,307619,20983,False
2016,05/01,Sacramento,1.06,158376,251468,16678,54906,106,325,Spring,213282,251574,17003,False
2016,04/24,Sacramento,1.01,173546,281110,18901,55978,0,280,Spring,229524,281110,19181,False
2016,04/17,Sacramento,1.15,158323,210773,21378,57218,61,326,Spring,215541,210834,21704,False
2016,04/10,Sacramento,1.15,152169,227080,22372,57376,20,322,Spring,209545,227100,22694,False
2016,04/03,Sacramento,1.05,128563,284764,21875,53306,37,0,Spring,181869,284801,21875,False
2016,03/27,Sacramento,1.18,129399,248862,20119,60509,8,0,Spring,189908,248870,20119,False
2016,03/20,Sacramento,1.18,128297,203155,19762,53491,26,2,Spring,181788,203181,19764,False
2016,03/13,Sacramento,1.14,139305,227493,18205,56309,0,20,Spring,195614,227493,18225,False
2016,03/06,Sacramento,1.13,136469,216299,19505,71097,5,8,Spring,207566,216304,19513,False
2016,02/28,Sacramento,1.13,133683,213422,21516,70657,0,0,Winter,204340,213422,21516,False
2016,02/21,Sacramento,1.09,124241,219980,17229,58022,5,0,Winter,182263,219985,17229,False
2016,02/14,Sacramento,1.04,143312,207645,17758,79168,17,43,Winter,222480,207662,17801,False
2016,02/07,Sacramento,0.91,259382,419044,34235,83768,55,37,Winter,343150,419099,34272,False
2016,01/31,Sacramento,1.13,145374,209170,19002,60564,5,2,Winter,205938,209175,19004,False
2016,01/24,Sacramento,1.11,55327,278223,18007,57734,32,0,Winter,113061,278255,18007,False
2016,01/17,Sacramento,1.11,105468,256283,15555,60045,0,2,Winter,165513,256283,15557,False
2016,01/10,Sacramento,1.08,122362,229930,15444,66489,11,0,Winter,188851,229941,15444,False
2016,01/03,Sacramento,0.96,141161,301172,16053,53729,0,0,Winter,194890,301172,16053,False
2016,12/25,SanDiego,0.89,118030,191754,14438,125660,22080,1765,Winter,243690,213834,16203,False
2016,12/18,SanDiego,0.9,106000,161104,14145,115858,38951,1110,Winter,221858,200055,15255,False
2016,12/11,SanDiego,0.81,139066,205742,14736,91917,53237,421,Winter,230983,258979,15157,False
2016,12/04,SanDiego,0.85,214063,133318,15081,128681,6275,1723,Winter,342744,139593,16804,False
2016,11/27,SanDiego,1.08,160595,108871,12510,98751,10626,935,Fall,259346,119497,13445,False
2016,11/20,SanDiego,1.25,135337,120005,14499,85261,14192,385,Fall,220598,134197,14884,False
2016,11/13,SanDiego,1.37,120524,126173,18445,74992,13258,435,Fall,195516,139431,18880,False
2016,11/06,SanDiego,1.68,89364,128356,18569,46336,8804,868,Fall,135700,137160,19437,False
2016,10/30,SanDiego,1.65,88975,119080,14742,41712,6337,95,Fall,130687,125417,14837,False
2016,10/23,SanDiego,1.32,127391,119290,13215,91095,13109,1924,Fall,218486,132399,15139,False
2016,10/16,SanDiego,1.27,133020,139616,14087,137002,16987,2653,Fall,270022,156603,16740,False
2016,10/09,SanDiego,1.25,143507,142805,15433,150537,20262,500,Fall,294044,163067,15933,False
2016,10/02,SanDiego,1.09,209855,131355,17065,159927,15812,785,Fall,369782,147167,17850,False
2016,09/25,SanDiego,1.05,217679,136015,15808,182692,12821,1071,Fall,400371,148836,16879,False
2016,09/18,SanDiego,1.18,147766,139189,12716,144313,11857,1354,Fall,292079,151046,14070,False
2016,09/11,SanDiego,1.08,164685,144231,12611,161784,15187,55,Fall,326469,159418,12666,False
2016,09/04,SanDiego,1.06,186260,164050,12126,177175,10942,201,Fall,363435,174992,12327,False
2016,08/28,SanDiego,0.9,244514,145515,14632,204056,10854,468,Summer,448570,156369,15100,False
2016,08/21,SanDiego,0.94,227977,127819,13817,194536,14380,98,Summer,422513,142199,13915,False
2016,08/14,SanDiego,1.19,151194,164960,17324,149733,15841,0,Summer,300927,180801,17324,False
2016,08/07,SanDiego,1.14,164926,168655,17490,163646,20236,0,Summer,328572,188891,17490,False
2016,07/31,SanDiego,1.16,156893,167605,18152,156662,23324,40,Summer,313555,190929,18192,False
2016,07/24,SanDiego,1.18,168729,168789,22671,147604,18132,730,Summer,316333,186921,23401,False
2016,07/17,SanDiego,1.12,169871,161029,23096,144223,20474,871,Summer,314094,181503,23967,False
2016,07/10,SanDiego,0.98,186258,204704,20782,171944,19129,1261,Summer,358202,223833,22043,False
2016,07/03,SanDiego,1.04,182471,186674,29141,192454,20162,2101,Summer,374925,206836,31242,False
2016,06/26,SanDiego,0.89,196595,163147,28460,189495,17484,733,Summer,386090,180631,29193,False
2016,06/19,SanDiego,0.98,182110,160231,28933,183995,17443,1116,Summer,366105,177674,30049,False
2016,06/12,SanDiego,0.88,216162,144195,26931,189261,19728,355,Summer,405423,163923,27286,False
2016,06/05,SanDiego,0.83,242212,171998,31852,175831,39014,250,Summer,418043,211012,32102,False
2016,05/29,SanDiego,0.92,183028,168419,32042,160356,31715,980,Spring,343384,200134,33022,False
2016,05/22,SanDiego,0.78,157623,205497,20406,154279,30337,1205,Spring,311902,235834,21611,False
2016,05/15,SanDiego,0.86,196229,169362,19467,133555,35091,0,Spring,329784,204453,19467,False
2016,05/08,SanDiego,0.78,210276,194613,24705,82058,137623,226,Spring,292334,332236,24931,False
2016,05/01,SanDiego,0.68,221162,221265,23602,57334,155614,233,Spring,278496,376879,23835,False
2016,04/24,SanDiego,0.73,209423,193980,22783,128655,68644,0,Spring,338078,262624,22783,False
2016,04/17,SanDiego,0.8,219230,155882,22416,199325,24495,0,Spring,418555,180377,22416,False
2016,04/10,SanDiego,0.84,190244,158653,21394,175064,44337,0,Spring,365308,202990,21394,False
2016,04/03,SanDiego,0.9,165482,148671,25760,136889,50311,0,Spring,302371,198982,25760,False
2016,03/27,SanDiego,0.8,183067,162858,23076,180500,66077,0,Spring,363567,228935,23076,False
2016,03/20,SanDiego,0.76,159593,189449,21444,228122,51304,0,Spring,387715,240753,21444,False
2016,03/13,SanDiego,0.84,151219,139500,23806,203378,50047,0,Spring,354597,189547,23806,False
2016,03/06,SanDiego,0.81,160581,156090,22297,218488,69940,0,Spring,379069,226030,22297,False
2016,02/28,SanDiego,0.8,143189,144667,25138,201892,70804,0,Winter,345081,215471,25138,False
2016,02/21,SanDiego,0.86,165757,159025,19779,206855,40779,0,Winter,372612,199804,19779,False
2016,02/14,SanDiego,0.79,173874,140454,22029,161727,97328,0,Winter,335601,237782,22029,False
2016,02/07,SanDiego,0.61,212980,302238,23694,292228,86517,0,Winter,505208,388755,23694,False
2016,01/31,SanDiego,0.72,174249,192217,18036,219631,39190,0,Winter,393880,231407,18036,False
2016,01/24,SanDiego,0.85,104831,157896,21607,238110,42191,0,Winter,342941,200087,21607,False
2016,01/17,SanDiego,0.79,164565,190461,19123,141951,45611,0,Winter,306516,236072,19123,False
2016,01/10,SanDiego,0.81,155537,153030,21523,144796,103723,0,Winter,300333,256753,21523,False
2016,01/03,SanDiego,0.65,204145,256691,22617,138815,97480,0,Winter,342960,354171,22617,False
2016,12/25,SanFrancisco,1.18,164595,462872,2525,52277,7459,295,Winter,216872,470331,2820,False
2016,12/18,SanFrancisco,1.22,173909,401462,3063,52370,11823,889,Winter,226279,413285,3952,False
2016,12/11,SanFrancisco,1.29,134467,447891,2861,58673,10578,954,Winter,193140,458469,3815,False
2016,12/04,SanFrancisco,1.52,159831,310592,2249,67734,1143,1304,Winter,227565,311735,3553,False
2016,11/27,SanFrancisco,1.75,118187,297882,2393,67676,1584,655,Fall,185863,299466,3048,False
2016,11/20,SanFrancisco,1.89,120582,308963,2239,74502,1192,3271,Fall,195084,310155,5510,False
2016,11/13,SanFrancisco,1.94,118820,308678,3208,74569,976,290,Fall,193389,309654,3498,False
2016,11/06,SanFrancisco,2.07,109080,304926,3840,74025,103,529,Fall,183105,305029,4369,False
2016,10/30,SanFrancisco,2.2,130025,285048,3399,57223,269,1972,Fall,187248,285317,5371,False
2016,10/23,SanFrancisco,1.87,133676,178795,4817,89533,2966,2084,Fall,223209,181761,6901,False
2016,10/16,SanFrancisco,1.99,141221,362859,7787,74349,3259,1058,Fall,215570,366118,8845,False
2016,10/09,SanFrancisco,1.82,163264,409307,9771,89663,1055,19,Fall,252927,410362,9790,False
2016,10/02,SanFrancisco,1.52,196085,421421,10626,101544,1167,1148,Fall,297629,422588,11774,False
2016,09/25,SanFrancisco,1.43,210602,549378,7878,89785,1571,1330,Fall,300387,550949,9208,False
2016,09/18,SanFrancisco,1.5,173635,549722,9254,75829,3098,2035,Fall,249464,552820,11289,False
2016,09/11,SanFrancisco,1.43,222298,533967,11292,94338,691,143,Fall,316636,534658,11435,False
2016,09/04,SanFrancisco,1.47,203090,552428,10836,82334,962,451,Fall,285424,553390,11287,False
2016,08/28,SanFrancisco,1.38,258578,469333,13522,68675,990,1311,Summer,327253,470323,14833,False
2016,08/21,SanFrancisco,1.28,311234,415962,24855,70853,856,1576,Summer,382087,416818,26431,False
2016,08/14,SanFrancisco,1.03,266260,757100,31009,58400,900,1162,Summer,324660,758000,32171,False
2016,08/07,SanFrancisco,1.49,189861,463372,28987,70181,869,297,Summer,260042,464241,29284,False
2016,07/31,SanFrancisco,1.52,185496,513372,42846,71153,948,687,Summer,256649,514320,43533,False
2016,07/24,SanFrancisco,1.54,158290,527450,56349,72853,1013,1398,Summer,231143,528463,57747,False
2016,07/17,SanFrancisco,1.46,200748,481290,43042,77461,106,1422,Summer,278209,481396,44464,False
2016,07/10,SanFrancisco,1.4,249271,458731,43916,88916,689,1206,Summer,338187,459420,45122,False
2016,07/03,SanFrancisco,1.41,202576,546096,54358,86921,945,1019,Summer,289497,547041,55377,False
2016,06/26,SanFrancisco,1.5,194824,411086,55056,86438,1044,1105,Summer,281262,412130,56161,False
2016,06/19,SanFrancisco,1.44,210315,459979,43427,85053,1080,1065,Summer,295368,461059,44492,False
2016,06/12,SanFrancisco,1.45,228294,418903,48922,72937,1021,302,Summer,301231,419924,49224,False
2016,06/05,SanFrancisco,1.35,278152,481323,53447,85119,697,413,Summer,363271,482020,53860,False
2016,05/29,SanFrancisco,1.34,304281,462079,52673,70154,676,1202,Spring,374435,462755,53875,False
2016,05/22,SanFrancisco,1.31,247488,416811,70753,80974,945,948,Spring,328462,417756,71701,False
2016,05/15,SanFrancisco,1.37,201205,438490,61090,69780,1042,455,Spring,270985,439532,61545,False
2016,05/08,SanFrancisco,1.06,259594,569011,49424,80879,885,1538,Spring,340473,569896,50962,False
2016,05/01,SanFrancisco,0.99,355140,534187,39101,71485,898,413,Spring,426625,535085,39514,False
2016,04/24,SanFrancisco,1.0,313239,570669,55668,76195,883,769,Spring,389434,571552,56437,False
2016,04/17,SanFrancisco,1.39,209130,415099,76966,83707,901,618,Spring,292837,416000,77584,False
2016,04/10,SanFrancisco,1.38,216993,399403,61241,85683,894,1435,Spring,302676,400297,62676,False
2016,04/03,SanFrancisco,1.12,166177,546227,54166,82300,842,25,Spring,248477,547069,54191,False
2016,03/27,SanFrancisco,1.47,167887,409135,46243,91907,830,15,Spring,259794,409965,46258,False
2016,03/20,SanFrancisco,1.4,193704,416863,46189,81984,820,15,Spring,275688,417683,46204,False
2016,03/13,SanFrancisco,1.41,192002,383557,52459,85202,726,53,Spring,277204,384283,52512,False
2016,03/06,SanFrancisco,1.29,217965,441193,62391,94788,797,103,Spring,312753,441990,62494,False
2016,02/28,SanFrancisco,1.29,238542,445285,39537,99966,745,15,Winter,338508,446030,39552,False
2016,02/21,SanFrancisco,1.15,178438,509199,41240,70255,663,28,Winter,248693,509862,41268,False
2016,02/14,SanFrancisco,1.34,200199,357790,39859,98394,688,28,Winter,298593,358478,39887,False
2016,02/07,SanFrancisco,0.89,333064,858526,72545,90251,619,40,Winter,423315,859145,72585,False
2016,01/31,SanFrancisco,1.27,236160,431120,57834,79401,382,139,Winter,315561,431502,57973,False
2016,01/24,SanFrancisco,1.05,115036,621996,41235,65970,166,12,Winter,181006,622162,41247,False
2016,01/17,SanFrancisco,1.24,141712,474840,36599,79192,508,6,Winter,220904,475348,36605,False
2016,01/10,SanFrancisco,1.21,144506,487614,41093,92023,601,0,Winter,236529,488215,41093,False
2016,01/03,SanFrancisco,0.93,204501,593429,32339,88155,372,0,Winter,292656,593801,32339,False
2016,12/25,Seattle,1.17,64749,143841,205,265938,156,252,Winter,330687,143997,457,False
2016,12/18,Seattle,1.09,67730,132123,254,258720,215,278,Winter,326450,132338,532,False
2016,12/11,Seattle,0.88,69913,207213,401,529839,416,1619,Winter,599752,207629,2020,False
2016,12/04,Seattle,1.23,75095,131322,196,324725,191,271,Winter,399820,131513,467,False
2016,11/27,Seattle,1.45,44831,120317,388,217343,182,205,Fall,262174,120499,593,False
2016,11/20,Seattle,1.41,56982,128919,270,260780,648,160,Fall,317762,129567,430,False
2016,11/13,Seattle,1.43,61375,152069,317,257996,284,825,Fall,319371,152353,1142,False
2016,11/06,Seattle,1.43,58648,130208,528,256977,241,365,Fall,315625,130449,893,False
2016,10/30,Seattle,1.42,52130,108922,1018,205195,334,454,Fall,257325,109256,1472,False
2016,10/23,Seattle,1.12,69252,212504,483,335967,319,1071,Fall,405219,212823,1554,False
2016,10/16,Seattle,1.2,94032,146878,452,369370,7512,120,Fall,463402,154390,572,False
2016,10/09,Seattle,1.23,74612,138352,2177,309380,31923,429,Fall,383992,170275,2606,False
2016,10/02,Seattle,0.89,73071,190566,3182,361894,287932,492,Fall,434965,478498,3674,False
2016,09/25,Seattle,1.03,101292,130310,3243,304494,115510,575,Fall,405786,245820,3818,False
2016,09/18,Seattle,1.03,121884,150306,2273,264786,46367,593,Fall,386670,196673,2866,False
2016,09/11,Seattle,1.0,154068,167761,2713,319298,135,72,Fall,473366,167896,2785,False
2016,09/04,Seattle,1.13,132309,141811,2493,286871,129,238,Fall,419180,141940,2731,False
2016,08/28,Seattle,1.08,114777,174074,2493,300809,141,308,Summer,415586,174215,2801,False
2016,08/21,Seattle,1.11,111362,140739,2503,350689,135,223,Summer,462051,140874,2726,False
2016,08/14,Seattle,1.14,103908,158811,2368,326095,88,364,Summer,430003,158899,2732,False
2016,08/07,Seattle,1.11,101060,192576,2583,322390,143,454,Summer,423450,192719,3037,False
2016,07/31,Seattle,1.12,93422,157723,2598,341834,241,35,Summer,435256,157964,2633,False
2016,07/24,Seattle,1.1,85459,163758,1555,329976,114,159,Summer,415435,163872,1714,False
2016,07/17,Seattle,1.03,94220,165714,1624,378187,78,29,Summer,472407,165792,1653,False
2016,07/10,Seattle,1.11,103864,163811,6528,354205,146,53,Summer,458069,163957,6581,False
2016,07/03,Seattle,1.1,101636,179739,10770,371093,225,115,Summer,472729,179964,10885,False
2016,06/26,Seattle,1.03,91565,174576,12225,359260,313,608,Summer,450825,174889,12833,False
2016,06/19,Seattle,0.97,101860,193696,11487,369495,305,864,Summer,471355,194001,12351,False
2016,06/12,Seattle,1.01,108550,178700,12433,365830,512,314,Summer,474380,179212,12747,False
2016,06/05,Seattle,0.86,97146,262684,13268,478959,13577,706,Summer,576105,276261,13974,False
2016,05/29,Seattle,0.87,92529,210394,10676,443121,14344,167,Spring,535650,224738,10843,False
2016,05/22,Seattle,0.87,92633,212729,10453,324711,85148,388,Spring,417344,297877,10841,False
2016,05/15,Seattle,0.83,87749,218295,12759,523711,1383,449,Spring,611460,219678,13208,False
2016,05/08,Seattle,0.82,88762,334254,11093,552847,19202,1640,Spring,641609,353456,12733,False
2016,05/01,Seattle,0.82,91136,271005,11463,458041,25900,490,Spring,549177,296905,11953,False
2016,04/24,Seattle,0.88,86998,222808,12051,429116,197,965,Spring,516114,223005,13016,False
2016,04/17,Seattle,0.84,76011,252920,10371,511071,11419,655,Spring,587082,264339,11026,False
2016,04/10,Seattle,0.93,125383,228654,9317,363375,150,1566,Spring,488758,228804,10883,False
2016,04/03,Seattle,0.86,111241,191068,9773,480649,107,347,Spring,591890,191175,10120,False
2016,03/27,Seattle,0.85,91025,192539,10623,486972,87,333,Spring,577997,192626,10956,False
2016,03/20,Seattle,1.02,76059,193206,9181,317318,61,283,Spring,393377,193267,9464,False
2016,03/13,Seattle,0.94,71766,189254,10517,440777,139,353,Spring,512543,189393,10870,False
2016,03/06,Seattle,0.88,101164,203599,8332,468419,515,363,Spring,569583,204114,8695,False
2016,02/28,Seattle,0.91,96852,180912,7587,451747,116,300,Winter,548599,181028,7887,False
2016,02/21,Seattle,0.86,56523,215390,8476,474543,391,402,Winter,531066,215781,8878,False
2016,02/14,Seattle,0.98,105339,152777,8215,326841,284,193,Winter,432180,153061,8408,False
2016,02/07,Seattle,0.75,110675,347695,6322,573866,1573,821,Winter,684541,349268,7143,False
2016,01/31,Seattle,0.98,75852,190462,8910,390708,174,561,Winter,466560,190636,9471,False
2016,01/24,Seattle,0.92,100315,253246,7343,363400,1682,89,Winter,463715,254928,7432,False
2016,01/17,Seattle,0.94,155213,203618,8794,418854,2393,60,Winter,574067,206011,8854,False
2016,01/10,Seattle,0.86,177583,272041,7552,374204,173,355,Winter,551787,272214,7907,False
2016,01/03,Seattle,0.89,179151,290450,16134,327227,419,911,Winter,506378,290869,17045,False
2016,12/25,SouthCarolina,1.02,121219,62511,2501,72546,49562,0,Winter,193765,112073,2501,False
2016,12/18,SouthCarolina,1.07,103487,56975,2551,62581,44094,0,Winter,166068,101069,2551,False
2016,12/11,SouthCarolina,1.2,106629,42052,2563,60969,31340,0,Winter,167598,73392,2563,False
2016,12/04,SouthCarolina,1.09,122448,64899,3039,56900,56728,23,Winter,179348,121627,3062,False
2016,11/27,SouthCarolina,1.33,90090,40561,2813,65375,30153,78,Fall,155465,70714,2891,False
2016,11/20,SouthCarolina,1.34,105060,37789,4949,65248,33444,423,Fall,170308,71233,5372,False
2016,11/13,SouthCarolina,1.41,127839,40770,8259,42376,35957,85,Fall,170215,76727,8344,False
2016,11/06,SouthCarolina,1.5,97077,42624,9363,39593,33718,0,Fall,136670,76342,9363,False
2016,10/30,SouthCarolina,1.43,99127,45338,9096,40257,34173,0,Fall,139384,79511,9096,False
2016,10/23,SouthCarolina,1.4,128648,52740,6749,42484,29822,0,Fall,171132,82562,6749,False
2016,10/16,SouthCarolina,1.3,117958,64027,6111,49717,43424,0,Fall,167675,107451,6111,False
2016,10/09,SouthCarolina,1.32,109192,56453,4235,57335,35547,0,Fall,166527,92000,4235,False
2016,10/02,SouthCarolina,1.3,128824,66171,7203,63691,34973,137,Fall,192515,101144,7340,False
2016,09/25,SouthCarolina,1.25,148997,68555,6099,73929,30142,0,Fall,222926,98697,6099,False
2016,09/18,SouthCarolina,1.12,153616,62717,5940,75354,33919,0,Fall,228970,96636,5940,False
2016,09/11,SouthCarolina,1.08,156750,59265,6695,94007,25095,73,Fall,250757,84360,6768,False
2016,09/04,SouthCarolina,1.03,228635,60398,8324,89224,33338,5,Fall,317859,93736,8329,False
2016,08/28,SouthCarolina,1.11,197155,48370,6799,82906,17066,0,Summer,280061,65436,6799,False
2016,08/21,SouthCarolina,1.08,193878,58093,8868,104376,16333,0,Summer,298254,74426,8868,False
2016,08/14,SouthCarolina,1.11,198569,67082,10231,86861,26894,0,Summer,285430,93976,10231,False
2016,08/07,SouthCarolina,1.17,183405,59165,12579,83535,23894,45,Summer,266940,83059,12624,False
2016,07/31,SouthCarolina,1.18,156886,67074,12940,83699,23134,755,Summer,240585,90208,13695,False
2016,07/24,SouthCarolina,1.18,143275,81763,15147,71699,22356,2431,Summer,214974,104119,17578,False
2016,07/17,SouthCarolina,1.17,144883,77242,14172,75310,24436,5,Summer,220193,101678,14177,False
2016,07/10,SouthCarolina,1.08,168421,87043,21153,89946,22731,5,Summer,258367,109774,21158,False
2016,07/03,SouthCarolina,0.95,214287,125503,20517,116583,38901,0,Summer,330870,164404,20517,False
2016,06/26,SouthCarolina,1.07,150191,90300,18403,90996,17790,96,Summer,241187,108090,18499,False
2016,06/19,SouthCarolina,0.97,211554,100652,20140,85874,31652,1866,Summer,297428,132304,22006,False
2016,06/12,SouthCarolina,1.04,161172,80778,19782,73085,17292,5791,Summer,234257,98070,25573,False
2016,06/05,SouthCarolina,0.94,186493,103324,16909,66829,37354,5256,Summer,253322,140678,22165,False
2016,05/29,SouthCarolina,0.97,188092,120644,15039,63637,50673,3310,Spring,251729,171317,18349,False
2016,05/22,SouthCarolina,1.04,135034,98568,6909,59371,40067,3624,Spring,194405,138635,10533,False
2016,05/15,SouthCarolina,0.89,153126,137072,6161,69081,56332,502,Spring,222207,193404,6663,False
2016,05/08,SouthCarolina,0.82,216508,132765,6506,95500,52832,35,Spring,312008,185597,6541,False
2016,05/01,SouthCarolina,0.76,251273,163222,6281,100785,70398,0,Spring,352058,233620,6281,False
2016,04/24,SouthCarolina,0.93,151185,146951,6258,61890,53782,0,Spring,213075,200733,6258,False
2016,04/17,SouthCarolina,1.01,153725,109475,5464,67727,34296,0,Spring,221452,143771,5464,False
2016,04/10,SouthCarolina,0.96,158605,126384,6056,57960,48983,0,Spring,216565,175367,6056,False
2016,04/03,SouthCarolina,1.05,150247,97713,6435,63628,22540,0,Spring,213875,120253,6435,False
2016,03/27,SouthCarolina,1.07,136387,91995,7331,61407,17902,0,Spring,197794,109897,7331,False
2016,03/20,SouthCarolina,1.07,149730,94541,8317,60250,18690,0,Spring,209980,113231,8317,False
2016,03/13,SouthCarolina,0.96,175358,127186,8978,65808,37604,5,Spring,241166,164790,8983,False
2016,03/06,SouthCarolina,1.06,156334,90668,8137,52684,17961,0,Spring,209018,108629,8137,False
2016,02/28,SouthCarolina,0.93,178406,112748,7038,53432,36113,0,Winter,231838,148861,7038,False
2016,02/21,SouthCarolina,1.04,145774,82586,7361,49804,17126,0,Winter,195578,99712,7361,False
2016,02/14,SouthCarolina,0.91,180057,81396,6594,50158,24498,0,Winter,230215,105894,6594,False
2016,02/07,SouthCarolina,0.69,307135,151185,13083,61003,61340,10,Winter,368138,212525,13093,False
2016,01/31,SouthCarolina,1.01,159088,88740,9166,38452,17006,0,Winter,197540,105746,9166,False
2016,01/24,SouthCarolina,0.95,145616,92970,9676,43452,25315,0,Winter,189068,118285,9676,False
2016,01/17,SouthCarolina,1.05,149490,74436,9610,42971,11090,0,Winter,192461,85526,9610,False
2016,01/10,SouthCarolina,0.98,171275,76296,9959,42725,22176,0,Winter,214000,98472,9959,False
2016,01/03,SouthCarolina,1.03,195469,64802,10726,39155,9074,0,Winter,234624,73876,10726,False
2016,12/25,Spokane,1.15,13134,22888,43,32946,13,28,Winter,46080,22901,71,False
2016,12/18,Spokane,0.97,11468,24325,27,42186,361,7,Winter,53654,24686,34,False
2016,12/11,Spokane,0.96,12117,27759,34,50878,424,208,Winter,62995,28183,242,False
2016,12/04,Spokane,1.4,10871,19424,312,28878,8,15,Winter,39749,19432,327,False
2016,11/27,Spokane,1.49,8071,17786,33,23852,13,5,Fall,31923,17799,38,False
2016,11/20,Spokane,1.14,9351,25545,24,45968,4,124,Fall,55319,25549,148,False
2016,11/13,Spokane,1.07,12237,31222,35,55562,81,321,Fall,67799,31303,356,False
2016,11/06,Spokane,1.48,11311,21354,20,28639,4,35,Fall,39950,21358,55,False
2016,10/30,Spokane,1.39,8156,15739,118,27169,0,116,Fall,35325,15739,234,False
2016,10/23,Spokane,1.23,8981,34481,19,35886,44,65,Fall,44867,34525,84,False
2016,10/16,Spokane,1.33,13123,19622,46,34881,1171,4,Fall,48004,20793,50,False
2016,10/09,Spokane,1.19,13780,19165,70,33043,10182,0,Fall,46823,29347,70,False
2016,10/02,Spokane,0.87,12840,28797,151,45596,43887,310,Fall,58436,72684,461,False
2016,09/25,Spokane,1.09,17514,19838,124,39036,10338,0,Fall,56550,30176,124,False
2016,09/18,Spokane,1.05,17028,21111,378,32496,3721,12,Fall,49524,24832,390,False
2016,09/11,Spokane,0.98,25160,14719,1572,41633,0,9,Fall,66793,14719,1581,False
2016,09/04,Spokane,1.12,27414,15403,1519,39194,17,26,Fall,66608,15420,1545,False
2016,08/28,Spokane,1.12,24062,18386,1858,39315,0,4,Summer,63377,18386,1862,False
2016,08/21,Spokane,1.09,27169,14030,2000,44033,8,7,Summer,71202,14038,2007,False
2016,08/14,Spokane,1.14,24615,16234,2321,40759,0,2,Summer,65374,16234,2323,False
2016,08/07,Spokane,1.16,28151,21160,1816,38393,0,9,Summer,66544,21160,1825,False
2016,07/31,Spokane,1.14,25236,15512,1167,41986,0,0,Summer,67222,15512,1167,False
2016,07/24,Spokane,1.08,24997,15528,210,41880,0,0,Summer,66877,15528,210,False
2016,07/17,Spokane,0.98,25707,15296,159,51218,0,4,Summer,76925,15296,163,False
2016,07/10,Spokane,1.06,28563,16330,1198,44566,33,57,Summer,73129,16363,1255,False
2016,07/03,Spokane,1.09,29447,19298,3407,44836,349,26,Summer,74283,19647,3433,False
2016,06/26,Spokane,1.02,24210,18081,3974,44033,0,2,Summer,68243,18081,3976,False
2016,06/19,Spokane,0.96,27584,19850,2998,41041,56,24,Summer,68625,19906,3022,False
2016,06/12,Spokane,0.99,31353,17047,3152,37812,4447,7,Summer,69165,21494,3159,False
2016,06/05,Spokane,0.87,29094,30005,5361,60082,1383,7,Summer,89176,31388,5368,False
2016,05/29,Spokane,0.87,29399,21853,3012,55214,110,14,Spring,84613,21963,3026,False
2016,05/22,Spokane,0.89,28756,23438,3206,36360,8782,7,Spring,65116,32220,3213,False
2016,05/15,Spokane,0.85,24776,22868,3401,60819,32,95,Spring,85595,22900,3496,False
2016,05/08,Spokane,0.84,32460,34939,3173,55178,1553,98,Spring,87638,36492,3271,False
2016,05/01,Spokane,0.86,30544,28945,3451,53362,0,44,Spring,83906,28945,3495,False
2016,04/24,Spokane,0.95,26548,21236,2947,44270,630,26,Spring,70818,21866,2973,False
2016,04/17,Spokane,0.82,23285,29662,3466,75098,69,151,Spring,98383,29731,3617,False
2016,04/10,Spokane,0.96,31092,26584,3378,42824,0,118,Spring,73916,26584,3496,False
2016,04/03,Spokane,0.92,23189,22271,3270,48727,930,9,Spring,71916,23201,3279,False
2016,03/27,Spokane,0.81,21798,22445,3115,63172,0,83,Spring,84970,22445,3198,False
2016,03/20,Spokane,1.02,24106,19605,3092,36639,4,9,Spring,60745,19609,3101,False
2016,03/13,Spokane,0.93,22599,17655,3141,51069,0,64,Spring,73668,17655,3205,False
2016,03/06,Spokane,0.91,23603,22577,3132,52480,59,16,Spring,76083,22636,3148,False
2016,02/28,Spokane,0.95,21928,19963,2886,47750,29,38,Winter,69678,19992,2924,False
2016,02/21,Spokane,0.82,16913,27398,2940,64778,12,31,Winter,81691,27410,2971,False
2016,02/14,Spokane,0.95,22683,21398,2422,35052,53,16,Winter,57735,21451,2438,False
2016,02/07,Spokane,0.74,25009,56113,1283,72052,91,181,Winter,97061,56204,1464,False
2016,01/31,Spokane,1.0,19600,19030,3497,45821,76,14,Winter,65421,19106,3511,False
2016,01/24,Spokane,0.97,14122,29929,2793,42637,17,38,Winter,56759,29946,2831,False
2016,01/17,Spokane,0.98,20833,23919,3527,52341,132,0,Winter,73174,24051,3527,False
2016,01/10,Spokane,0.88,25931,32688,3214,49569,51,148,Winter,75500,32739,3362,False
2016,01/03,Spokane,0.9,25325,37805,4624,43671,1485,138,Winter,68996,39290,4762,False
2016,12/25,StLouis,1.02,58510,9135,60,47503,16823,0,Winter,106013,25958,60,False
2016,12/18,StLouis,0.97,58408,7756,50,52786,18882,0,Winter,111194,26638,50,False
2016,12/11,StLouis,1.11,38790,6951,146,57071,14613,0,Winter,95861,21564,146,False
2016,12/04,StLouis,1.1,40780,6623,37,40391,30343,0,Winter,81171,36966,37,False
2016,11/27,StLouis,1.16,34165,6473,16,40665,19103,0,Fall,74830,25576,16,False
2016,11/20,StLouis,1.29,40938,8785,86,35284,14835,0,Fall,76222,23620,86,False
2016,11/13,StLouis,1.34,59889,11028,97,40601,16476,0,Fall,100490,27504,97,False
2016,11/06,StLouis,1.25,64239,10904,98,45157,19079,219,Fall,109396,29983,317,False
2016,10/30,StLouis,1.01,51881,6010,59,45591,25423,0,Fall,97472,31433,59,False
2016,10/23,StLouis,0.95,90463,8443,49,61303,24146,0,Fall,151766,32589,49,False
2016,10/16,StLouis,1.29,53894,12563,46,42853,14842,0,Fall,96747,27405,46,False
2016,10/09,StLouis,1.3,49980,19770,125,39013,16710,0,Fall,88993,36480,125,False
2016,10/02,StLouis,1.16,51859,14340,35,41062,32732,0,Fall,92921,47072,35,False
2016,09/25,StLouis,1.06,89034,12643,25,38326,25857,0,Fall,127360,38500,25,False
2016,09/18,StLouis,1.17,46991,23066,58,50958,26367,76,Fall,97949,49433,134,False
2016,09/11,StLouis,1.05,97942,20573,32,50774,13353,0,Fall,148716,33926,32,False
2016,09/04,StLouis,1.16,41709,27154,131,59982,17076,5401,Fall,101691,44230,5532,False
2016,08/28,StLouis,1.15,43863,22002,99,43548,19095,4579,Summer,87411,41097,4678,False
2016,08/21,StLouis,1.03,45178,23409,167,98022,6778,10504,Summer,143200,30187,10671,False
2016,08/14,StLouis,0.91,53920,22787,254,137801,10454,5511,Summer,191721,33241,5765,False
2016,08/07,StLouis,0.85,62085,28664,213,154944,9249,12852,Summer,217029,37913,13065,False
2016,07/31,StLouis,1.03,54119,28847,229,109459,6537,15079,Summer,163578,35384,15308,False
2016,07/24,StLouis,0.94,75714,23532,439,132587,11498,11961,Summer,208301,35030,12400,False
2016,07/17,StLouis,0.88,53603,25828,304,152990,20179,8831,Summer,206593,46007,9135,False
2016,07/10,StLouis,0.74,61310,22958,663,204560,13138,12217,Summer,265870,36096,12880,False
2016,07/03,StLouis,0.76,65689,21478,467,225966,21420,13113,Summer,291655,42898,13580,False
2016,06/26,StLouis,0.97,70089,10838,750,126591,14354,14274,Summer,196680,25192,15024,False
2016,06/19,StLouis,0.95,68071,14769,81,139118,27583,4778,Summer,207189,42352,4859,False
2016,06/12,StLouis,0.92,63117,10829,88,139479,19315,18517,Summer,202596,30144,18605,False
2016,06/05,StLouis,0.83,69394,10226,90,170177,19377,14881,Summer,239571,29603,14971,False
2016,05/29,StLouis,0.8,71157,9858,210,150822,13401,31,Spring,221979,23259,241,False
2016,05/22,StLouis,0.81,85909,8500,15,156414,28505,46,Spring,242323,37005,61,False
2016,05/15,StLouis,0.75,69857,10440,46,179609,30236,413,Spring,249466,40676,459,False
2016,05/08,StLouis,0.85,68597,12628,73,127495,54426,142,Spring,196092,67054,215,False
2016,05/01,StLouis,0.79,99574,10728,42,126405,19398,30,Spring,225979,30126,72,False
2016,04/24,StLouis,0.8,65855,10636,10,123839,32941,37,Spring,189694,43577,47,False
2016,04/17,StLouis,0.91,55007,11057,47,96909,34108,69,Spring,151916,45165,116,False
2016,04/10,StLouis,0.87,83221,8054,82,98906,28468,21,Spring,182127,36522,103,False
2016,04/03,StLouis,0.94,57658,7307,15,82978,31523,2,Spring,140636,38830,17,False
2016,03/27,StLouis,0.97,49442,10038,21,76482,20432,36,Spring,125924,30470,57,False
2016,03/20,StLouis,0.88,74088,11333,27,73562,36866,4,Spring,147650,48199,31,False
2016,03/13,StLouis,0.89,67142,9121,68,65087,31078,99,Spring,132229,40199,167,False
2016,03/06,StLouis,0.96,68570,9371,23,84301,23258,43,Spring,152871,32629,66,False
2016,02/28,StLouis,0.98,52180,12434,64,81857,26526,220,Winter,134037,38960,284,False
2016,02/21,StLouis,1.0,78891,27326,55,74251,26792,21,Winter,153142,54118,76,False
2016,02/14,StLouis,0.98,55935,21668,16,69046,18403,0,Winter,124981,40071,16,False
2016,02/07,StLouis,0.87,76562,80994,32,71787,41934,43,Winter,148349,122928,75,False
2016,01/31,StLouis,1.01,79030,33529,14,68748,38112,8,Winter,147778,71641,22,False
2016,01/24,StLouis,1.1,38174,28333,4,67007,34086,13,Winter,105181,62419,17,False
2016,01/17,StLouis,1.15,55839,32775,25,63934,15068,46,Winter,119773,47843,71,False
2016,01/10,StLouis,1.01,77169,28510,34,89122,23596,28,Winter,166291,52106,62,False
2016,01/03,StLouis,1.0,105267,29054,34,67243,11814,22,Winter,172510,40868,56,False
2016,12/25,Syracuse,1.46,748,29452,2,14866,966,0,Winter,15614,30418,2,False
2016,12/18,Syracuse,1.42,770,28068,5,12270,908,6,Winter,13040,28976,11,False
2016,12/11,Syracuse,1.5,762,31386,15,8823,922,0,Winter,9585,32308,15,False
2016,12/04,Syracuse,1.64,796,42942,4,6841,149,97,Winter,7637,43091,101,False
2016,11/27,Syracuse,1.55,690,24789,6,8270,0,0,Fall,8960,24789,6,False
2016,11/20,Syracuse,1.61,814,27876,1,9906,0,0,Fall,10720,27876,1,False
2016,11/13,Syracuse,1.62,1266,27380,33,10590,0,0,Fall,11856,27380,33,False
2016,11/06,Syracuse,1.59,922,26701,31,11213,0,0,Fall,12135,26701,31,False
2016,10/30,Syracuse,1.56,967,25926,12,6791,2,0,Fall,7758,25928,12,False
2016,10/23,Syracuse,1.38,1110,37054,41,18222,0,0,Fall,19332,37054,41,False
2016,10/16,Syracuse,1.36,1344,31561,21,22125,0,0,Fall,23469,31561,21,False
2016,10/09,Syracuse,1.23,980,46378,56,22178,0,0,Fall,23158,46378,56,False
2016,10/02,Syracuse,1.43,987,32211,37,20560,0,0,Fall,21547,32211,37,False
2016,09/25,Syracuse,1.54,3272,38679,24,19358,17,0,Fall,22630,38696,24,False
2016,09/18,Syracuse,1.46,2411,36168,15,17070,255,0,Fall,19481,36423,15,False
2016,09/11,Syracuse,1.35,1874,39693,10,18636,777,0,Fall,20510,40470,10,False
2016,09/04,Syracuse,1.53,3545,35938,23,12128,6,150,Fall,15673,35944,173,False
2016,08/28,Syracuse,1.38,5939,45349,16,19306,0,1100,Summer,25245,45349,1116,False
2016,08/21,Syracuse,1.44,2904,37191,19,17427,0,955,Summer,20331,37191,974,False
2016,08/14,Syracuse,1.35,4941,39269,28,15337,0,635,Summer,20278,39269,663,False
2016,08/07,Syracuse,1.53,2724,41584,2,15518,0,695,Summer,18242,41584,697,False
2016,07/31,Syracuse,1.6,1970,47609,10,18175,0,545,Summer,20145,47609,555,False
2016,07/24,Syracuse,1.5,1940,35492,19,16609,0,2890,Summer,18549,35492,2909,False
2016,07/17,Syracuse,1.31,2211,39136,1,24463,0,1095,Summer,26674,39136,1096,False
2016,07/10,Syracuse,1.29,3503,49140,13,28754,3,2970,Summer,32257,49143,2983,False
2016,07/03,Syracuse,1.37,1970,47537,1,32830,0,2865,Summer,34800,47537,2866,False
2016,06/26,Syracuse,1.43,1952,52517,13,28352,0,1505,Summer,30304,52517,1518,False
2016,06/19,Syracuse,1.35,2080,45936,15,28498,0,1680,Summer,30578,45936,1695,False
2016,06/12,Syracuse,1.29,3484,43664,90,31259,0,1170,Summer,34743,43664,1260,False
2016,06/05,Syracuse,1.31,1635,46955,178,29640,0,1605,Summer,31275,46955,1783,False
2016,05/29,Syracuse,1.36,1259,52293,435,27875,0,310,Spring,29134,52293,745,False
2016,05/22,Syracuse,1.27,951,40672,600,29287,0,1125,Spring,30238,40672,1725,False
2016,05/15,Syracuse,1.23,1015,41631,695,28097,0,0,Spring,29112,41631,695,False
2016,05/08,Syracuse,1.23,1143,51234,411,32833,0,0,Spring,33976,51234,411,False
2016,05/01,Syracuse,1.31,992,54950,769,26695,0,0,Spring,27687,54950,769,False
2016,04/24,Syracuse,1.22,1000,39959,586,27268,3,0,Spring,28268,39962,586,False
2016,04/17,Syracuse,1.21,880,39173,3,30486,0,0,Spring,31366,39173,3,False
2016,04/10,Syracuse,1.28,987,32612,2,29290,0,0,Spring,30277,32612,2,False
2016,04/03,Syracuse,1.03,651,31826,4,26379,0,0,Spring,27030,31826,4,False
2016,03/27,Syracuse,1.29,872,43180,15,28359,0,0,Spring,29231,43180,15,False
2016,03/20,Syracuse,1.24,784,46256,10,25508,0,0,Spring,26292,46256,10,False
2016,03/13,Syracuse,1.18,874,42612,21,27710,4,0,Spring,28584,42616,21,False
2016,03/06,Syracuse,1.36,1023,38547,38,25157,99,0,Spring,26180,38646,38,False
2016,02/28,Syracuse,1.27,861,39219,8,23555,691,0,Winter,24416,39910,8,False
2016,02/21,Syracuse,1.34,918,40416,20,22191,1845,0,Winter,23109,42261,20,False
2016,02/14,Syracuse,1.28,1088,37685,41,25835,1115,0,Winter,26923,38800,41,False
2016,02/07,Syracuse,1.28,1462,60707,23,28032,708,0,Winter,29494,61415,23,False
2016,01/31,Syracuse,1.2,1181,41173,33,27245,541,0,Winter,28426,41714,33,False
2016,01/24,Syracuse,1.32,72,34868,31,29215,92,0,Winter,29287,34960,31,False
2016,01/17,Syracuse,1.37,1078,41232,9,27814,0,0,Winter,28892,41232,9,False
2016,01/10,Syracuse,1.36,757,31787,2,25129,0,0,Winter,25886,31787,2,False
2016,01/03,Syracuse,1.34,839,47417,24,20919,0,0,Winter,21758,47417,24,False
2016,12/25,Tampa,0.93,157380,104316,63,87877,95803,0,Winter,245257,200119,63,False
2016,12/18,Tampa,0.93,132947,102323,48,77777,99658,136,Winter,210724,201981,184,False
2016,12/11,Tampa,1.22,99668,60413,27,72901,56753,0,Winter,172569,117166,27,False
2016,12/04,Tampa,0.96,163609,123041,39,91215,122888,0,Winter,254824,245929,39,False
2016,11/27,Tampa,1.45,92933,61345,41,52267,59002,0,Fall,145200,120347,41,False
2016,11/20,Tampa,1.47,95447,63840,87,58516,61702,0,Fall,153963,125542,87,False
2016,11/13,Tampa,1.38,124544,69065,148,63858,66144,0,Fall,188402,135209,148,False
2016,11/06,Tampa,1.46,110779,67753,145,43844,61804,0,Fall,154623,129557,145,False
2016,10/30,Tampa,1.52,93166,68007,150,42732,61275,0,Fall,135898,129282,150,False
2016,10/23,Tampa,1.53,91272,92612,130,35310,62490,0,Fall,126582,155102,130,False
2016,10/16,Tampa,1.26,116452,117544,214,36245,100691,0,Fall,152697,218235,214,False
2016,10/09,Tampa,1.45,110106,105328,119,53843,67973,0,Fall,163949,173301,119,False
2016,10/02,Tampa,1.45,123390,72977,250,63736,62969,0,Fall,187126,135946,250,False
2016,09/25,Tampa,1.37,140782,66909,109,78485,63687,0,Fall,219267,130596,109,False
2016,09/18,Tampa,1.14,132430,66929,102,73697,71774,3,Fall,206127,138703,105,False
2016,09/11,Tampa,1.16,154295,62808,61,65128,55457,768,Fall,219423,118265,829,False
2016,09/04,Tampa,0.95,298317,105769,79,85777,68958,1788,Fall,384094,174727,1867,False
2016,08/28,Tampa,1.14,177292,99784,62,78855,20239,2583,Summer,256147,120023,2645,False
2016,08/21,Tampa,1.14,175344,100775,48,80157,27826,5900,Summer,255501,128601,5948,False
2016,08/14,Tampa,1.14,213370,110703,63,65540,57507,4890,Summer,278910,168210,4953,False
2016,08/07,Tampa,1.21,147057,95386,107,75445,35139,9700,Summer,222502,130525,9807,False
2016,07/31,Tampa,1.25,134859,87238,23,68165,30100,9890,Summer,203024,117338,9913,False
2016,07/24,Tampa,1.22,143082,97554,24,71808,29197,12195,Summer,214890,126751,12219,False
2016,07/17,Tampa,1.17,143891,101298,46,87458,31340,12239,Summer,231349,132638,12285,False
2016,07/10,Tampa,1.15,141565,92115,93,87917,26862,10791,Summer,229482,118977,10884,False
2016,07/03,Tampa,0.93,288161,142383,71,116195,50307,15976,Summer,404356,192690,16047,False
2016,06/26,Tampa,1.16,143485,88209,37,88532,31127,9790,Summer,232017,119336,9827,False
2016,06/19,Tampa,0.98,234054,127730,111,68955,55517,10900,Summer,303009,183247,11011,False
2016,06/12,Tampa,1.23,136835,76895,50,57317,29525,10445,Summer,194152,106420,10495,False
2016,06/05,Tampa,0.97,261221,100100,105,61524,53634,8416,Summer,322745,153734,8521,False
2016,05/29,Tampa,0.96,287990,117845,172,63311,57550,5556,Spring,351301,175395,5728,False
2016,05/22,Tampa,1.18,164833,65400,187,54513,33377,8936,Spring,219346,98777,9123,False
2016,05/15,Tampa,0.86,214251,138866,113,58113,106150,4638,Spring,272364,245016,4751,False
2016,05/08,Tampa,0.92,238892,96504,163,81108,76960,0,Spring,320000,173464,163,False
2016,05/01,Tampa,0.75,336112,170270,50,85158,150133,0,Spring,421270,320403,50,False
2016,04/24,Tampa,0.86,233226,148355,155,60995,122379,1005,Spring,294221,270734,1160,False
2016,04/17,Tampa,1.06,183628,79809,97,63443,60944,0,Spring,247071,140753,97,False
2016,04/10,Tampa,0.85,226151,140518,28,58747,123796,123,Spring,284898,264314,151,False
2016,04/03,Tampa,1.04,196164,73787,29,68922,63643,0,Spring,265086,137430,29,False
2016,03/27,Tampa,1.08,159310,70270,67,58016,55096,0,Spring,217326,125366,67,False
2016,03/20,Tampa,1.1,148381,69085,56,52243,56564,0,Spring,200624,125649,56,False
2016,03/13,Tampa,0.86,219895,131684,263,56866,118506,0,Spring,276761,250190,263,False
2016,03/06,Tampa,1.08,149559,67539,20,62840,52037,0,Spring,212399,119576,20,False
2016,02/28,Tampa,0.82,248401,134264,46,67866,118768,0,Winter,316267,253032,46,False
2016,02/21,Tampa,1.05,146660,67636,75,55694,51928,0,Winter,202354,119564,75,False
2016,02/14,Tampa,1.0,160675,76135,78,56730,36258,0,Winter,217405,112393,78,False
2016,02/07,Tampa,0.56,385584,189389,105,98976,148493,0,Winter,484560,337882,105,False
2016,01/31,Tampa,0.98,155283,95492,91,66287,74111,0,Winter,221570,169603,91,False
2016,01/24,Tampa,0.81,184104,122562,213,80146,116498,2,Winter,264250,239060,215,False
2016,01/17,Tampa,1.05,138371,49996,101,70537,45235,27,Winter,208908,95231,128,False
2016,01/10,Tampa,0.85,250745,88162,131,70164,110156,0,Winter,320909,198318,131,False
2016,01/03,Tampa,1.07,226406,46447,133,69223,33336,0,Winter,295629,79783,133,False
2016,12/25,WestTexNewMexico,0.73,484143,69977,15998,130112,167620,140,Winter,614255,237597,16138,False
2016,12/18,WestTexNewMexico,0.76,388322,66773,12379,142224,180677,413,Winter,530546,247450,12792,False
2016,12/11,WestTexNewMexico,0.79,308697,68324,12632,167338,219187,273,Winter,476035,287511,12905,False
2016,12/04,WestTexNewMexico,0.85,353339,66386,10869,105842,162657,75,Winter,459181,229043,10944,False
2016,11/27,WestTexNewMexico,0.8,415839,45217,9805,104487,98716,118,Fall,520326,143933,9923,False
2016,11/20,WestTexNewMexico,0.99,407045,40680,11622,109832,100871,0,Fall,516877,141551,11622,False
2016,11/13,WestTexNewMexico,0.96,429758,39757,14195,114355,92752,0,Fall,544113,132509,14195,False
2016,11/06,WestTexNewMexico,0.99,389129,47289,17719,106571,82920,0,Fall,495700,130209,17719,False
2016,10/30,WestTexNewMexico,1.11,230696,55531,17669,77112,93470,0,Fall,307808,149001,17669,False
2016,10/23,WestTexNewMexico,1.0,326067,68189,17487,92147,115578,918,Fall,418214,183767,18405,False
2016,10/16,WestTexNewMexico,0.87,490768,72347,13559,204702,121346,0,Fall,695470,193693,13559,False
2016,10/09,WestTexNewMexico,1.05,432642,61267,11748,153534,73637,0,Fall,586176,134904,11748,False
2016,10/02,WestTexNewMexico,1.14,326742,61488,15371,131471,69960,0,Fall,458213,131448,15371,False
2016,09/25,WestTexNewMexico,1.07,334016,61710,14663,117476,70580,175,Fall,451492,132290,14838,False
2016,09/18,WestTexNewMexico,0.95,471618,85785,12899,104714,74913,0,Fall,576332,160698,12899,False
2016,09/11,WestTexNewMexico,0.73,689424,117338,12243,111106,81825,100,Fall,800530,199163,12343,False
2016,09/04,WestTexNewMexico,0.88,570194,87176,13318,112529,79499,320,Fall,682723,166675,13638,False
2016,08/28,WestTexNewMexico,0.93,472159,93803,12234,134565,76391,70,Summer,606724,170194,12304,False
2016,08/21,WestTexNewMexico,0.92,484477,87640,12142,142739,81012,0,Summer,627216,168652,12142,False
2016,08/14,WestTexNewMexico,0.93,449883,89651,15309,159059,85083,0,Summer,608942,174734,15309,False
2016,08/07,WestTexNewMexico,0.95,500097,81237,15436,152300,67457,0,Summer,652397,148694,15436,False
2016,07/31,WestTexNewMexico,1.06,404007,76077,15442,144484,65764,2466,Summer,548491,141841,17908,False
2016,07/24,WestTexNewMexico,1.03,432573,85761,17101,169487,81989,11080,Summer,602060,167750,28181,False
2016,07/17,WestTexNewMexico,0.95,449793,85497,16431,178906,68996,3208,Summer,628699,154493,19639,False
2016,07/10,WestTexNewMexico,0.87,571522,102689,16968,187139,87776,12958,Summer,758661,190465,29926,False
2016,07/03,WestTexNewMexico,0.86,581532,106150,20212,212681,91214,14526,Summer,794213,197364,34738,False
2016,06/26,WestTexNewMexico,0.8,558419,101284,23127,243993,95170,6849,Summer,802412,196454,29976,False
2016,06/19,WestTexNewMexico,0.79,633115,111120,25373,167775,94639,16124,Summer,800890,205759,41497,False
2016,06/12,WestTexNewMexico,0.82,552199,94429,56434,110853,87748,15293,Summer,663052,182177,71727,False
2016,06/05,WestTexNewMexico,0.75,625919,125188,41083,106610,121450,10140,Summer,732529,246638,51223,False
2016,05/29,WestTexNewMexico,0.77,556578,134448,37522,107015,144257,6011,Spring,663593,278705,43533,False
2016,05/22,WestTexNewMexico,0.8,497605,111206,50440,97204,93102,8283,Spring,594809,204308,58723,False
2016,05/15,WestTexNewMexico,0.7,581142,136712,20624,97314,61552,3870,Spring,678456,198264,24494,False
2016,05/08,WestTexNewMexico,0.74,623286,183588,33224,124984,83560,4296,Spring,748270,267148,37520,False
2016,05/01,WestTexNewMexico,0.73,489363,148534,32607,173262,75381,7056,Spring,662625,223915,39663,False
2016,04/24,WestTexNewMexico,0.77,475418,155177,32786,97308,96326,2276,Spring,572726,251503,35062,False
2016,04/17,WestTexNewMexico,0.73,538758,154216,51745,92473,107003,140,Spring,631231,261219,51885,False
2016,04/10,WestTexNewMexico,0.77,567763,128899,32940,97395,70756,0,Spring,665158,199655,32940,False
2016,04/03,WestTexNewMexico,0.73,552528,80391,29032,82969,31311,0,Spring,635497,111702,29032,False
2016,03/27,WestTexNewMexico,0.71,638259,112685,30073,99134,56448,0,Spring,737393,169133,30073,False
2016,03/20,WestTexNewMexico,0.7,572667,148116,71017,86992,53584,0,Spring,659659,201700,71017,False
2016,03/13,WestTexNewMexico,0.72,563341,136619,36476,88060,61699,0,Spring,651401,198318,36476,False
2016,03/06,WestTexNewMexico,0.77,548260,108856,38919,89574,29004,0,Spring,637834,137860,38919,False
2016,02/28,WestTexNewMexico,0.73,532849,112139,53843,84429,40794,16,Winter,617278,152933,53859,False
2016,02/21,WestTexNewMexico,0.7,531994,140944,27799,88186,50489,1496,Winter,620180,191433,29295,False
2016,02/14,WestTexNewMexico,0.7,621734,151510,30289,89653,56745,13113,Winter,711387,208255,43402,False
2016,02/07,WestTexNewMexico,0.68,755962,197733,74916,100403,41471,28192,Winter,856365,239204,103108,False
2016,01/31,WestTexNewMexico,0.79,512429,88819,38529,94019,16913,38120,Winter,606448,105732,76649,False
2016,01/24,WestTexNewMexico,1.12,45720,99167,16034,94434,24812,16234,Winter,140154,123979,32268,False
2016,01/17,WestTexNewMexico,0.83,440675,120098,26636,89810,28507,7208,Winter,530485,148605,33844,False
2016,01/10,WestTexNewMexico,0.74,486986,152838,16273,82660,40944,1333,Winter,569646,193782,17606,False
2016,01/03,WestTexNewMexico,0.76,419119,178471,35241,94218,32476,2233,Winter,513337,210947,37474,False
2017,12/31,Albany,1.47,2622,101135,20,5556,4178,0,Winter,8178,105313,20,False
2017,12/24,Albany,1.45,2811,58592,19,6863,8752,0,Winter,9674,67344,19,False
2017,12/17,Albany,1.43,2578,50811,79,8914,8293,0,Winter,11492,59104,79,False
2017,12/10,Albany,1.29,3220,75147,104,7268,6585,0,Winter,10488,81732,104,False
2017,12/03,Albany,1.39,3772,126551,136,7061,2450,0,Winter,10833,129001,136,False
2017,11/26,Albany,1.5,2413,49076,62,5059,6368,0,Fall,7472,55444,62,False
2017,11/19,Albany,1.65,2695,80596,43,7536,6404,0,Fall,10231,87000,43,False
2017,11/12,Albany,1.26,4509,96748,213,8006,4109,0,Fall,12515,100857,213,False
2017,11/05,Albany,1.62,2483,55509,33,9877,3172,0,Fall,12360,58681,33,False
2017,10/29,Albany,1.67,2959,57585,57,5050,3778,0,Fall,8009,61363,57,False
2017,10/22,Albany,1.56,3758,57340,35,5101,3467,0,Fall,8859,60807,35,False
2017,10/15,Albany,1.65,3383,63355,62,3882,2891,0,Fall,7265,66246,62,False
2017,10/08,Albany,1.78,3679,45843,42,2148,3654,0,Fall,5827,49497,42,False
2017,10/01,Albany,1.69,4411,57416,77,5069,4230,0,Fall,9480,61646,77,False
2017,09/24,Albany,1.64,2508,56023,74,5391,4541,0,Fall,7899,60564,74,False
2017,09/17,Albany,1.41,3986,66934,33,5289,3851,13,Fall,9275,70785,46,False
2017,09/10,Albany,1.78,3368,87155,136,4559,3672,753,Fall,7927,90827,889,False
2017,09/03,Albany,1.76,4738,59299,121,4615,3646,1876,Fall,9353,62945,1997,False
2017,08/27,Albany,1.61,2156,59831,71,9395,3709,306,Summer,11551,63540,377,False
2017,08/20,Albany,1.61,1553,59028,130,8599,4155,1153,Summer,10152,63183,1283,False
2017,08/13,Albany,1.52,1947,118605,186,8301,3132,896,Summer,10248,121737,1082,False
2017,08/06,Albany,1.53,2456,76509,336,5918,6844,873,Summer,8374,83353,1209,False
2017,07/30,Albany,1.61,1915,73287,321,5552,1932,590,Summer,7467,75219,911,False
2017,07/23,Albany,1.49,1905,72533,940,3250,4896,890,Summer,5155,77429,1830,False
2017,07/16,Albany,1.39,2468,86707,2546,4950,4788,1000,Summer,7418,91495,3546,False
2017,07/09,Albany,1.52,2899,81929,494,8213,5210,2585,Summer,11112,87139,3079,False
2017,07/02,Albany,1.56,2808,79968,741,6549,6584,1630,Summer,9357,86552,2371,False
2017,06/25,Albany,1.53,2224,74282,129,4686,6874,1105,Summer,6910,81156,1234,False
2017,06/18,Albany,1.58,2454,82154,723,3875,6697,1175,Summer,6329,88851,1898,False
2017,06/11,Albany,1.65,1989,76736,364,2704,8235,1918,Summer,4693,84971,2282,False
2017,06/04,Albany,1.7,1923,72573,100,2834,6342,1070,Summer,4757,78915,1170,False
2017,05/28,Albany,1.8,2345,106690,105,6141,6029,556,Spring,8486,112719,661,False
2017,05/21,Albany,1.38,2307,86817,334,5338,5203,256,Spring,7645,92020,590,False
2017,05/14,Albany,1.77,2804,80469,196,5727,7552,0,Spring,8531,88021,196,False
2017,05/07,Albany,1.47,2473,87791,121,9600,27205,0,Spring,12073,114996,121,False
2017,04/30,Albany,1.13,2573,99451,81,10547,12272,0,Spring,13120,111723,81,False
2017,04/23,Albany,1.34,4437,61512,84,8236,15056,0,Spring,12673,76568,84,False
2017,04/16,Albany,1.62,4362,71957,161,7179,6825,0,Spring,11541,78782,161,False
2017,04/09,Albany,1.54,3708,87775,44,7121,6786,0,Spring,10829,94561,44,False
2017,04/02,Albany,1.62,4530,68015,97,6332,13645,0,Spring,10862,81660,97,False
2017,03/26,Albany,1.16,3184,100854,70,7252,11590,0,Spring,10436,112444,70,False
2017,03/19,Albany,1.6,2332,72033,140,8302,9965,0,Spring,10634,81998,140,False
2017,03/12,Albany,1.54,2046,67162,89,10990,15424,0,Spring,13036,82586,89,False
2017,03/05,Albany,1.18,3123,90784,57,13277,111,0,Spring,16400,90895,57,False
2017,02/26,Albany,1.4,3190,73959,71,10910,239,0,Winter,14100,74198,71,False
2017,02/19,Albany,1.67,2702,81691,125,10784,171,0,Winter,13486,81862,125,False
2017,02/12,Albany,1.42,3808,81070,175,11650,510,0,Winter,15458,81580,175,False
2017,02/05,Albany,1.49,5666,165530,2119,10047,186,0,Winter,15713,165716,2119,False
2017,01/29,Albany,1.31,3844,78315,484,12393,382,4,Winter,16237,78697,488,False
2017,01/22,Albany,1.59,4119,111173,2191,11060,125,8,Winter,15179,111298,2199,False
2017,01/15,Albany,1.55,3327,71956,607,12574,60,0,Winter,15901,72016,607,False
2017,01/08,Albany,1.55,3355,75641,56,12606,67,0,Winter,15961,75708,56,False
2017,01/01,Albany,1.47,4845,117027,200,7866,7,0,Winter,12711,117034,200,False
2017,12/31,Atlanta,0.95,341061,41818,961,173990,88882,2639,Winter,515051,130700,3600,False
2017,12/24,Atlanta,1.11,212413,30834,1112,130079,66147,4194,Winter,342492,96981,5306,False
2017,12/17,Atlanta,1.0,231133,33481,915,153468,62336,2991,Winter,384601,95817,3906,False
2017,12/10,Atlanta,0.99,274345,38433,1302,158483,67567,3486,Winter,432828,106000,4788,False
2017,12/03,Atlanta,1.07,263807,32457,1390,137581,66640,3058,Winter,401388,99097,4448,False
2017,11/26,Atlanta,1.12,211077,27773,903,113141,55576,3743,Fall,324218,83349,4646,False
2017,11/19,Atlanta,1.13,239860,31169,1109,118386,61447,1784,Fall,358246,92616,2893,False
2017,11/12,Atlanta,1.11,251896,31719,1398,154898,75134,3164,Fall,406794,106853,4562,False
2017,11/05,Atlanta,1.08,275749,32494,1124,189677,66802,1723,Fall,465426,99296,2847,False
2017,10/29,Atlanta,1.28,256988,36334,1083,131656,66215,1641,Fall,388644,102549,2724,False
2017,10/22,Atlanta,1.49,219172,35958,894,95710,54265,8,Fall,314882,90223,902,False
2017,10/15,Atlanta,1.64,197442,34760,148,110652,63067,39,Fall,308094,97827,187,False
2017,10/08,Atlanta,1.6,213442,32020,51,100702,65197,106,Fall,314144,97217,157,False
2017,10/01,Atlanta,1.55,222683,45065,366,101913,51196,8,Fall,324596,96261,374,False
2017,09/24,Atlanta,1.5,222498,45024,34,88241,47954,26,Fall,310739,92978,60,False
2017,09/17,Atlanta,1.59,204374,47135,92,90750,50425,156,Fall,295124,97560,248,False
2017,09/10,Atlanta,1.54,241057,47619,111,116857,58868,2475,Fall,357914,106487,2586,False
2017,09/03,Atlanta,1.53,235645,47493,121,92866,54225,3103,Fall,328511,101718,3224,False
2017,08/27,Atlanta,1.49,230031,48132,99,116586,56679,6505,Summer,346617,104811,6604,False
2017,08/20,Atlanta,1.43,230252,49199,27,132374,62509,1557,Summer,362626,111708,1584,False
2017,08/13,Atlanta,1.37,251178,62180,64,148972,66092,5570,Summer,400150,128272,5634,False
2017,08/06,Atlanta,1.36,252436,60584,69,137139,60271,7638,Summer,389575,120855,7707,False
2017,07/30,Atlanta,1.34,247038,60149,87,105247,53475,6014,Summer,352285,113624,6101,False
2017,07/23,Atlanta,1.24,285745,65016,150,115065,45903,6799,Summer,400810,110919,6949,False
2017,07/16,Atlanta,1.2,301471,63898,100,154627,55794,6175,Summer,456098,119692,6275,False
2017,07/09,Atlanta,1.19,233475,57935,442,138657,69372,7455,Summer,372132,127307,7897,False
2017,07/02,Atlanta,1.16,248095,56275,109,136027,77103,10685,Summer,384122,133378,10794,False
2017,06/25,Atlanta,1.12,249204,46343,149,102982,95431,7162,Summer,352186,141774,7311,False
2017,06/18,Atlanta,1.2,269328,49177,145,94081,69712,10390,Summer,363409,118889,10535,False
2017,06/11,Atlanta,1.13,318335,51385,101,117300,78150,7565,Summer,435635,129535,7666,False
2017,06/04,Atlanta,1.08,361265,55627,130,174068,113270,5675,Summer,535333,168897,5805,False
2017,05/28,Atlanta,1.23,273538,50236,354,131064,57827,10972,Spring,404602,108063,11326,False
2017,05/21,Atlanta,1.2,253792,49347,1650,142077,70753,9218,Spring,395869,120100,10868,False
2017,05/14,Atlanta,1.18,265556,49122,3491,171471,69708,9573,Spring,437027,118830,13064,False
2017,05/07,Atlanta,1.1,377225,72058,248,148163,121006,8024,Spring,525388,193064,8272,False
2017,04/30,Atlanta,1.17,304668,74961,240,131644,75877,8147,Spring,436312,150838,8387,False
2017,04/23,Atlanta,1.21,249318,55045,96,138920,84101,2547,Spring,388238,139146,2643,False
2017,04/16,Atlanta,1.15,237537,48907,143,170945,80087,5605,Spring,408482,128994,5748,False
2017,04/09,Atlanta,1.23,223170,48912,124,107369,78978,6795,Spring,330539,127890,6919,False
2017,04/02,Atlanta,1.26,226289,48770,139,150546,52857,3330,Spring,376835,101627,3469,False
2017,03/26,Atlanta,1.32,222457,50731,132,108832,56386,4975,Spring,331289,107117,5107,False
2017,03/19,Atlanta,1.25,215046,50085,147,120153,72091,3465,Spring,335199,122176,3612,False
2017,03/12,Atlanta,1.21,217624,48169,97,126155,75894,1336,Spring,343779,124063,1433,False
2017,03/05,Atlanta,1.08,237307,52012,62,143650,77624,705,Spring,380957,129636,767,False
2017,02/26,Atlanta,0.85,302620,53782,96,222151,50371,2485,Winter,524771,104153,2581,False
2017,02/19,Atlanta,0.86,279494,52644,133,171819,55459,3468,Winter,451313,108103,3601,False
2017,02/12,Atlanta,0.79,355571,77241,325,176286,56911,536,Winter,531857,134152,861,False
2017,02/05,Atlanta,0.83,442152,167181,412,180392,97837,118,Winter,622544,265018,530,False
2017,01/29,Atlanta,0.95,285147,86150,219,177033,79144,0,Winter,462180,165294,219,False
2017,01/22,Atlanta,0.84,320378,135920,179,177899,121095,0,Winter,498277,257015,179,False
2017,01/15,Atlanta,0.99,249159,86964,169,145333,75750,0,Winter,394492,162714,169,False
2017,01/08,Atlanta,0.98,279265,77758,319,172510,71691,0,Winter,451775,149449,319,False
2017,01/01,Atlanta,0.93,224073,118926,337,111599,92628,0,Winter,335672,211554,337,False
2017,12/31,BaltimoreWashington,1.15,66628,519460,4920,245665,12812,0,Winter,312293,532272,4920,False
2017,12/24,BaltimoreWashington,1.41,66338,363593,2679,184571,7085,0,Winter,250909,370678,2679,False
2017,12/17,BaltimoreWashington,1.44,67126,369810,2933,177981,10883,0,Winter,245107,380693,2933,False
2017,12/10,BaltimoreWashington,1.13,103332,546809,3979,263946,22782,0,Winter,367278,569591,3979,False
2017,12/03,BaltimoreWashington,1.43,69819,407522,3789,173143,4666,0,Winter,242962,412188,3789,False
2017,11/26,BaltimoreWashington,1.43,59916,377227,3440,157579,31556,0,Fall,217495,408783,3440,False
2017,11/19,BaltimoreWashington,1.45,64122,365922,3724,167489,43483,0,Fall,231611,409405,3724,False
2017,11/12,BaltimoreWashington,1.49,78052,387453,3925,178913,10350,0,Fall,256965,397803,3925,False
2017,11/05,BaltimoreWashington,1.41,93808,458177,4062,173551,6867,0,Fall,267359,465044,4062,False
2017,10/29,BaltimoreWashington,1.55,62566,434269,4193,179693,1510,3,Fall,242259,435779,4196,False
2017,10/22,BaltimoreWashington,1.6,60120,418176,4523,184656,4545,44,Fall,244776,422721,4567,False
2017,10/15,BaltimoreWashington,1.66,57542,426158,4901,166892,12272,3,Fall,224434,438430,4904,False
2017,10/08,BaltimoreWashington,1.71,58351,380897,4554,147300,7733,0,Fall,205651,388630,4554,False
2017,10/01,BaltimoreWashington,1.59,57840,461605,4777,167895,13332,0,Fall,225735,474937,4777,False
2017,09/24,BaltimoreWashington,1.59,58682,451995,4487,158072,3260,0,Fall,216754,455255,4487,False
2017,09/17,BaltimoreWashington,1.58,55766,443692,4745,158757,1466,73,Fall,214523,445158,4818,False
2017,09/10,BaltimoreWashington,1.57,52853,424593,5141,169534,3197,4783,Fall,222387,427790,9924,False
2017,09/03,BaltimoreWashington,1.62,58996,435940,5348,168300,547,2370,Fall,227296,436487,7718,False
2017,08/27,BaltimoreWashington,1.66,51628,402657,5171,192627,800,713,Summer,244255,403457,5884,False
2017,08/20,BaltimoreWashington,1.57,58935,417107,5204,198850,1721,9815,Summer,257785,418828,15019,False
2017,08/13,BaltimoreWashington,1.48,61461,431018,5629,186157,8884,4168,Summer,247618,439902,9797,False
2017,08/06,BaltimoreWashington,1.47,60785,440986,5324,182988,1830,3933,Summer,243773,442816,9257,False
2017,07/30,BaltimoreWashington,1.47,57622,399898,5352,187554,1284,3714,Summer,245176,401182,9066,False
2017,07/23,BaltimoreWashington,1.48,65421,435763,5663,181105,1046,3872,Summer,246526,436809,9535,False
2017,07/16,BaltimoreWashington,1.48,64407,415327,5640,177112,886,7102,Summer,241519,416213,12742,False
2017,07/09,BaltimoreWashington,1.64,64096,448758,6202,170309,3724,8778,Summer,234405,452482,14980,False
2017,07/02,BaltimoreWashington,1.6,57584,397714,6602,182308,14659,13745,Summer,239892,412373,20347,False
2017,06/25,BaltimoreWashington,1.65,57367,446948,6496,167326,7351,8481,Summer,224693,454299,14977,False
2017,06/18,BaltimoreWashington,1.67,62875,462835,6444,169245,2474,9595,Summer,232120,465309,16039,False
2017,06/11,BaltimoreWashington,1.65,65666,475095,7177,184500,4298,7420,Summer,250166,479393,14597,False
2017,06/04,BaltimoreWashington,1.8,62567,482039,7375,201471,2167,2288,Summer,264038,484206,9663,False
2017,05/28,BaltimoreWashington,1.75,66151,477777,7002,221418,2459,4373,Spring,287569,480236,11375,False
2017,05/21,BaltimoreWashington,1.67,70765,467149,7223,202535,2203,263,Spring,273300,469352,7486,False
2017,05/14,BaltimoreWashington,1.59,67663,394707,6178,259582,2476,1345,Spring,327245,397183,7523,False
2017,05/07,BaltimoreWashington,1.37,75658,722001,10048,282860,6800,611,Spring,358518,728801,10659,False
2017,04/30,BaltimoreWashington,1.69,74466,471825,7668,202998,4607,358,Spring,277464,476432,8026,False
2017,04/23,BaltimoreWashington,1.67,69674,458300,7322,197171,16072,645,Spring,266845,474372,7967,False
2017,04/16,BaltimoreWashington,1.7,67839,439898,6834,182834,20215,318,Spring,250673,460113,7152,False
2017,04/09,BaltimoreWashington,1.64,71187,438985,6568,218334,2510,668,Spring,289521,441495,7236,False
2017,04/02,BaltimoreWashington,1.5,82571,493953,7301,213697,1724,1553,Spring,296268,495677,8854,False
2017,03/26,BaltimoreWashington,1.6,70467,462479,7285,196644,1950,550,Spring,267111,464429,7835,False
2017,03/19,BaltimoreWashington,1.58,70368,463108,6761,179560,18501,655,Spring,249928,481609,7416,False
2017,03/12,BaltimoreWashington,1.6,72820,476272,9389,202870,2051,379,Spring,275690,478323,9768,False
2017,03/05,BaltimoreWashington,1.33,84608,591422,12152,190684,1458,0,Spring,275292,592880,12152,False
2017,02/26,BaltimoreWashington,1.48,82179,531502,9921,185955,4349,469,Winter,268134,535851,10390,False
2017,02/19,BaltimoreWashington,1.38,96158,434568,9538,169659,10733,598,Winter,265817,445301,10136,False
2017,02/12,BaltimoreWashington,1.24,190311,538660,8822,166227,19425,2127,Winter,356538,558085,10949,False
2017,02/05,BaltimoreWashington,1.09,174325,770463,29352,187362,6286,2654,Winter,361687,776749,32006,False
2017,01/29,BaltimoreWashington,1.46,81883,489023,10828,193910,2724,3167,Winter,275793,491747,13995,False
2017,01/22,BaltimoreWashington,1.42,81908,528125,22836,187903,5693,473,Winter,269811,533818,23309,False
2017,01/15,BaltimoreWashington,1.48,76382,472453,10119,188395,2152,7,Winter,264777,474605,10126,False
2017,01/08,BaltimoreWashington,1.14,83249,750033,9793,183395,2281,525,Winter,266644,752314,10318,False
2017,01/01,BaltimoreWashington,1.47,54530,408952,14387,151345,2542,3,Winter,205875,411494,14390,False
2017,12/31,Boise,1.13,38196,1706,6263,28764,4676,39,Winter,66960,6382,6302,False
2017,12/24,Boise,1.18,39116,2348,4750,18067,6638,83,Winter,57183,8986,4833,False
2017,12/17,Boise,1.29,31969,1752,6655,18837,5849,26,Winter,50806,7601,6681,False
2017,12/10,Boise,1.08,53165,1936,4746,19630,5945,72,Winter,72795,7881,4818,False
2017,12/03,Boise,1.14,38662,1518,7094,35079,4261,32,Winter,73741,5779,7126,False
2017,11/26,Boise,1.44,28307,1707,5116,14540,4914,96,Fall,42847,6621,5212,False
2017,11/19,Boise,1.42,31177,2085,5660,14002,7421,258,Fall,45179,9506,5918,False
2017,11/12,Boise,1.23,37876,2047,4630,32441,4811,21,Fall,70317,6858,4651,False
2017,11/05,Boise,1.21,40651,1848,4629,29560,4359,54,Fall,70211,6207,4683,False
2017,10/29,Boise,1.44,33724,2180,4757,22077,5728,53,Fall,55801,7908,4810,False
2017,10/22,Boise,1.43,49926,2947,4055,23454,3437,21,Fall,73380,6384,4076,False
2017,10/15,Boise,1.83,30892,2910,5019,13508,5695,34,Fall,44400,8605,5053,False
2017,10/08,Boise,1.89,28952,2680,6108,13229,4986,129,Fall,42181,7666,6237,False
2017,10/01,Boise,1.8,33499,2015,5127,12675,5242,42,Fall,46174,7257,5169,False
2017,09/24,Boise,1.78,29755,1936,5658,13553,5756,10,Fall,43308,7692,5668,False
2017,09/17,Boise,1.73,35146,2637,5498,15258,6770,23,Fall,50404,9407,5521,False
2017,09/10,Boise,1.76,36441,2816,6160,13679,7241,139,Fall,50120,10057,6299,False
2017,09/03,Boise,1.68,30130,3171,6522,18158,6319,53,Fall,48288,9490,6575,False
2017,08/27,Boise,1.3,45399,2514,6033,35502,4335,17,Summer,80901,6849,6050,False
2017,08/20,Boise,1.37,42285,2840,7323,29076,6495,10,Summer,71361,9335,7333,False
2017,08/13,Boise,1.51,36652,3646,5544,16648,8222,2,Summer,53300,11868,5546,False
2017,08/06,Boise,1.54,37252,3802,7644,16530,8380,98,Summer,53782,12182,7742,False
2017,07/30,Boise,1.54,36727,3472,7264,15602,8946,7,Summer,52329,12418,7271,False
2017,07/23,Boise,1.51,36289,3129,7061,15903,8360,39,Summer,52192,11489,7100,False
2017,07/16,Boise,1.49,35748,3543,8951,15218,8708,75,Summer,50966,12251,9026,False
2017,07/09,Boise,0.98,47772,3135,7817,66747,308,4,Summer,114519,3443,7821,False
2017,07/02,Boise,1.17,41134,3402,8606,44184,24,55,Summer,85318,3426,8661,False
2017,06/25,Boise,1.2,41340,3573,7667,42360,52,76,Summer,83700,3625,7743,False
2017,06/18,Boise,1.21,40471,3263,8414,40688,26,42,Summer,81159,3289,8456,False
2017,06/11,Boise,1.21,40250,2998,8103,41167,19,8,Summer,81417,3017,8111,False
2017,06/04,Boise,1.19,42302,3757,7950,44427,11,11,Summer,86729,3768,7961,False
2017,05/28,Boise,1.21,40637,3548,10210,45988,20,11,Spring,86625,3568,10221,False
2017,05/21,Boise,1.29,35312,3430,10330,37442,8,8,Spring,72754,3438,10338,False
2017,05/14,Boise,1.2,38987,2778,9358,41044,2292,4,Spring,80031,5070,9362,False
2017,05/07,Boise,1.09,60550,3285,9701,45880,2055,9,Spring,106430,5340,9710,False
2017,04/30,Boise,1.03,41327,2195,9316,56263,2,13,Spring,97590,2197,9329,False
2017,04/23,Boise,1.14,41816,2688,9753,39291,85,21,Spring,81107,2773,9774,False
2017,04/16,Boise,1.15,43003,3555,9548,43271,29,3,Spring,86274,3584,9551,False
2017,04/09,Boise,1.21,39291,4115,10280,41795,15,9,Spring,81086,4130,10289,False
2017,04/02,Boise,1.2,41043,3616,9919,40187,115,22,Spring,81230,3731,9941,False
2017,03/26,Boise,1.16,43566,4140,8899,38139,517,29,Spring,81705,4657,8928,False
2017,03/19,Boise,1.15,33891,3887,9034,39041,834,38,Spring,72932,4721,9072,False
2017,03/12,Boise,0.98,33062,9415,9975,58419,1777,126,Spring,91481,11192,10101,False
2017,03/05,Boise,1.11,29234,5256,12115,32638,14550,18,Spring,61872,19806,12133,False
2017,02/26,Boise,0.91,31701,5199,11562,38256,18258,44,Winter,69957,23457,11606,False
2017,02/19,Boise,0.94,33444,7191,9936,45026,11989,133,Winter,78470,19180,10069,False
2017,02/12,Boise,0.98,41600,4101,9261,41656,1141,23,Winter,83256,5242,9284,False
2017,02/05,Boise,0.9,36808,11333,23346,61439,3116,46,Winter,98247,14449,23392,False
2017,01/29,Boise,0.93,35677,6532,9559,36294,17043,25,Winter,71971,23575,9584,False
2017,01/22,Boise,1.01,34251,5626,8313,34932,5155,38,Winter,69183,10781,8351,False
2017,01/15,Boise,1.0,36085,4773,10056,38975,4039,225,Winter,75060,8812,10281,False
2017,01/08,Boise,1.02,35596,7162,12143,40257,8607,20,Winter,75853,15769,12163,False
2017,01/01,Boise,0.92,27845,9408,11341,53093,2793,27,Winter,80938,12201,11368,False
2017,12/31,Boston,1.4,9622,325398,2061,65868,16745,0,Winter,75490,342143,2061,False
2017,12/24,Boston,1.45,10726,312860,1638,75107,13814,0,Winter,85833,326674,1638,False
2017,12/17,Boston,1.28,10139,413484,3836,74552,14758,0,Winter,84691,428242,3836,False
2017,12/10,Boston,1.14,13210,557434,2169,93125,21311,0,Winter,106335,578745,2169,False
2017,12/03,Boston,1.4,12171,386056,1901,66539,21921,0,Winter,78710,407977,1901,False
2017,11/26,Boston,1.39,10677,304833,2073,65656,40538,0,Fall,76333,345371,2073,False
2017,11/19,Boston,1.36,11494,341486,2365,77117,43775,0,Fall,88611,385261,2365,False
2017,11/12,Boston,1.23,15689,533027,5720,74568,10086,0,Fall,90257,543113,5720,False
2017,11/05,Boston,1.49,13002,334875,2014,74159,16919,0,Fall,87161,351794,2014,False
2017,10/29,Boston,1.49,14781,360615,2145,74278,13286,0,Fall,89059,373901,2145,False
2017,10/22,Boston,1.48,19871,328476,2432,81134,3329,0,Fall,101005,331805,2432,False
2017,10/15,Boston,1.59,20138,331423,2218,57500,6953,0,Fall,77638,338376,2218,False
2017,10/08,Boston,1.61,16621,322931,1266,76160,34628,0,Fall,92781,357559,1266,False
2017,10/01,Boston,1.62,14889,366122,1797,71620,27841,0,Fall,86509,393963,1797,False
2017,09/24,Boston,1.62,10697,384522,1718,67635,33422,23,Fall,78332,417944,1741,False
2017,09/17,Boston,1.58,11826,323528,1322,89622,36416,80,Fall,101448,359944,1402,False
2017,09/10,Boston,1.63,10795,394645,1483,97862,18127,1600,Fall,108657,412772,3083,False
2017,09/03,Boston,1.81,10210,333916,1478,83323,27043,1890,Fall,93533,360959,3368,False
2017,08/27,Boston,1.79,7262,319717,1534,89674,36986,740,Summer,96936,356703,2274,False
2017,08/20,Boston,1.77,6723,328845,1675,90348,44267,3122,Summer,97071,373112,4797,False
2017,08/13,Boston,1.52,7302,492068,2985,78320,40848,2893,Summer,85622,532916,5878,False
2017,08/06,Boston,1.55,8619,470232,3211,85619,35182,1893,Summer,94238,505414,5104,False
2017,07/30,Boston,1.48,8414,429987,3326,96106,29390,1030,Summer,104520,459377,4356,False
2017,07/23,Boston,1.37,7993,556263,6107,77917,35935,2516,Summer,85910,592198,8623,False
2017,07/16,Boston,1.56,9162,463806,3825,76876,38373,1971,Summer,86038,502179,5796,False
2017,07/09,Boston,1.69,8735,464670,3962,75760,4052,2840,Summer,84495,468722,6802,False
2017,07/02,Boston,1.67,6572,437068,4890,88408,5364,2825,Summer,94980,442432,7715,False
2017,06/25,Boston,1.68,5987,434222,3399,94362,5241,2675,Summer,100349,439463,6074,False
2017,06/18,Boston,1.66,5379,452146,3286,112280,5416,2794,Summer,117659,457562,6080,False
2017,06/11,Boston,1.72,5556,457512,3039,109052,5650,2897,Summer,114608,463162,5936,False
2017,06/04,Boston,1.73,5139,460653,3075,115907,5366,436,Summer,121046,466019,3511,False
2017,05/28,Boston,1.73,5970,460430,2755,127580,4926,973,Spring,133550,465356,3728,False
2017,05/21,Boston,1.69,5555,441357,3222,117070,5154,60,Spring,122625,446511,3282,False
2017,05/14,Boston,1.62,5152,448442,3462,146852,6280,158,Spring,152004,454722,3620,False
2017,05/07,Boston,1.49,6703,493447,6088,148966,20450,1193,Spring,155669,513897,7281,False
2017,04/30,Boston,1.61,5758,467084,3505,114534,11768,631,Spring,120292,478852,4136,False
2017,04/23,Boston,1.63,9577,382449,3293,104839,20633,0,Spring,114416,403082,3293,False
2017,04/16,Boston,1.61,7319,437483,3589,124789,17115,1752,Spring,132108,454598,5341,False
2017,04/09,Boston,1.53,5715,450287,3497,149094,21204,0,Spring,154809,471491,3497,False
2017,04/02,Boston,1.56,7962,427483,3484,115541,17430,0,Spring,123503,444913,3484,False
2017,03/26,Boston,1.51,6860,412840,3403,115695,11461,686,Spring,122555,424301,4089,False
2017,03/19,Boston,1.54,5709,425273,3736,87773,18047,0,Spring,93482,443320,3736,False
2017,03/12,Boston,1.55,5729,389749,3675,75284,20014,663,Spring,81013,409763,4338,False
2017,03/05,Boston,1.3,9208,529716,5832,75014,535,0,Spring,84222,530251,5832,False
2017,02/26,Boston,1.24,11751,489161,5887,88862,3515,0,Winter,100613,492676,5887,False
2017,02/19,Boston,1.31,27790,391316,5419,88030,8569,0,Winter,115820,399885,5419,False
2017,02/12,Boston,1.12,83640,593329,11050,97915,5190,0,Winter,181555,598519,11050,False
2017,02/05,Boston,1.19,50889,594522,7080,119075,541,0,Winter,169964,595063,7080,False
2017,01/29,Boston,1.32,5792,464828,6111,126000,1373,0,Winter,131792,466201,6111,False
2017,01/22,Boston,1.26,4741,526892,11138,118685,2276,0,Winter,123426,529168,11138,False
2017,01/15,Boston,1.3,5430,457448,8522,106091,483,0,Winter,111521,457931,8522,False
2017,01/08,Boston,1.09,7543,605624,9300,107796,93,0,Winter,115339,605717,9300,False
2017,01/01,Boston,1.29,4119,371223,3933,79339,213,0,Winter,83458,371436,3933,False
2017,12/31,BuffaloRochester,1.27,5924,62632,25,37397,9529,0,Winter,43321,72161,25,False
2017,12/24,BuffaloRochester,1.28,7430,72517,27,43236,4163,0,Winter,50666,76680,27,False
2017,12/17,BuffaloRochester,1.26,7563,57326,39,38800,4622,0,Winter,46363,61948,39,False
2017,12/10,BuffaloRochester,1.25,7934,63389,61,51672,4220,0,Winter,59606,67609,61,False
2017,12/03,BuffaloRochester,1.13,7805,87461,42,54677,3297,0,Winter,62482,90758,42,False
2017,11/26,BuffaloRochester,1.23,6353,50509,26,40451,5319,0,Fall,46804,55828,26,False
2017,11/19,BuffaloRochester,1.3,8870,55800,75,36898,10802,0,Fall,45768,66602,75,False
2017,11/12,BuffaloRochester,1.37,10402,55305,48,45324,7354,0,Fall,55726,62659,48,False
2017,11/05,BuffaloRochester,1.37,9707,54119,58,19894,31804,46,Fall,29601,85923,104,False
2017,10/29,BuffaloRochester,1.36,11383,53894,38,15584,40914,0,Fall,26967,94808,38,False
2017,10/22,BuffaloRochester,1.5,24441,39988,61,21739,4679,0,Fall,46180,44667,61,False
2017,10/15,BuffaloRochester,1.5,26274,40394,32,14836,5341,0,Fall,41110,45735,32,False
2017,10/08,BuffaloRochester,1.49,25376,31576,38,25278,20353,0,Fall,50654,51929,38,False
2017,10/01,BuffaloRochester,1.53,22791,42861,36,16985,13615,0,Fall,39776,56476,36,False
2017,09/24,BuffaloRochester,1.42,11991,52356,31,50015,7107,0,Fall,62006,59463,31,False
2017,09/17,BuffaloRochester,1.37,7007,59413,47,60985,12841,356,Fall,67992,72254,403,False
2017,09/10,BuffaloRochester,1.46,2860,66980,31,63253,6368,2703,Fall,66113,73348,2734,False
2017,09/03,BuffaloRochester,1.56,2894,67610,39,56628,6698,1408,Fall,59522,74308,1447,False
2017,08/27,BuffaloRochester,1.33,1871,74398,19,71041,18,490,Summer,72912,74416,509,False
2017,08/20,BuffaloRochester,1.34,2619,71900,11,64906,102,2570,Summer,67525,72002,2581,False
2017,08/13,BuffaloRochester,1.32,2321,60729,18,79458,107,1983,Summer,81779,60836,2001,False
2017,08/06,BuffaloRochester,1.32,2068,78780,42,73066,84,1593,Summer,75134,78864,1635,False
2017,07/30,BuffaloRochester,1.32,1769,65452,40,76952,592,1263,Summer,78721,66044,1303,False
2017,07/23,BuffaloRochester,1.34,1917,67607,37,76394,331,1810,Summer,78311,67938,1847,False
2017,07/16,BuffaloRochester,1.35,1791,72328,35,68146,47,2411,Summer,69937,72375,2446,False
2017,07/09,BuffaloRochester,1.31,2075,80022,55,78261,641,5795,Summer,80336,80663,5850,False
2017,07/02,BuffaloRochester,1.34,1954,80410,105,55195,3167,3475,Summer,57149,83577,3580,False
2017,06/25,BuffaloRochester,1.46,1954,77254,59,32337,945,3350,Summer,34291,78199,3409,False
2017,06/18,BuffaloRochester,1.5,2124,82873,101,40583,700,3352,Summer,42707,83573,3453,False
2017,06/11,BuffaloRochester,1.62,1737,75551,78,30261,1937,4515,Summer,31998,77488,4593,False
2017,06/04,BuffaloRochester,1.6,1453,80512,57,59568,1656,1953,Summer,61021,82168,2010,False
2017,05/28,BuffaloRochester,1.64,1588,75152,109,81516,1153,963,Spring,83104,76305,1072,False
2017,05/21,BuffaloRochester,1.71,1486,72163,56,63239,2270,418,Spring,64725,74433,474,False
2017,05/14,BuffaloRochester,1.55,1761,66532,134,82649,1064,0,Spring,84410,67596,134,False
2017,05/07,BuffaloRochester,1.71,1772,87260,209,84212,1291,0,Spring,85984,88551,209,False
2017,04/30,BuffaloRochester,1.54,1803,83395,45,91172,2447,0,Spring,92975,85842,45,False
2017,04/23,BuffaloRochester,1.55,2554,70195,39,72228,2225,0,Spring,74782,72420,39,False
2017,04/16,BuffaloRochester,1.54,3103,70001,36,87097,5849,0,Spring,90200,75850,36,False
2017,04/09,BuffaloRochester,1.56,1954,80632,48,38343,51967,0,Spring,40297,132599,48,False
2017,04/02,BuffaloRochester,1.54,3854,73053,42,64653,25760,0,Spring,68507,98813,42,False
2017,03/26,BuffaloRochester,1.53,2184,67000,53,86727,821,0,Spring,88911,67821,53,False
2017,03/19,BuffaloRochester,1.54,1917,72621,74,73724,3121,0,Spring,75641,75742,74,False
2017,03/12,BuffaloRochester,1.48,1457,85677,28,56757,22055,0,Spring,58214,107732,28,False
2017,03/05,BuffaloRochester,1.68,1420,75283,46,63652,65,0,Spring,65072,75348,46,False
2017,02/26,BuffaloRochester,1.69,1195,71329,44,49518,206,0,Winter,50713,71535,44,False
2017,02/19,BuffaloRochester,1.68,1360,62449,33,44232,1732,0,Winter,45592,64181,33,False
2017,02/12,BuffaloRochester,1.56,1773,71050,110,58032,4319,0,Winter,59805,75369,110,False
2017,02/05,BuffaloRochester,1.4,1561,97167,116,89664,73,0,Winter,91225,97240,116,False
2017,01/29,BuffaloRochester,1.37,1541,72000,111,87723,1253,505,Winter,89264,73253,616,False
2017,01/22,BuffaloRochester,1.34,1691,70336,56,86197,2642,0,Winter,87888,72978,56,False
2017,01/15,BuffaloRochester,1.29,2011,68322,53,96319,1523,0,Winter,98330,69845,53,False
2017,01/08,BuffaloRochester,1.37,1506,83906,65,72703,85,0,Winter,74209,83991,65,False
2017,01/01,BuffaloRochester,1.43,1285,58531,102,45155,255,18,Winter,46440,58786,120,False
2017,12/31,Charlotte,0.93,60766,108930,6349,162934,7369,6,Winter,223700,116299,6355,False
2017,12/24,Charlotte,1.33,53317,58732,3839,63206,3441,0,Winter,116523,62173,3839,False
2017,12/17,Charlotte,1.26,58017,56564,3658,66708,4580,0,Winter,124725,61144,3658,False
2017,12/10,Charlotte,1.02,58726,60515,4428,146050,7808,0,Winter,204776,68323,4428,False
2017,12/03,Charlotte,1.26,58826,94262,4556,59298,3895,0,Winter,118124,98157,4556,False
2017,11/26,Charlotte,1.4,45363,56764,3742,61925,2619,0,Fall,107288,59383,3742,False
2017,11/19,Charlotte,1.4,47542,59312,3820,65221,3115,0,Fall,112763,62427,3820,False
2017,11/12,Charlotte,1.44,53681,65657,4551,62017,4539,0,Fall,115698,70196,4551,False
2017,11/05,Charlotte,1.47,46741,65173,4855,66781,3829,0,Fall,113522,69002,4855,False
2017,10/29,Charlotte,1.49,52951,62872,4716,56997,5687,0,Fall,109948,68559,4716,False
2017,10/22,Charlotte,1.64,44543,65040,4652,50704,3295,0,Fall,95247,68335,4652,False
2017,10/15,Charlotte,1.7,45266,68119,5567,49194,7172,2,Fall,94460,75291,5569,False
2017,10/08,Charlotte,1.77,50017,66076,4781,52744,5371,0,Fall,102761,71447,4781,False
2017,10/01,Charlotte,1.76,43576,74145,4797,52513,5246,0,Fall,96089,79391,4797,False
2017,09/24,Charlotte,1.72,47607,71519,5336,57929,4531,0,Fall,105536,76050,5336,False
2017,09/17,Charlotte,1.61,56017,64593,5176,62156,4502,0,Fall,118173,69095,5176,False
2017,09/10,Charlotte,1.69,45960,68912,5424,63280,3374,870,Fall,109240,72286,6294,False
2017,09/03,Charlotte,1.65,49285,69478,6029,67996,4698,3413,Fall,117281,74176,9442,False
2017,08/27,Charlotte,1.58,60886,65605,5772,69562,5067,1543,Summer,130448,70672,7315,False
2017,08/20,Charlotte,1.52,57230,69135,5602,71101,5397,4011,Summer,128331,74532,9613,False
2017,08/13,Charlotte,1.47,47263,78914,6255,67363,6829,3144,Summer,114626,85743,9399,False
2017,08/06,Charlotte,1.43,43174,78385,6519,71208,5682,1523,Summer,114382,84067,8042,False
2017,07/30,Charlotte,1.4,54840,81789,6237,63813,4829,1097,Summer,118653,86618,7334,False
2017,07/23,Charlotte,1.39,50924,75358,5993,75923,4233,3030,Summer,126847,79591,9023,False
2017,07/16,Charlotte,1.38,44530,73163,6036,77573,4561,3669,Summer,122103,77724,9705,False
2017,07/09,Charlotte,1.32,62331,70720,6490,73227,4767,4490,Summer,135558,75487,10980,False
2017,07/02,Charlotte,1.36,60811,76448,6627,71119,5358,4450,Summer,131930,81806,11077,False
2017,06/25,Charlotte,1.33,53140,72807,5877,72142,4877,2795,Summer,125282,77684,8672,False
2017,06/18,Charlotte,1.43,45497,78803,6332,62169,3515,5520,Summer,107666,82318,11852,False
2017,06/11,Charlotte,1.38,50865,86113,6816,69740,5812,4940,Summer,120605,91925,11756,False
2017,06/04,Charlotte,1.49,59349,86778,7005,65629,6092,1566,Summer,124978,92870,8571,False
2017,05/28,Charlotte,1.5,55170,89547,8529,80490,3625,0,Spring,135660,93172,8529,False
2017,05/21,Charlotte,1.5,56077,87872,7712,71310,4868,0,Spring,127387,92740,7712,False
2017,05/14,Charlotte,1.41,52616,77142,6721,83151,4994,0,Spring,135767,82136,6721,False
2017,05/07,Charlotte,1.36,76880,106192,11654,98860,9964,0,Spring,175740,116156,11654,False
2017,04/30,Charlotte,1.53,57129,87500,7990,73582,9496,0,Spring,130711,96996,7990,False
2017,04/23,Charlotte,1.5,48220,78264,7619,81393,5471,0,Spring,129613,83735,7619,False
2017,04/16,Charlotte,1.56,48494,77380,7459,66436,3448,0,Spring,114930,80828,7459,False
2017,04/09,Charlotte,1.54,50325,75492,6657,64339,4484,0,Spring,114664,79976,6657,False
2017,04/02,Charlotte,1.48,47420,85811,7802,85957,4258,177,Spring,133377,90069,7979,False
2017,03/26,Charlotte,1.48,48843,94477,7655,69700,4593,0,Spring,118543,99070,7655,False
2017,03/19,Charlotte,1.47,42389,89209,7312,63179,4642,0,Spring,105568,93851,7312,False
2017,03/12,Charlotte,1.55,48009,87659,8252,58990,4114,0,Spring,106999,91773,8252,False
2017,03/05,Charlotte,1.41,43409,87666,11157,56436,3883,0,Spring,99845,91549,11157,False
2017,02/26,Charlotte,1.26,50330,118606,13181,54950,4483,0,Winter,105280,123089,13181,False
2017,02/19,Charlotte,1.33,46010,78996,9650,59663,4224,13,Winter,105673,83220,9663,False
2017,02/12,Charlotte,1.25,58973,74076,8886,59465,5142,217,Winter,118438,79218,9103,False
2017,02/05,Charlotte,0.95,95176,172311,21721,56412,13627,452,Winter,151588,185938,22173,False
2017,01/29,Charlotte,1.33,48872,86135,9146,58828,9630,994,Winter,107700,95765,10140,False
2017,01/22,Charlotte,1.18,42582,116159,20382,54562,14067,0,Winter,97144,130226,20382,False
2017,01/15,Charlotte,1.37,39546,84479,9918,52626,10327,0,Winter,92172,94806,9918,False
2017,01/08,Charlotte,1.28,56739,80201,10231,63539,8626,0,Winter,120278,88827,10231,False
2017,01/01,Charlotte,1.21,47765,94571,15036,45920,13711,46,Winter,93685,108282,15082,False
2017,12/31,Chicago,0.93,144034,845964,120869,63314,8409,55,Winter,207348,854373,120924,False
2017,12/24,Chicago,1.36,83138,417905,116405,78806,11311,77,Winter,161944,429216,116482,False
2017,12/17,Chicago,1.49,113959,275986,99248,77380,53445,31,Winter,191339,329431,99279,False
2017,12/10,Chicago,1.13,142085,277789,90891,87489,423185,3,Winter,229574,700974,90894,False
2017,12/03,Chicago,1.56,99971,378155,92092,48070,36440,12,Winter,148041,414595,92104,False
2017,11/26,Chicago,1.7,71736,278263,82294,68552,5532,15,Fall,140288,283795,82309,False
2017,11/19,Chicago,1.71,86790,285841,98666,81798,2775,2,Fall,168588,288616,98668,False
2017,11/12,Chicago,1.78,90581,276787,91330,79021,3280,12,Fall,169602,280067,91342,False
2017,11/05,Chicago,1.77,96105,284220,81793,73426,3406,15,Fall,169531,287626,81808,False
2017,10/29,Chicago,1.94,117423,268773,88632,74126,2647,2,Fall,191549,271420,88634,False
2017,10/22,Chicago,2.06,84590,275588,95627,59543,4441,22,Fall,144133,280029,95649,False
2017,10/15,Chicago,2.11,89191,288024,93956,69716,5164,1,Fall,158907,293188,93957,False
2017,10/08,Chicago,2.22,62315,296817,87406,66070,3699,11,Fall,128385,300516,87417,False
2017,10/01,Chicago,2.14,73349,293404,85663,77980,7213,98,Fall,151329,300617,85761,False
2017,09/24,Chicago,2.07,79162,322016,61656,79455,9519,85,Fall,158617,331535,61741,False
2017,09/17,Chicago,2.15,59561,315414,100807,69984,7392,54,Fall,129545,322806,100861,False
2017,09/10,Chicago,2.02,65245,318095,114858,82436,7822,2131,Fall,147681,325917,116989,False
2017,09/03,Chicago,2.0,65246,343566,114879,79318,7988,3460,Fall,144564,351554,118339,False
2017,08/27,Chicago,1.93,87298,336708,115570,74670,8186,2183,Summer,161968,344894,117753,False
2017,08/20,Chicago,1.88,91477,349704,140354,79635,9073,4566,Summer,171112,358777,144920,False
2017,08/13,Chicago,1.89,64033,355733,135484,72282,8346,4473,Summer,136315,364079,139957,False
2017,08/06,Chicago,1.72,68696,401419,136884,71189,8973,4976,Summer,139885,410392,141860,False
2017,07/30,Chicago,1.62,76110,447892,134637,66465,7716,2443,Summer,142575,455608,137080,False
2017,07/23,Chicago,1.59,79551,459858,127440,73112,7949,4886,Summer,152663,467807,132326,False
2017,07/16,Chicago,1.54,91095,486178,129762,84928,5909,4014,Summer,176023,492087,133776,False
2017,07/09,Chicago,1.54,82890,504037,168507,122061,658,1952,Summer,204951,504695,170459,False
2017,07/02,Chicago,1.45,128743,534893,149582,128738,327,1462,Summer,257481,535220,151044,False
2017,06/25,Chicago,1.44,132426,473567,139914,119020,764,3078,Summer,251446,474331,142992,False
2017,06/18,Chicago,1.53,68578,549159,138493,103151,528,2471,Summer,171729,549687,140964,False
2017,06/11,Chicago,1.6,87526,514710,122729,76117,1456,4830,Summer,163643,516166,127559,False
2017,06/04,Chicago,1.64,79878,493631,132270,61829,2440,6144,Summer,141707,496071,138414,False
2017,05/28,Chicago,1.63,62151,538899,103858,69117,1927,5130,Spring,131268,540826,108988,False
2017,05/21,Chicago,1.64,67698,496380,123099,67000,2740,7323,Spring,134698,499120,130422,False
2017,05/14,Chicago,1.6,99653,470279,147524,68906,2127,4041,Spring,168559,472406,151565,False
2017,05/07,Chicago,1.51,133904,591928,162708,75728,2304,9510,Spring,209632,594232,172218,False
2017,04/30,Chicago,1.62,81817,498579,125905,72854,2421,5745,Spring,154671,501000,131650,False
2017,04/23,Chicago,1.63,81460,470214,94819,66653,1911,4307,Spring,148113,472125,99126,False
2017,04/16,Chicago,1.65,65083,490301,104457,75155,2307,5369,Spring,140238,492608,109826,False
2017,04/09,Chicago,1.65,70040,454691,102227,63362,2625,6644,Spring,133402,457316,108871,False
2017,04/02,Chicago,1.65,64888,452598,97671,56000,934,4207,Spring,120888,453532,101878,False
2017,03/26,Chicago,1.64,60039,432870,101928,56904,1563,3568,Spring,116943,434433,105496,False
2017,03/19,Chicago,1.64,61927,448962,103000,61719,814,2473,Spring,123646,449776,105473,False
2017,03/12,Chicago,1.66,59930,446178,105820,47528,1346,4560,Spring,107458,447524,110380,False
2017,03/05,Chicago,1.62,59136,454626,98165,62917,1104,4853,Spring,122053,455730,103018,False
2017,02/26,Chicago,1.61,52553,442525,110938,62915,1403,4489,Winter,115468,443928,115427,False
2017,02/19,Chicago,1.27,61491,461727,133540,64795,1514,5333,Winter,126286,463241,138873,False
2017,02/12,Chicago,1.05,144293,454380,187793,81975,2104,3801,Winter,226268,456484,191594,False
2017,02/05,Chicago,0.7,378806,912672,224554,94444,1936,8839,Winter,473250,914608,233393,False
2017,01/29,Chicago,1.1,86213,511365,135946,85615,1691,9667,Winter,171828,513056,145613,False
2017,01/22,Chicago,1.21,120093,497235,136328,83227,1680,6499,Winter,203320,498915,142827,False
2017,01/15,Chicago,1.23,78836,480071,142550,67302,1595,6465,Winter,146138,481666,149015,False
2017,01/08,Chicago,1.16,79629,499835,151447,81467,1420,8721,Winter,161096,501255,160168,False
2017,01/01,Chicago,1.15,87695,531287,114647,63550,1078,5089,Winter,151245,532365,119736,False
2017,12/31,CincinnatiDayton,0.86,86072,43570,18071,120022,10142,248,Winter,206094,53712,18319,False
2017,12/24,CincinnatiDayton,1.36,34443,41602,20559,48089,14510,32,Winter,82532,56112,20591,False
2017,12/17,CincinnatiDayton,1.3,21459,53838,9956,57656,26216,91,Winter,79115,80054,10047,False
2017,12/10,CincinnatiDayton,1.16,5977,88000,505,38355,101403,55,Winter,44332,189403,560,False
2017,12/03,CincinnatiDayton,1.05,5197,133150,1399,20306,142867,73,Winter,25503,276017,1472,False
2017,11/26,CincinnatiDayton,1.23,3566,62154,475,15934,82960,14,Fall,19500,145114,489,False
2017,11/19,CincinnatiDayton,1.01,4314,89762,793,19201,132886,203,Fall,23515,222648,996,False
2017,11/12,CincinnatiDayton,0.9,5473,119880,868,16033,182385,190,Fall,21506,302265,1058,False
2017,11/05,CincinnatiDayton,1.01,4581,121602,862,19496,173702,182,Fall,24077,295304,1044,False
2017,10/29,CincinnatiDayton,1.42,4682,80070,505,28319,119249,176,Fall,33001,199319,681,False
2017,10/22,CincinnatiDayton,1.75,4778,59196,377,31734,85072,43,Fall,36512,144268,420,False
2017,10/15,CincinnatiDayton,1.81,6137,59691,574,21562,94257,51,Fall,27699,153948,625,False
2017,10/08,CincinnatiDayton,1.9,6658,50674,588,19544,92860,39,Fall,26202,143534,627,False
2017,10/01,CincinnatiDayton,1.86,7514,58917,626,22881,93645,98,Fall,30395,152562,724,False
2017,09/24,CincinnatiDayton,1.79,4560,68227,614,22411,86693,206,Fall,26971,154920,820,False
2017,09/17,CincinnatiDayton,1.79,4223,69168,711,25990,84078,263,Fall,30213,153246,974,False
2017,09/10,CincinnatiDayton,1.75,4525,74602,668,28410,101680,292,Fall,32935,176282,960,False
2017,09/03,CincinnatiDayton,1.72,4651,73801,817,28780,104144,433,Fall,33431,177945,1250,False
2017,08/27,CincinnatiDayton,1.31,4199,88697,645,21251,138455,627,Summer,25450,227152,1272,False
2017,08/20,CincinnatiDayton,1.15,4339,107640,884,21955,172119,679,Summer,26294,279759,1563,False
2017,08/13,CincinnatiDayton,1.34,4609,92313,1103,21883,140667,576,Summer,26492,232980,1679,False
2017,08/06,CincinnatiDayton,1.46,4310,88272,1301,23000,119014,585,Summer,27310,207286,1886,False
2017,07/30,CincinnatiDayton,1.48,3801,82403,856,16005,109831,695,Summer,19806,192234,1551,False
2017,07/23,CincinnatiDayton,1.47,4245,85748,1095,14922,109212,442,Summer,19167,194960,1537,False
2017,07/16,CincinnatiDayton,1.5,3860,91780,1529,16210,104180,584,Summer,20070,195960,2113,False
2017,07/09,CincinnatiDayton,1.09,3260,95015,1259,38542,116563,611,Summer,41802,211578,1870,False
2017,07/02,CincinnatiDayton,0.79,3711,101205,1278,35260,193552,1079,Summer,38971,294757,2357,False
2017,06/25,CincinnatiDayton,0.8,4289,100910,1020,28717,201500,772,Summer,33006,302410,1792,False
2017,06/18,CincinnatiDayton,1.09,4452,110401,2143,33465,130291,730,Summer,37917,240692,2873,False
2017,06/11,CincinnatiDayton,0.87,7487,85499,1348,24201,245215,1256,Summer,31688,330714,2604,False
2017,06/04,CincinnatiDayton,1.0,11153,83649,1325,32810,208325,178,Summer,43963,291974,1503,False
2017,05/28,CincinnatiDayton,0.96,10451,76776,1279,34309,180475,148,Spring,44760,257251,1427,False
2017,05/21,CincinnatiDayton,1.0,7946,73693,1026,27839,150104,114,Spring,35785,223797,1140,False
2017,05/14,CincinnatiDayton,0.76,8786,87347,931,25076,191736,110,Spring,33862,279083,1041,False
2017,05/07,CincinnatiDayton,0.6,8438,131508,1302,33659,363468,142,Spring,42097,494976,1444,False
2017,04/30,CincinnatiDayton,1.1,11133,89607,1158,30877,109897,42,Spring,42010,199504,1200,False
2017,04/23,CincinnatiDayton,1.13,7434,68248,1022,29243,99417,35,Spring,36677,167665,1057,False
2017,04/16,CincinnatiDayton,1.06,7865,77040,1300,36250,138925,15,Spring,44115,215965,1315,False
2017,04/09,CincinnatiDayton,1.17,8795,76148,1214,30133,99467,89,Spring,38928,175615,1303,False
2017,04/02,CincinnatiDayton,1.01,7282,72866,1092,33461,175820,46,Spring,40743,248686,1138,False
2017,03/26,CincinnatiDayton,1.16,2737,75138,1185,30291,111860,1,Spring,33028,186998,1186,False
2017,03/19,CincinnatiDayton,0.95,2059,71214,1250,33907,155347,58,Spring,35966,226561,1308,False
2017,03/12,CincinnatiDayton,0.9,3110,77406,1153,28992,174289,46,Spring,32102,251695,1199,False
2017,03/05,CincinnatiDayton,0.78,2739,82627,1107,20142,166331,39,Spring,22881,248958,1146,False
2017,02/26,CincinnatiDayton,0.78,3306,108390,2024,28279,140287,56,Winter,31585,248677,2080,False
2017,02/19,CincinnatiDayton,0.7,2623,93502,1010,23085,182918,4,Winter,25708,276420,1014,False
2017,02/12,CincinnatiDayton,0.65,3907,131463,1679,30174,153260,7,Winter,34081,284723,1686,False
2017,02/05,CincinnatiDayton,0.65,3229,181550,3016,35158,188488,7,Winter,38387,370038,3023,False
2017,01/29,CincinnatiDayton,0.71,3040,118753,980,30234,172935,0,Winter,33274,291688,980,False
2017,01/22,CincinnatiDayton,0.69,3186,142025,2545,34561,198094,16,Winter,37747,340119,2561,False
2017,01/15,CincinnatiDayton,0.76,2939,125731,994,29095,187759,3,Winter,32034,313490,997,False
2017,01/08,CincinnatiDayton,0.82,4147,126967,991,33746,118612,562,Winter,37893,245579,1553,False
2017,01/01,CincinnatiDayton,0.64,2646,130250,2530,30669,163180,1,Winter,33315,293430,2531,False
2017,12/31,Columbus,0.8,103506,30763,5224,68828,12796,84,Winter,172334,43559,5308,False
2017,12/24,Columbus,1.06,47451,20793,5024,61296,5712,43,Winter,108747,26505,5067,False
2017,12/17,Columbus,1.03,55232,32627,5344,58821,10798,75,Winter,114053,43425,5419,False
2017,12/10,Columbus,1.1,62869,18377,1247,59594,7390,146,Winter,122463,25767,1393,False
2017,12/03,Columbus,0.99,74697,45552,2801,56452,15193,101,Winter,131149,60745,2902,False
2017,11/26,Columbus,1.04,60008,16437,984,38018,10872,59,Fall,98026,27309,1043,False
2017,11/19,Columbus,0.97,78940,14167,856,69169,6354,69,Fall,148109,20521,925,False
2017,11/12,Columbus,0.97,98437,14574,866,69587,12778,191,Fall,168024,27352,1057,False
2017,11/05,Columbus,0.96,108463,15618,911,91641,5898,216,Fall,200104,21516,1127,False
2017,10/29,Columbus,1.22,72722,18568,808,68103,4974,82,Fall,140825,23542,890,False
2017,10/22,Columbus,1.55,46747,15690,750,42964,5308,29,Fall,89711,20998,779,False
2017,10/15,Columbus,1.71,47436,16441,663,38814,6307,1,Fall,86250,22748,664,False
2017,10/08,Columbus,1.83,46870,8224,765,40288,6950,23,Fall,87158,15174,788,False
2017,10/01,Columbus,1.72,53367,13597,1131,42737,7359,150,Fall,96104,20956,1281,False
2017,09/24,Columbus,1.69,53450,16472,904,44515,5349,181,Fall,97965,21821,1085,False
2017,09/17,Columbus,1.7,51846,16291,935,44154,7205,166,Fall,96000,23496,1101,False
2017,09/10,Columbus,1.68,54122,19954,989,52387,7866,311,Fall,106509,27820,1300,False
2017,09/03,Columbus,1.62,53867,21626,1053,44365,6306,393,Fall,98232,27932,1446,False
2017,08/27,Columbus,1.26,86236,19787,1022,62542,6049,593,Summer,148778,25836,1615,False
2017,08/20,Columbus,1.23,93230,20982,988,88136,7448,492,Summer,181366,28430,1480,False
2017,08/13,Columbus,1.52,59728,19181,1136,62533,8290,519,Summer,122261,27471,1655,False
2017,08/06,Columbus,1.21,82089,24630,1148,78410,7851,628,Summer,160499,32481,1776,False
2017,07/30,Columbus,1.22,87045,20908,1144,52483,8793,416,Summer,139528,29701,1560,False
2017,07/23,Columbus,1.39,62106,20698,1069,48159,5227,521,Summer,110265,25925,1590,False
2017,07/16,Columbus,1.36,61744,28471,2046,49408,7883,1194,Summer,111152,36354,3240,False
2017,07/09,Columbus,0.95,94170,28458,1949,92651,22633,207,Summer,186821,51091,2156,False
2017,07/02,Columbus,0.85,109297,29874,1474,119449,15486,859,Summer,228746,45360,2333,False
2017,06/25,Columbus,0.86,100495,26548,1160,98172,17016,543,Summer,198667,43564,1703,False
2017,06/18,Columbus,0.81,115493,35647,2235,135610,14771,488,Summer,251103,50418,2723,False
2017,06/11,Columbus,0.98,82013,22618,1338,71041,3179,1062,Summer,153054,25797,2400,False
2017,06/04,Columbus,1.1,82888,20624,1780,85697,5341,59,Summer,168585,25965,1839,False
2017,05/28,Columbus,1.24,81187,20819,1809,56749,21930,70,Spring,137936,42749,1879,False
2017,05/21,Columbus,1.16,84951,22123,1875,62962,8171,198,Spring,147913,30294,2073,False
2017,05/14,Columbus,0.99,91332,15547,1391,94035,7984,57,Spring,185367,23531,1448,False
2017,05/07,Columbus,0.93,126893,33865,2805,104277,8431,147,Spring,231170,42296,2952,False
2017,04/30,Columbus,1.18,87269,27191,1849,75469,7759,103,Spring,162738,34950,1952,False
2017,04/23,Columbus,1.26,70224,19859,1525,72832,2452,24,Spring,143056,22311,1549,False
2017,04/16,Columbus,0.99,97052,23006,1563,118412,2679,6,Spring,215464,25685,1569,False
2017,04/09,Columbus,1.07,107031,23208,1696,91576,2306,24,Spring,198607,25514,1720,False
2017,04/02,Columbus,1.23,75024,25021,1682,70290,2942,15,Spring,145314,27963,1697,False
2017,03/26,Columbus,1.26,68172,23491,1510,57572,2766,0,Spring,125744,26257,1510,False
2017,03/19,Columbus,1.3,64865,24224,1373,43921,1946,39,Spring,108786,26170,1412,False
2017,03/12,Columbus,1.29,62328,32440,1275,40701,3271,108,Spring,103029,35711,1383,False
2017,03/05,Columbus,1.14,74969,29779,1538,54733,5134,12,Spring,129702,34913,1550,False
2017,02/26,Columbus,1.04,63979,49174,3873,66797,2588,15,Winter,130776,51762,3888,False
2017,02/19,Columbus,1.07,60793,31711,2015,62128,2406,0,Winter,122921,34117,2015,False
2017,02/12,Columbus,0.78,100274,43260,1988,76106,4894,1,Winter,176380,48154,1989,False
2017,02/05,Columbus,0.69,140453,60090,4269,114404,3809,2,Winter,254857,63899,4271,False
2017,01/29,Columbus,1.06,66807,32338,1335,54598,8001,4,Winter,121405,40339,1339,False
2017,01/22,Columbus,0.91,75919,47945,3811,65666,3727,1,Winter,141585,51672,3812,False
2017,01/15,Columbus,0.97,90931,32602,1593,65836,9154,108,Winter,156767,41756,1701,False
2017,01/08,Columbus,0.86,105022,34667,1761,81562,3205,0,Winter,186584,37872,1761,False
2017,01/01,Columbus,0.83,87684,50243,4324,73432,3196,0,Winter,161116,53439,4324,False
2017,12/31,DallasFtWorth,0.9,481105,307423,4818,161254,161616,174,Winter,642359,469039,4992,False
2017,12/24,DallasFtWorth,0.99,565235,203334,4651,204606,82552,75,Winter,769841,285886,4726,False
2017,12/17,DallasFtWorth,0.83,540252,217661,3860,262364,59824,105,Winter,802616,277485,3965,False
2017,12/10,DallasFtWorth,0.75,637875,219736,4749,358594,67257,66,Winter,996469,286993,4815,False
2017,12/03,DallasFtWorth,0.85,575766,258400,5217,278475,81498,67,Winter,854241,339898,5284,False
2017,11/26,DallasFtWorth,0.95,523362,160636,2920,130864,80717,49,Fall,654226,241353,2969,False
2017,11/19,DallasFtWorth,0.94,561075,167540,3568,137522,88658,57,Fall,698597,256198,3625,False
2017,11/12,DallasFtWorth,0.96,509106,271438,4615,120695,148352,121,Fall,629801,419790,4736,False
2017,11/05,DallasFtWorth,0.96,600272,245464,3677,104979,187840,264,Fall,705251,433304,3941,False
2017,10/29,DallasFtWorth,1.05,548902,213645,2639,180681,125267,209,Fall,729583,338912,2848,False
2017,10/22,DallasFtWorth,1.1,525021,186939,2275,252684,70932,77,Fall,777705,257871,2352,False
2017,10/15,DallasFtWorth,1.28,480909,174844,1813,147724,79245,93,Fall,628633,254089,1906,False
2017,10/08,DallasFtWorth,1.29,488695,194837,1217,149960,84717,280,Fall,638655,279554,1497,False
2017,10/01,DallasFtWorth,1.3,492841,170718,876,147483,81358,108,Fall,640324,252076,984,False
2017,09/24,DallasFtWorth,1.29,523101,168546,891,175955,77807,82,Fall,699056,246353,973,False
2017,09/17,DallasFtWorth,1.24,562493,181711,1213,161740,75613,59,Fall,724233,257324,1272,False
2017,09/10,DallasFtWorth,1.2,569828,167025,1360,179460,79463,136,Fall,749288,246488,1496,False
2017,09/03,DallasFtWorth,1.23,589764,185508,1205,188278,76730,1522,Fall,778042,262238,2727,False
2017,08/27,DallasFtWorth,1.13,631381,186107,1463,192595,78351,1067,Summer,823976,264458,2530,False
2017,08/20,DallasFtWorth,0.99,624826,228512,818,154837,153344,1126,Summer,779663,381856,1944,False
2017,08/13,DallasFtWorth,1.0,677058,260341,2582,157631,164728,1423,Summer,834689,425069,4005,False
2017,08/06,DallasFtWorth,0.98,663949,307186,2723,187977,90232,1467,Summer,851926,397418,4190,False
2017,07/30,DallasFtWorth,1.03,636100,259717,1707,169789,86836,82,Summer,805889,346553,1789,False
2017,07/23,DallasFtWorth,0.99,640831,275273,2162,181151,92258,6125,Summer,821982,367531,8287,False
2017,07/16,DallasFtWorth,0.98,572059,327858,2757,174975,140535,1706,Summer,747034,468393,4463,False
2017,07/09,DallasFtWorth,0.84,675094,287850,3155,542368,3088,2942,Summer,1217462,290938,6097,False
2017,07/02,DallasFtWorth,0.9,637767,287481,4000,445093,2978,1242,Summer,1082860,290459,5242,False
2017,06/25,DallasFtWorth,0.89,688781,221432,2113,410536,4154,148,Summer,1099317,225586,2261,False
2017,06/18,DallasFtWorth,0.9,734956,307811,4290,391342,3444,95,Summer,1126298,311255,4385,False
2017,06/11,DallasFtWorth,0.9,734135,231555,2332,390320,3337,92,Summer,1124455,234892,2424,False
2017,06/04,DallasFtWorth,0.93,712765,227992,2256,379395,3347,155,Summer,1092160,231339,2411,False
2017,05/28,DallasFtWorth,0.93,747618,269246,3945,363230,2841,23,Spring,1110848,272087,3968,False
2017,05/21,DallasFtWorth,0.91,728358,222773,2961,334652,2828,30,Spring,1063010,225601,2991,False
2017,05/14,DallasFtWorth,0.95,674072,238304,3363,372603,3655,71,Spring,1046675,241959,3434,False
2017,05/07,DallasFtWorth,0.89,824175,269156,2529,373862,4073,49,Spring,1198037,273229,2578,False
2017,04/30,DallasFtWorth,0.9,653423,337551,7032,405190,4155,137,Spring,1058613,341706,7169,False
2017,04/23,DallasFtWorth,0.85,673961,338732,5109,474435,3842,280,Spring,1148396,342574,5389,False
2017,04/16,DallasFtWorth,0.87,756530,289149,4244,463181,3860,212,Spring,1219711,293009,4456,False
2017,04/09,DallasFtWorth,0.9,710379,275048,8443,338910,4079,186,Spring,1049289,279127,8629,False
2017,04/02,DallasFtWorth,0.83,798833,216633,4975,347585,3931,289,Spring,1146418,220564,5264,False
2017,03/26,DallasFtWorth,0.91,700655,223658,4320,350221,3864,77,Spring,1050876,227522,4397,False
2017,03/19,DallasFtWorth,0.94,591093,237495,10579,311549,2865,116,Spring,902642,240360,10695,False
2017,03/12,DallasFtWorth,0.9,617249,200229,40164,310580,2337,79,Spring,927829,202566,40243,False
2017,03/05,DallasFtWorth,0.93,558906,208324,39374,296356,2050,70,Spring,855262,210374,39444,False
2017,02/26,DallasFtWorth,0.73,821922,198567,32790,292306,27130,94,Winter,1114228,225697,32884,False
2017,02/19,DallasFtWorth,0.76,501922,272758,48080,317473,37019,59,Winter,819395,309777,48139,False
2017,02/12,DallasFtWorth,0.7,624160,276020,46940,464056,10489,678,Winter,1088216,286509,47618,False
2017,02/05,DallasFtWorth,0.65,882268,362714,97315,352919,76779,503,Winter,1235187,439493,97818,False
2017,01/29,DallasFtWorth,0.73,789341,172742,36048,264359,43743,59,Winter,1053700,216485,36107,False
2017,01/22,DallasFtWorth,0.7,850531,222669,4457,302263,2962,81,Winter,1152794,225631,4538,False
2017,01/15,DallasFtWorth,0.7,750093,313392,2775,319826,3521,107,Winter,1069919,316913,2882,False
2017,01/08,DallasFtWorth,0.78,556814,343124,2551,341681,3247,69,Winter,898495,346371,2620,False
2017,01/01,DallasFtWorth,0.68,526727,438041,4254,364446,2152,916,Winter,891173,440193,5170,False
2017,12/31,Denver,0.94,127052,355322,8950,62602,384553,0,Winter,189654,739875,8950,False
2017,12/24,Denver,1.19,142027,171218,11713,104300,246332,1,Winter,246327,417550,11714,False
2017,12/17,Denver,1.13,157024,154962,12155,98284,224310,0,Winter,255308,379272,12155,False
2017,12/10,Denver,0.97,150700,330683,7679,131381,266397,0,Winter,282081,597080,7679,False
2017,12/03,Denver,1.1,149815,325073,9270,98904,266779,0,Winter,248719,591852,9270,False
2017,11/26,Denver,1.36,125916,171383,12038,93132,140775,0,Fall,219048,312158,12038,False
2017,11/19,Denver,1.13,132242,196662,15425,97734,258959,0,Fall,229976,455621,15425,False
2017,11/12,Denver,1.03,137872,269918,8942,102535,328570,0,Fall,240407,598488,8942,False
2017,11/05,Denver,1.07,122060,320967,8617,89816,393106,1,Fall,211876,714073,8618,False
2017,10/29,Denver,1.2,130556,226576,10872,92309,323624,0,Fall,222865,550200,10872,False
2017,10/22,Denver,1.43,126273,238205,6359,96160,171993,1,Fall,222433,410198,6360,False
2017,10/15,Denver,1.57,126304,158787,711,98271,153064,0,Fall,224575,311851,711,False
2017,10/08,Denver,1.6,133463,140121,177,102204,161965,0,Fall,235667,302086,177,False
2017,10/01,Denver,1.47,114291,249372,198,68911,172460,0,Fall,183202,421832,198,False
2017,09/24,Denver,1.6,125319,161435,191,75919,136894,0,Fall,201238,298329,191,False
2017,09/17,Denver,1.47,150991,156645,2422,113823,133330,0,Fall,264814,289975,2422,False
2017,09/10,Denver,1.56,114529,167203,12806,130758,159840,0,Fall,245287,327043,12806,False
2017,09/03,Denver,1.5,122402,165312,13836,108570,176544,1823,Fall,230972,341856,15659,False
2017,08/27,Denver,1.1,122874,379022,10439,99069,281790,2885,Summer,221943,660812,13324,False
2017,08/20,Denver,1.2,113449,324067,13424,88857,337802,1,Summer,202306,661869,13425,False
2017,08/13,Denver,1.46,148506,198503,11830,109341,165514,2208,Summer,257847,364017,14038,False
2017,08/06,Denver,1.43,145450,211822,13541,101540,163807,2725,Summer,246990,375629,16266,False
2017,07/30,Denver,1.19,145887,313773,12960,80821,233748,0,Summer,226708,547521,12960,False
2017,07/23,Denver,1.15,149313,353625,13389,86886,368135,0,Summer,236199,721760,13389,False
2017,07/16,Denver,1.46,108383,207831,14610,114962,196568,480,Summer,223345,404399,15090,False
2017,07/09,Denver,1.11,164106,267690,16221,192191,309207,1989,Summer,356297,576897,18210,False
2017,07/02,Denver,1.19,124815,182812,25202,167076,313376,259,Summer,291891,496188,25461,False
2017,06/25,Denver,1.17,165523,173432,20677,130071,352058,0,Summer,295594,525490,20677,False
2017,06/18,Denver,1.14,185315,198308,19386,129619,358058,35,Summer,314934,556366,19421,False
2017,06/11,Denver,1.18,192091,212252,21884,115180,330977,20,Summer,307271,543229,21904,False
2017,06/04,Denver,1.16,198732,179793,30183,200815,286070,0,Summer,399547,465863,30183,False
2017,05/28,Denver,1.19,172557,175140,24390,125061,338685,0,Spring,297618,513825,24390,False
2017,05/21,Denver,1.23,145486,205774,16548,90426,292464,0,Spring,235912,498238,16548,False
2017,05/14,Denver,1.23,166017,223913,18080,215216,158076,0,Spring,381233,381989,18080,False
2017,05/07,Denver,1.13,147250,357127,17250,272024,110311,133,Spring,419274,467438,17383,False
2017,04/30,Denver,1.33,145242,162526,23984,176258,195491,0,Spring,321500,358017,23984,False
2017,04/23,Denver,1.15,162809,163230,22772,88929,329199,0,Spring,251738,492429,22772,False
2017,04/16,Denver,1.23,164060,178842,23776,103004,343777,5,Spring,267064,522619,23781,False
2017,04/09,Denver,1.31,136193,164298,23358,117825,262684,0,Spring,254018,426982,23358,False
2017,04/02,Denver,1.33,150610,159643,22581,156262,192441,0,Spring,306872,352084,22581,False
2017,03/26,Denver,1.42,158588,150934,20052,144528,156827,0,Spring,303116,307761,20052,False
2017,03/19,Denver,1.32,152538,156751,19725,142550,206301,136,Spring,295088,363052,19861,False
2017,03/12,Denver,1.32,138467,157143,18699,134714,224576,0,Spring,273181,381719,18699,False
2017,03/05,Denver,1.32,142858,161939,18347,148831,167574,16,Spring,291689,329513,18363,False
2017,02/26,Denver,1.15,139037,237453,15021,214059,176671,0,Winter,353096,414124,15021,False
2017,02/19,Denver,1.07,153258,254318,17088,150957,223447,0,Winter,304215,477765,17088,False
2017,02/12,Denver,0.96,204917,291657,14706,109877,200109,322,Winter,314794,491766,15028,False
2017,02/05,Denver,0.77,239163,502457,14680,249329,253122,198,Winter,488492,755579,14878,False
2017,01/29,Denver,1.05,172614,214811,14725,315628,169960,224,Winter,488242,384771,14949,False
2017,01/22,Denver,1.03,149313,268029,13355,326361,149643,134,Winter,475674,417672,13489,False
2017,01/15,Denver,1.04,147752,212522,18135,255414,174946,0,Winter,403166,387468,18135,False
2017,01/08,Denver,0.92,169103,249167,16470,247424,162523,0,Winter,416527,411690,16470,False
2017,01/01,Denver,0.8,138364,336467,12664,310280,161495,97,Winter,448644,497962,12761,False
2017,12/31,Detroit,0.84,146333,91027,25276,161600,41058,2286,Winter,307933,132085,27562,False
2017,12/24,Detroit,1.25,50834,57335,15610,156973,16351,1041,Winter,207807,73686,16651,False
2017,12/17,Detroit,1.08,60128,98625,32609,149638,20548,7646,Winter,209766,119173,40255,False
2017,12/10,Detroit,1.13,89161,44929,10001,148544,16977,2334,Winter,237705,61906,12335,False
2017,12/03,Detroit,0.97,101693,183341,36621,120011,73013,1228,Winter,221704,256354,37849,False
2017,11/26,Detroit,1.21,71317,40629,7259,82401,27604,83,Fall,153718,68233,7342,False
2017,11/19,Detroit,0.99,112881,39979,7326,175882,17533,338,Fall,288763,57512,7664,False
2017,11/12,Detroit,0.93,163957,42219,8156,185753,32216,602,Fall,349710,74435,8758,False
2017,11/05,Detroit,1.0,154127,42917,7701,204821,16602,473,Fall,358948,59519,8174,False
2017,10/29,Detroit,1.28,91775,40457,8828,163758,10728,728,Fall,255533,51185,9556,False
2017,10/22,Detroit,1.59,57747,39113,10512,106301,15915,794,Fall,164048,55028,11306,False
2017,10/15,Detroit,1.79,57304,33515,10114,89625,13124,1694,Fall,146929,46639,11808,False
2017,10/08,Detroit,1.94,55417,17297,18345,98662,10865,7711,Fall,154079,28162,26056,False
2017,10/01,Detroit,1.88,56101,24145,19204,99539,8543,8306,Fall,155640,32688,27510,False
2017,09/24,Detroit,1.82,61575,32561,24622,100643,4399,10990,Fall,162218,36960,35612,False
2017,09/17,Detroit,1.84,56672,29720,23010,101940,8905,11422,Fall,158612,38625,34432,False
2017,09/10,Detroit,1.8,60774,32685,23392,113843,9150,11251,Fall,174617,41835,34643,False
2017,09/03,Detroit,1.68,58131,35365,25800,98010,5328,12294,Fall,156141,40693,38094,False
2017,08/27,Detroit,1.32,99924,29648,23558,133119,5877,11871,Summer,233043,35525,35429,False
2017,08/20,Detroit,1.25,113908,34529,26555,191985,8146,13125,Summer,305893,42675,39680,False
2017,08/13,Detroit,1.55,64304,33590,27839,137133,10425,13385,Summer,201437,44015,41224,False
2017,08/06,Detroit,1.25,101371,45320,41542,185661,7330,19519,Summer,287032,52650,61061,False
2017,07/30,Detroit,1.29,114942,39063,27664,133047,12487,12645,Summer,247989,51550,40309,False
2017,07/23,Detroit,1.55,66396,40479,30384,113415,2545,14033,Summer,179811,43024,44417,False
2017,07/16,Detroit,1.18,100370,55199,46609,155523,4802,23461,Summer,255893,60001,70070,False
2017,07/09,Detroit,0.99,119584,56064,43719,232206,28983,22217,Summer,351790,85047,65936,False
2017,07/02,Detroit,1.22,65065,63951,42737,183724,16727,20307,Summer,248789,80678,63044,False
2017,06/25,Detroit,1.01,96114,58116,14203,200994,31937,1548,Summer,297108,90053,15751,False
2017,06/18,Detroit,0.85,127581,129555,35982,349596,22971,3248,Summer,477177,152526,39230,False
2017,06/11,Detroit,1.28,71644,61426,17894,159993,2790,1491,Summer,231637,64216,19385,False
2017,06/04,Detroit,1.26,77883,57322,35156,174009,12147,4992,Summer,251892,69469,40148,False
2017,05/28,Detroit,1.29,83266,48464,42531,126219,47266,14157,Spring,209485,95730,56688,False
2017,05/21,Detroit,1.32,71333,44186,36112,123293,16846,15901,Spring,194626,61032,52013,False
2017,05/14,Detroit,1.03,110697,44186,40589,225833,13583,10459,Spring,336530,57769,51048,False
2017,05/07,Detroit,0.99,160714,82132,84740,259510,12354,26022,Spring,420224,94486,110762,False
2017,04/30,Detroit,1.48,64498,50224,37837,150695,11326,10400,Spring,215193,61550,48237,False
2017,04/23,Detroit,1.46,60299,42596,33427,144672,4014,10777,Spring,204971,46610,44204,False
2017,04/16,Detroit,1.45,68514,51563,38761,165252,3614,14839,Spring,233766,55177,53600,False
2017,04/09,Detroit,1.51,64658,48429,33629,123525,3833,10638,Spring,188183,52262,44267,False
2017,04/02,Detroit,1.48,65914,45497,33828,131639,3178,8581,Spring,197553,48675,42409,False
2017,03/26,Detroit,1.48,69601,44602,30844,125425,3129,15502,Spring,195026,47731,46346,False
2017,03/19,Detroit,1.48,71290,45054,26987,101931,3247,13604,Spring,173221,48301,40591,False
2017,03/12,Detroit,1.44,73391,40214,26073,80639,5789,12103,Spring,154030,46003,38176,False
2017,03/05,Detroit,0.97,117593,42026,24897,184674,2917,11061,Spring,302267,44943,35958,False
2017,02/26,Detroit,0.83,133389,105832,79598,186675,3009,31809,Winter,320064,108841,111407,False
2017,02/19,Detroit,1.07,82084,46507,20143,147195,3389,11950,Winter,229279,49896,32093,False
2017,02/12,Detroit,0.74,148920,87966,9992,212979,14028,1715,Winter,361899,101994,11707,False
2017,02/05,Detroit,0.65,214826,228906,25712,321790,6374,88,Winter,536616,235280,25800,False
2017,01/29,Detroit,1.01,125847,70435,6902,174385,3782,151,Winter,300232,74217,7053,False
2017,01/22,Detroit,0.84,129912,202323,25797,254296,3810,448,Winter,384208,206133,26245,False
2017,01/15,Detroit,0.98,124452,72303,7243,181789,11325,1,Winter,306241,83628,7244,False
2017,01/08,Detroit,0.9,157160,76519,7819,225725,3415,3,Winter,382885,79934,7822,False
2017,01/01,Detroit,0.75,100364,165059,18804,194306,2054,24,Winter,294670,167113,18828,False
2017,12/31,GrandRapids,1.09,2522,103361,58453,17391,4053,16852,Winter,19913,107414,75305,False
2017,12/24,GrandRapids,1.64,2190,59470,28289,29812,4900,6073,Winter,32002,64370,34362,False
2017,12/17,GrandRapids,1.25,2042,74185,48181,21582,3918,13013,Winter,23624,78103,61194,False
2017,12/10,GrandRapids,1.61,2211,52467,17501,25029,5916,3892,Winter,27240,58383,21393,False
2017,12/03,GrandRapids,0.99,2268,182507,65476,14813,26632,9831,Winter,17081,209139,75307,False
2017,11/26,GrandRapids,1.65,1864,50330,11404,22505,10417,180,Fall,24369,60747,11584,False
2017,11/19,GrandRapids,1.4,2688,68242,15683,42924,7407,2335,Fall,45612,75649,18018,False
2017,11/12,GrandRapids,1.59,2585,49202,17062,31462,8517,1957,Fall,34047,57719,19019,False
2017,11/05,GrandRapids,1.7,2335,46898,18583,26098,7766,2033,Fall,28433,54664,20616,False
2017,10/29,GrandRapids,1.55,2263,65813,21510,40970,2846,4784,Fall,43233,68659,26294,False
2017,10/22,GrandRapids,1.96,2538,37656,21937,27100,2690,5208,Fall,29638,40346,27145,False
2017,10/15,GrandRapids,2.07,3559,37970,18550,27063,1681,5244,Fall,30622,39651,23794,False
2017,10/08,GrandRapids,2.19,2689,30568,19624,25625,2275,5970,Fall,28314,32843,25594,False
2017,10/01,GrandRapids,2.09,3178,35898,19397,30261,2715,5960,Fall,33439,38613,25357,False
2017,09/24,GrandRapids,1.96,2101,48552,24966,26290,3741,7620,Fall,28391,52293,32586,False
2017,09/17,GrandRapids,1.99,1713,40378,23054,25043,2910,7397,Fall,26756,43288,30451,False
2017,09/10,GrandRapids,1.86,2360,46227,23127,29053,3726,7238,Fall,31413,49953,30365,False
2017,09/03,GrandRapids,1.65,2659,52612,28692,30195,4062,8925,Fall,32854,56674,37617,False
2017,08/27,GrandRapids,1.74,1978,45102,25971,26953,3478,8538,Summer,28931,48580,34509,False
2017,08/20,GrandRapids,1.7,2503,47876,29038,30576,5002,9910,Summer,33079,52878,38948,False
2017,08/13,GrandRapids,1.7,3912,48945,30208,29466,3459,9219,Summer,33378,52404,39427,False
2017,08/06,GrandRapids,1.45,2082,69687,45132,31734,4280,14317,Summer,33816,73967,59449,False
2017,07/30,GrandRapids,1.63,2162,49417,30794,30869,5476,8882,Summer,33031,54893,39676,False
2017,07/23,GrandRapids,1.68,2240,56572,33294,29974,4228,9776,Summer,32214,60800,43070,False
2017,07/16,GrandRapids,1.42,2520,70377,52300,25053,4106,15478,Summer,27573,74483,67778,False
2017,07/09,GrandRapids,1.43,2225,71380,47480,38785,3403,14910,Summer,41010,74783,62390,False
2017,07/02,GrandRapids,1.51,2073,71125,51887,45887,4128,16905,Summer,47960,75253,68792,False
2017,06/25,GrandRapids,1.74,2010,54017,29866,42161,4631,9570,Summer,44171,58648,39436,False
2017,06/18,GrandRapids,1.29,2180,96015,81813,38840,2445,23997,Summer,41020,98460,105810,False
2017,06/11,GrandRapids,1.79,2308,64251,34921,40421,6310,10663,Summer,42729,70561,45584,False
2017,06/04,GrandRapids,1.88,2254,74167,35468,34931,7483,7745,Summer,37185,81650,43213,False
2017,05/28,GrandRapids,1.85,1824,70747,36364,41977,6300,8503,Spring,43801,77047,44867,False
2017,05/21,GrandRapids,1.88,1972,64369,30992,35805,6312,9047,Spring,37777,70681,40039,False
2017,05/14,GrandRapids,1.87,1659,68015,33883,35585,6715,5413,Spring,37244,74730,39296,False
2017,05/07,GrandRapids,1.46,2037,134403,68209,30912,6939,12479,Spring,32949,141342,80688,False
2017,04/30,GrandRapids,1.83,2008,72819,33054,36778,7109,6097,Spring,38786,79928,39151,False
2017,04/23,GrandRapids,1.67,1826,67510,28859,32757,6398,8671,Spring,34583,73908,37530,False
2017,04/16,GrandRapids,1.67,1857,80672,34537,39418,6580,12794,Spring,41275,87252,47331,False
2017,04/09,GrandRapids,1.73,2187,69915,29243,30183,6762,6068,Spring,32370,76677,35311,False
2017,04/02,GrandRapids,1.73,1804,68299,25528,31734,5315,7948,Spring,33538,73614,33476,False
2017,03/26,GrandRapids,1.71,1890,71916,25542,32426,6541,11161,Spring,34316,78457,36703,False
2017,03/19,GrandRapids,1.73,1749,70210,23436,30574,6156,9585,Spring,32323,76366,33021,False
2017,03/12,GrandRapids,1.73,1645,64057,21287,26704,7110,9016,Spring,28349,71167,30303,False
2017,03/05,GrandRapids,1.5,1498,59098,17801,28414,14185,7206,Spring,29912,73283,25007,False
2017,02/26,GrandRapids,1.02,1386,140947,48369,25307,4248,18045,Winter,26693,145195,66414,False
2017,02/19,GrandRapids,1.42,1224,80219,17743,28012,4266,10309,Winter,29236,84485,28052,False
2017,02/12,GrandRapids,1.13,1277,107963,8309,49076,6314,3648,Winter,50353,114277,11957,False
2017,02/05,GrandRapids,0.81,1573,298897,8303,78260,3910,367,Winter,79833,302807,8670,False
2017,01/29,GrandRapids,1.29,1391,100681,5482,53182,6877,637,Winter,54573,107558,6119,False
2017,01/22,GrandRapids,0.92,1152,227003,12962,72435,6021,2790,Winter,73587,233024,15752,False
2017,01/15,GrandRapids,1.29,935,107348,2863,49537,5423,50,Winter,50472,112771,2913,False
2017,01/08,GrandRapids,1.26,1225,102134,3082,60761,6851,22,Winter,61986,108985,3104,False
2017,01/01,GrandRapids,0.77,1217,224774,7582,68737,3714,103,Winter,69954,228488,7685,False
2017,12/31,HarrisburgScranton,1.37,35962,106173,56,41330,12373,0,Winter,77292,118546,56,False
2017,12/24,HarrisburgScranton,1.37,37343,115065,82,61171,4306,0,Winter,98514,119371,82,False
2017,12/17,HarrisburgScranton,1.37,35590,101937,71,54104,5041,0,Winter,89694,106978,71,False
2017,12/10,HarrisburgScranton,1.13,43089,163729,84,62282,5753,0,Winter,105371,169482,84,False
2017,12/03,HarrisburgScranton,1.27,39382,127730,91,57036,7738,0,Winter,96418,135468,91,False
2017,11/26,HarrisburgScranton,1.3,30488,89564,97,55196,16146,0,Fall,85684,105710,97,False
2017,11/19,HarrisburgScranton,1.3,30820,97308,125,59742,28613,0,Fall,90562,125921,125,False
2017,11/12,HarrisburgScranton,1.38,31166,99684,74,54249,16269,0,Fall,85415,115953,74,False
2017,11/05,HarrisburgScranton,1.45,31048,99317,76,58486,2505,26,Fall,89534,101822,102,False
2017,10/29,HarrisburgScranton,1.47,30541,117170,36,54995,282,0,Fall,85536,117452,36,False
2017,10/22,HarrisburgScranton,1.43,30373,111836,29,62343,1531,0,Fall,92716,113367,29,False
2017,10/15,HarrisburgScranton,1.48,32691,112916,74,48527,11649,0,Fall,81218,124565,74,False
2017,10/08,HarrisburgScranton,1.54,34256,79474,139,46034,4794,0,Fall,80290,84268,139,False
2017,10/01,HarrisburgScranton,1.45,37491,115716,192,56521,4030,0,Fall,94012,119746,192,False
2017,09/24,HarrisburgScranton,1.44,36336,122032,70,50219,1319,3,Fall,86555,123351,73,False
2017,09/17,HarrisburgScranton,1.46,32973,107531,54,47545,763,166,Fall,80518,108294,220,False
2017,09/10,HarrisburgScranton,1.51,32675,97799,61,44252,1741,4343,Fall,76927,99540,4404,False
2017,09/03,HarrisburgScranton,1.53,39153,117858,49,52253,599,2913,Fall,91406,118457,2962,False
2017,08/27,HarrisburgScranton,1.48,40614,112224,30,60211,245,730,Summer,100825,112469,760,False
2017,08/20,HarrisburgScranton,1.47,40413,104200,62,60759,3437,4062,Summer,101172,107637,4124,False
2017,08/13,HarrisburgScranton,1.43,42116,127782,58,55944,9001,3326,Summer,98060,136783,3384,False
2017,08/06,HarrisburgScranton,1.37,42012,129112,58,59348,2124,3246,Summer,101360,131236,3304,False
2017,07/30,HarrisburgScranton,1.36,41369,115565,55,64199,285,1283,Summer,105568,115850,1338,False
2017,07/23,HarrisburgScranton,1.38,44426,116786,100,58580,1086,3226,Summer,103006,117872,3326,False
2017,07/16,HarrisburgScranton,1.38,42951,120360,131,53141,3621,4228,Summer,96092,123981,4359,False
2017,07/09,HarrisburgScranton,1.47,41065,129466,176,49614,8987,8135,Summer,90679,138453,8311,False
2017,07/02,HarrisburgScranton,1.48,40997,111399,155,61049,5973,6540,Summer,102046,117372,6695,False
2017,06/25,HarrisburgScranton,1.46,40132,121032,92,52906,2108,6175,Summer,93038,123140,6267,False
2017,06/18,HarrisburgScranton,1.5,45186,131057,86,55129,2569,4358,Summer,100315,133626,4444,False
2017,06/11,HarrisburgScranton,1.5,50902,115824,93,58868,4122,2916,Summer,109770,119946,3009,False
2017,06/04,HarrisburgScranton,1.55,50484,118452,139,75848,1879,256,Summer,126332,120331,395,False
2017,05/28,HarrisburgScranton,1.56,53527,137082,170,80202,4474,30,Spring,133729,141556,200,False
2017,05/21,HarrisburgScranton,1.51,52736,119601,179,70371,1749,0,Spring,123107,121350,179,False
2017,05/14,HarrisburgScranton,1.54,52237,95012,152,90107,1469,56,Spring,142344,96481,208,False
2017,05/07,HarrisburgScranton,1.51,53636,140316,208,101118,5671,229,Spring,154754,145987,437,False
2017,04/30,HarrisburgScranton,1.48,54369,135977,123,76015,2179,166,Spring,130384,138156,289,False
2017,04/23,HarrisburgScranton,1.49,53508,103642,52,61430,7047,0,Spring,114938,110689,52,False
2017,04/16,HarrisburgScranton,1.56,50600,123726,83,74662,12787,0,Spring,125262,136513,83,False
2017,04/09,HarrisburgScranton,1.48,47837,121350,124,78470,3892,0,Spring,126307,125242,124,False
2017,04/02,HarrisburgScranton,1.46,53424,110824,74,73919,1170,0,Spring,127343,111994,74,False
2017,03/26,HarrisburgScranton,1.38,52944,131659,340,68119,1536,0,Spring,121063,133195,340,False
2017,03/19,HarrisburgScranton,1.4,59161,118545,245,58499,6729,84,Spring,117660,125274,329,False
2017,03/12,HarrisburgScranton,1.42,51306,126552,107,64446,3514,0,Spring,115752,130066,107,False
2017,03/05,HarrisburgScranton,1.19,53961,151537,745,66399,841,0,Spring,120360,152378,745,False
2017,02/26,HarrisburgScranton,1.29,52855,139066,100,66310,2332,77,Winter,119165,141398,177,False
2017,02/19,HarrisburgScranton,1.28,56042,104680,184,61717,1915,0,Winter,117759,106595,184,False
2017,02/12,HarrisburgScranton,1.13,105170,106548,367,57944,6589,134,Winter,163114,113137,501,False
2017,02/05,HarrisburgScranton,1.14,117876,153442,4525,67100,5107,329,Winter,184976,158549,4854,False
2017,01/29,HarrisburgScranton,1.25,64322,129735,1855,70448,1418,136,Winter,134770,131153,1991,False
2017,01/22,HarrisburgScranton,1.4,49774,135845,3688,74174,3242,126,Winter,123948,139087,3814,False
2017,01/15,HarrisburgScranton,1.44,47536,126095,791,75330,1793,0,Winter,122866,127888,791,False
2017,01/08,HarrisburgScranton,1.3,51590,153751,98,67890,1733,0,Winter,119480,155484,98,False
2017,01/01,HarrisburgScranton,1.35,41800,136109,420,52817,4281,0,Winter,94617,140390,420,False
2017,12/31,HartfordSpringfield,1.42,4805,183945,178,48824,7447,1,Winter,53629,191392,179,False
2017,12/24,HartfordSpringfield,1.5,5610,161963,198,53040,5162,15,Winter,58650,167125,213,False
2017,12/17,HartfordSpringfield,1.44,6271,160129,112,56644,5133,0,Winter,62915,165262,112,False
2017,12/10,HartfordSpringfield,1.14,18098,359319,162,58863,10673,6,Winter,76961,369992,168,False
2017,12/03,HartfordSpringfield,1.55,5716,166828,171,47328,11166,0,Winter,53044,177994,171,False
2017,11/26,HartfordSpringfield,1.38,5695,153323,88,42139,28155,0,Fall,47834,181478,88,False
2017,11/19,HartfordSpringfield,1.38,4591,169972,131,61128,28942,0,Fall,65719,198914,131,False
2017,11/12,HartfordSpringfield,1.56,6490,162389,206,55528,2253,0,Fall,62018,164642,206,False
2017,11/05,HartfordSpringfield,1.53,5209,161648,106,62768,10883,0,Fall,67977,172531,106,False
2017,10/29,HartfordSpringfield,1.53,5938,188044,173,51182,2607,0,Fall,57120,190651,173,False
2017,10/22,HartfordSpringfield,1.5,7441,179802,151,55717,1673,0,Fall,63158,181475,151,False
2017,10/15,HartfordSpringfield,1.58,7043,177668,73,49691,2127,0,Fall,56734,179795,73,False
2017,10/08,HartfordSpringfield,1.6,7540,159211,174,50139,921,0,Fall,57679,160132,174,False
2017,10/01,HartfordSpringfield,1.6,6770,189987,76,51546,1676,0,Fall,58316,191663,76,False
2017,09/24,HartfordSpringfield,1.59,4809,181192,81,41353,1178,0,Fall,46162,182370,81,False
2017,09/17,HartfordSpringfield,1.54,7488,162728,73,50193,2102,6,Fall,57681,164830,79,False
2017,09/10,HartfordSpringfield,1.57,5195,182049,130,52068,2423,1266,Fall,57263,184472,1396,False
2017,09/03,HartfordSpringfield,1.74,4476,165217,79,52916,345,1600,Fall,57392,165562,1679,False
2017,08/27,HartfordSpringfield,1.78,4245,160115,67,55270,377,443,Summer,59515,160492,510,False
2017,08/20,HartfordSpringfield,1.74,3659,155326,79,59503,3259,1790,Summer,63162,158585,1869,False
2017,08/13,HartfordSpringfield,1.63,4240,193118,164,49438,14192,2469,Summer,53678,207310,2633,False
2017,08/06,HartfordSpringfield,1.6,5057,200007,223,52868,2359,1787,Summer,57925,202366,2010,False
2017,07/30,HartfordSpringfield,1.56,5477,190639,130,59706,1314,896,Summer,65183,191953,1026,False
2017,07/23,HartfordSpringfield,1.59,8142,201585,62,49946,3071,1500,Summer,58088,204656,1562,False
2017,07/16,HartfordSpringfield,1.59,10004,205771,129,46745,1544,1420,Summer,56749,207315,1549,False
2017,07/09,HartfordSpringfield,1.72,10848,198967,142,56481,3381,3240,Summer,67329,202348,3382,False
2017,07/02,HartfordSpringfield,1.76,9173,191483,549,46887,8666,3022,Summer,56060,200149,3571,False
2017,06/25,HartfordSpringfield,1.68,8658,220849,134,42685,670,2915,Summer,51343,221519,3049,False
2017,06/18,HartfordSpringfield,1.79,5734,195637,124,52477,86,2840,Summer,58211,195723,2964,False
2017,06/11,HartfordSpringfield,1.75,11601,218427,135,62894,6,3108,Summer,74495,218433,3243,False
2017,06/04,HartfordSpringfield,1.81,10922,216912,148,59149,0,1383,Summer,70071,216912,1531,False
2017,05/28,HartfordSpringfield,1.85,10672,225753,210,67319,27,356,Spring,77991,225780,566,False
2017,05/21,HartfordSpringfield,1.8,10370,208423,169,59724,245,153,Spring,70094,208668,322,False
2017,05/14,HartfordSpringfield,1.76,4501,193014,269,85671,1111,713,Spring,90172,194125,982,False
2017,05/07,HartfordSpringfield,1.61,6754,251849,310,109324,974,284,Spring,116078,252823,594,False
2017,04/30,HartfordSpringfield,1.66,7020,234305,228,56541,2215,0,Spring,63561,236520,228,False
2017,04/23,HartfordSpringfield,1.76,8180,201383,202,51718,5982,0,Spring,59898,207365,202,False
2017,04/16,HartfordSpringfield,1.8,6808,189287,128,56049,5132,0,Spring,62857,194419,128,False
2017,04/09,HartfordSpringfield,1.74,7409,199909,161,76173,867,0,Spring,83582,200776,161,False
2017,04/02,HartfordSpringfield,1.71,10131,204310,345,53650,653,0,Spring,63781,204963,345,False
2017,03/26,HartfordSpringfield,1.58,7860,203663,1524,56284,862,202,Spring,64144,204525,1726,False
2017,03/19,HartfordSpringfield,1.66,5615,195073,691,46606,5852,0,Spring,52221,200925,691,False
2017,03/12,HartfordSpringfield,1.65,4902,186372,162,56747,620,0,Spring,61649,186992,162,False
2017,03/05,HartfordSpringfield,1.25,8437,316785,265,46650,1785,0,Spring,55087,318570,265,False
2017,02/26,HartfordSpringfield,1.59,11083,193422,350,51393,3068,0,Winter,62476,196490,350,False
2017,02/19,HartfordSpringfield,1.3,30000,167971,598,45723,4491,243,Winter,75723,172462,841,False
2017,02/12,HartfordSpringfield,1.14,85641,249990,2290,54676,2761,619,Winter,140317,252751,2909,False
2017,02/05,HartfordSpringfield,1.2,52460,356398,23027,49803,3869,982,Winter,102263,360267,24009,False
2017,01/29,HartfordSpringfield,1.46,4741,220159,3935,62167,1025,680,Winter,66908,221184,4615,False
2017,01/22,HartfordSpringfield,1.47,4349,247185,13325,65059,1897,854,Winter,69408,249082,14179,False
2017,01/15,HartfordSpringfield,1.43,4665,223678,7893,46455,1319,374,Winter,51120,224997,8267,False
2017,01/08,HartfordSpringfield,1.25,5105,315473,306,47415,1168,0,Winter,52520,316641,306,False
2017,01/01,HartfordSpringfield,1.64,2772,188107,2695,38034,919,133,Winter,40806,189026,2828,False
2017,12/31,Houston,0.78,564063,209000,4194,527743,86179,0,Winter,1091806,295179,4194,False
2017,12/24,Houston,0.99,486643,150511,3020,327462,95743,3,Winter,814105,246254,3023,False
2017,12/17,Houston,0.98,429276,184347,2606,218017,94469,0,Winter,647293,278816,2606,False
2017,12/10,Houston,0.79,459265,294180,6828,416839,89251,0,Winter,876104,383431,6828,False
2017,12/03,Houston,0.77,540763,289729,7694,479680,80533,0,Winter,1020443,370262,7694,False
2017,11/26,Houston,0.88,501157,134619,2692,264827,88252,0,Fall,765984,222871,2692,False
2017,11/19,Houston,0.89,620361,134476,2776,298259,86254,0,Fall,918620,220730,2776,False
2017,11/12,Houston,0.88,514065,251034,6534,416893,68334,37,Fall,930958,319368,6571,False
2017,11/05,Houston,0.95,526090,264224,4359,428438,137878,2270,Fall,954528,402102,6629,False
2017,10/29,Houston,1.12,481864,189258,2105,264530,188243,400,Fall,746394,377501,2505,False
2017,10/22,Houston,1.16,492168,128029,1834,298349,87975,0,Fall,790517,216004,1834,False
2017,10/15,Houston,1.26,476686,149935,1866,310037,91030,0,Fall,786723,240965,1866,False
2017,10/08,Houston,1.29,491561,146966,1449,320849,81873,0,Fall,812410,228839,1449,False
2017,10/01,Houston,1.29,472251,141695,2169,291964,83858,0,Fall,764215,225553,2169,False
2017,09/24,Houston,1.25,470511,145808,1812,262287,69350,0,Fall,732798,215158,1812,False
2017,09/17,Houston,1.2,460806,171011,2264,229435,100937,3,Fall,690241,271948,2267,False
2017,09/10,Houston,1.1,606027,165584,2452,259297,104954,0,Fall,865324,270538,2452,False
2017,09/03,Houston,1.19,426423,171139,1860,172564,79904,217,Fall,598987,251043,2077,False
2017,08/27,Houston,1.16,510226,195358,1867,293696,108227,536,Summer,803922,303585,2403,False
2017,08/20,Houston,1.01,458024,216584,1575,230159,189883,0,Summer,688183,406467,1575,False
2017,08/13,Houston,0.99,406049,395755,6723,224811,298894,0,Summer,630860,694649,6723,False
2017,08/06,Houston,0.99,552895,251754,3739,246147,138352,0,Summer,799042,390106,3739,False
2017,07/30,Houston,1.0,536258,203627,2676,247453,127329,0,Summer,783711,330956,2676,False
2017,07/23,Houston,1.02,510127,214165,3006,240331,121091,70,Summer,750458,335256,3076,False
2017,07/16,Houston,1.01,475986,251487,4545,279519,131771,0,Summer,755505,383258,4545,False
2017,07/09,Houston,0.78,565234,223073,3020,334967,387301,0,Summer,900201,610374,3020,False
2017,07/02,Houston,0.83,559731,240188,4720,276152,267556,302,Summer,835883,507744,5022,False
2017,06/25,Houston,0.82,569850,285476,2928,188282,305777,3,Summer,758132,591253,2931,False
2017,06/18,Houston,0.77,583952,412002,7010,201968,550383,13,Summer,785920,962385,7023,False
2017,06/11,Houston,0.89,627610,201534,5451,200221,205490,0,Summer,827831,407024,5451,False
2017,06/04,Houston,0.83,603106,192105,4926,357447,219944,0,Summer,960553,412049,4926,False
2017,05/28,Houston,0.87,627786,268181,5549,187986,225754,0,Spring,815772,493935,5549,False
2017,05/21,Houston,0.83,579270,219956,3706,190861,268681,0,Spring,770131,488637,3706,False
2017,05/14,Houston,0.79,625728,231431,3248,262815,320799,0,Spring,888543,552230,3248,False
2017,05/07,Houston,0.74,732114,350523,3364,232259,470789,0,Spring,964373,821312,3364,False
2017,04/30,Houston,0.72,576270,451254,10440,164674,629791,19,Spring,740944,1081045,10459,False
2017,04/23,Houston,0.68,665435,352920,5646,224693,527525,0,Spring,890128,880445,5646,False
2017,04/16,Houston,0.76,820487,207708,3383,312771,58553,0,Spring,1133258,266261,3383,False
2017,04/09,Houston,0.81,684059,272460,7690,204288,76195,0,Spring,888347,348655,7690,False
2017,04/02,Houston,0.7,879079,183771,3906,316601,159683,6,Spring,1195680,343454,3912,False
2017,03/26,Houston,0.83,663134,182628,5896,203295,19565,0,Spring,866429,202193,5896,False
2017,03/19,Houston,0.85,653306,183349,21365,157513,998,3,Spring,810819,184347,21368,False
2017,03/12,Houston,0.9,619358,151499,29781,101884,1062,0,Spring,721242,152561,29781,False
2017,03/05,Houston,0.74,697103,161909,40611,209810,1458,3,Spring,906913,163367,40614,False
2017,02/26,Houston,0.53,1067091,116819,42393,292106,28925,0,Winter,1359197,145744,42393,False
2017,02/19,Houston,0.67,565042,142847,63757,291927,127089,44,Winter,856969,269936,63801,False
2017,02/12,Houston,0.58,781130,148459,71472,278125,141599,23,Winter,1059255,290058,71495,False
2017,02/05,Houston,0.55,1026765,406006,140962,316097,88069,22,Winter,1342862,494075,140984,False
2017,01/29,Houston,0.7,789020,215934,58981,74838,119674,32,Winter,863858,335608,59013,False
2017,01/22,Houston,0.68,798585,170357,4719,79246,66254,3,Winter,877831,236611,4722,False
2017,01/15,Houston,0.53,1134750,184545,2711,242009,49139,3,Winter,1376759,233684,2714,False
2017,01/08,Houston,0.57,933181,198434,2690,190479,92420,0,Winter,1123660,290854,2690,False
2017,01/01,Houston,0.51,985040,290583,6313,62497,131305,0,Winter,1047537,421888,6313,False
2017,12/31,Indianapolis,0.96,67904,57394,13768,59516,6575,42,Winter,127420,63969,13810,False
2017,12/24,Indianapolis,1.3,22248,58457,12103,47670,7840,67,Winter,69918,66297,12170,False
2017,12/17,Indianapolis,1.26,18371,58045,9259,48938,9311,48,Winter,67309,67356,9307,False
2017,12/10,Indianapolis,1.26,9368,83042,1754,37305,36372,47,Winter,46673,119414,1801,False
2017,12/03,Indianapolis,1.25,8806,103238,2338,23489,44956,64,Winter,32295,148194,2402,False
2017,11/26,Indianapolis,1.4,7132,51923,608,25102,30900,23,Fall,32234,82823,631,False
2017,11/19,Indianapolis,1.08,7408,76810,613,42396,51103,106,Fall,49804,127913,719,False
2017,11/12,Indianapolis,1.03,11814,89236,1037,36175,63702,165,Fall,47989,152938,1202,False
2017,11/05,Indianapolis,1.26,8575,86633,752,35477,62594,68,Fall,44052,149227,820,False
2017,10/29,Indianapolis,1.63,8565,65715,870,36905,40362,139,Fall,45470,106077,1009,False
2017,10/22,Indianapolis,1.67,8944,57230,603,28364,30577,26,Fall,37308,87807,629,False
2017,10/15,Indianapolis,1.76,9351,52216,631,27096,31344,22,Fall,36447,83560,653,False
2017,10/08,Indianapolis,1.97,10071,37063,607,27891,29348,60,Fall,37962,66411,667,False
2017,10/01,Indianapolis,1.84,9051,53986,972,33550,31111,328,Fall,42601,85097,1300,False
2017,09/24,Indianapolis,1.74,7948,63487,867,31441,32031,77,Fall,39389,95518,944,False
2017,09/17,Indianapolis,1.86,7889,55951,800,31782,29745,263,Fall,39671,85696,1063,False
2017,09/10,Indianapolis,1.86,8832,60421,787,35802,32306,1164,Fall,44634,92727,1951,False
2017,09/03,Indianapolis,1.7,7686,61680,879,39686,34205,1414,Fall,47372,95885,2293,False
2017,08/27,Indianapolis,1.29,8671,83185,1093,32946,52220,1737,Summer,41617,135405,2830,False
2017,08/20,Indianapolis,1.39,7182,83860,1162,35015,46406,1004,Summer,42197,130266,2166,False
2017,08/13,Indianapolis,1.49,7053,68255,800,36182,40113,1947,Summer,43235,108368,2747,False
2017,08/06,Indianapolis,1.35,7818,78546,1301,39049,41000,2821,Summer,46867,119546,4122,False
2017,07/30,Indianapolis,1.41,7452,74597,807,35579,39457,1630,Summer,43031,114054,2437,False
2017,07/23,Indianapolis,1.36,7482,70451,843,37123,37812,1481,Summer,44605,108263,2324,False
2017,07/16,Indianapolis,1.35,9861,82250,1367,34009,37719,1392,Summer,43870,119969,2759,False
2017,07/09,Indianapolis,1.08,8754,85278,1835,51238,59538,2403,Summer,59992,144816,4238,False
2017,07/02,Indianapolis,1.09,8629,78472,1678,54877,47715,3198,Summer,63506,126187,4876,False
2017,06/25,Indianapolis,1.04,7378,72671,1002,49444,64817,1780,Summer,56822,137488,2782,False
2017,06/18,Indianapolis,1.03,11623,96522,1944,53306,58995,829,Summer,64929,155517,2773,False
2017,06/11,Indianapolis,0.98,11584,72043,1097,46235,93478,434,Summer,57819,165521,1531,False
2017,06/04,Indianapolis,1.07,11334,79916,1766,40296,84463,314,Summer,51630,164379,2080,False
2017,05/28,Indianapolis,1.19,11651,77776,1540,45525,51742,47,Spring,57176,129518,1587,False
2017,05/21,Indianapolis,1.09,13080,71966,1202,44714,54004,640,Spring,57794,125970,1842,False
2017,05/14,Indianapolis,0.85,17926,93535,1422,44372,111176,84,Spring,62298,204711,1506,False
2017,05/07,Indianapolis,0.93,22284,116928,2348,50838,97497,117,Spring,73122,214425,2465,False
2017,04/30,Indianapolis,1.18,14827,86660,1564,47389,62334,101,Spring,62216,148994,1665,False
2017,04/23,Indianapolis,1.06,11831,72470,1240,42539,83872,23,Spring,54370,156342,1263,False
2017,04/16,Indianapolis,1.14,13018,79071,1773,46322,65171,72,Spring,59340,144242,1845,False
2017,04/09,Indianapolis,1.3,11776,69900,1133,41688,35858,31,Spring,53464,105758,1164,False
2017,04/02,Indianapolis,1.26,11375,61512,1452,45777,46455,15,Spring,57152,107967,1467,False
2017,03/26,Indianapolis,1.27,12342,68119,1326,42285,57404,10,Spring,54627,125523,1336,False
2017,03/19,Indianapolis,1.25,12798,60511,1516,41713,51729,61,Spring,54511,112240,1577,False
2017,03/12,Indianapolis,1.35,10979,65279,1539,35129,36351,38,Spring,46108,101630,1577,False
2017,03/05,Indianapolis,1.35,12865,66251,1756,40647,28640,140,Spring,53512,94891,1896,False
2017,02/26,Indianapolis,1.02,12096,83033,1923,38588,53252,6,Winter,50684,136285,1929,False
2017,02/19,Indianapolis,0.94,12336,74485,1362,42818,48242,4,Winter,55154,122727,1366,False
2017,02/12,Indianapolis,0.77,17435,116691,2796,51397,49247,7,Winter,68832,165938,2803,False
2017,02/05,Indianapolis,0.84,19443,146037,5353,53663,51550,2,Winter,73106,197587,5355,False
2017,01/29,Indianapolis,0.87,12914,93252,2759,53542,61566,1,Winter,66456,154818,2760,False
2017,01/22,Indianapolis,0.93,13553,92880,3909,47552,46669,5,Winter,61105,139549,3914,False
2017,01/15,Indianapolis,0.96,15258,102478,2034,45737,45282,1,Winter,60995,147760,2035,False
2017,01/08,Indianapolis,0.86,17783,112339,3127,41838,47759,1,Winter,59621,160098,3128,False
2017,01/01,Indianapolis,0.91,16193,97953,5029,39169,28118,0,Winter,55362,126071,5029,False
2017,12/31,Jacksonville,1.12,115793,14230,277,29166,46858,236,Winter,144959,61088,513,False
2017,12/24,Jacksonville,1.38,67108,8048,314,25721,25598,390,Winter,92829,33646,704,False
2017,12/17,Jacksonville,0.99,98660,11261,288,27358,39015,263,Winter,126018,50276,551,False
2017,12/10,Jacksonville,1.01,95942,11557,257,33265,40251,150,Winter,129207,51808,407,False
2017,12/03,Jacksonville,1.26,87017,9779,273,41484,13951,193,Winter,128501,23730,466,False
2017,11/26,Jacksonville,1.42,65331,7096,195,26125,21030,223,Fall,91456,28126,418,False
2017,11/19,Jacksonville,1.21,84638,10606,306,25039,34900,240,Fall,109677,45506,546,False
2017,11/12,Jacksonville,1.33,85332,9938,237,48421,10329,253,Fall,133753,20267,490,False
2017,11/05,Jacksonville,1.48,74308,8741,234,33225,14981,186,Fall,107533,23722,420,False
2017,10/29,Jacksonville,1.17,108447,13949,264,39625,31443,206,Fall,148072,45392,470,False
2017,10/22,Jacksonville,1.56,89649,11079,260,21040,30388,0,Fall,110689,41467,260,False
2017,10/15,Jacksonville,1.76,75857,10193,137,23963,27352,0,Fall,99820,37545,137,False
2017,10/08,Jacksonville,1.79,89903,10996,76,22345,29419,0,Fall,112248,40415,76,False
2017,10/01,Jacksonville,2.0,68330,14372,49,19480,26359,0,Fall,87810,40731,49,False
2017,09/24,Jacksonville,1.82,82615,12009,64,18592,17288,0,Fall,101207,29297,64,False
2017,09/17,Jacksonville,1.73,82016,13544,24,8860,37219,60,Fall,90876,50763,84,False
2017,09/10,Jacksonville,1.77,62701,11080,27,22005,20014,1513,Fall,84706,31094,1540,False
2017,09/03,Jacksonville,1.88,82573,14144,99,20452,28919,1053,Fall,103025,43063,1152,False
2017,08/27,Jacksonville,1.63,83466,12673,54,19492,19474,2860,Summer,102958,32147,2914,False
2017,08/20,Jacksonville,1.63,86428,13226,12,22007,27404,1750,Summer,108435,40630,1762,False
2017,08/13,Jacksonville,1.49,90069,14574,68,40501,23085,3696,Summer,130570,37659,3764,False
2017,08/06,Jacksonville,1.44,82275,12280,43,22133,29292,2213,Summer,104408,41572,2256,False
2017,07/30,Jacksonville,1.43,89089,13102,73,32147,21985,1313,Summer,121236,35087,1386,False
2017,07/23,Jacksonville,1.44,101545,14942,55,23710,29831,2907,Summer,125255,44773,2962,False
2017,07/16,Jacksonville,1.48,88735,14194,102,24773,29400,2971,Summer,113508,43594,3073,False
2017,07/09,Jacksonville,1.42,98757,14132,46,28914,16267,3746,Summer,127671,30399,3792,False
2017,07/02,Jacksonville,1.41,113926,18894,122,31305,20128,5035,Summer,145231,39022,5157,False
2017,06/25,Jacksonville,1.36,99600,16687,75,33088,28278,2470,Summer,132688,44965,2545,False
2017,06/18,Jacksonville,1.45,94578,12992,90,23346,16704,3300,Summer,117924,29696,3390,False
2017,06/11,Jacksonville,1.43,119698,15932,121,29031,25729,2575,Summer,148729,41661,2696,False
2017,06/04,Jacksonville,1.46,119654,16223,84,24682,16731,980,Summer,144336,32954,1064,False
2017,05/28,Jacksonville,1.43,96509,15848,115,35449,33245,420,Spring,131958,49093,535,False
2017,05/21,Jacksonville,1.44,86716,14543,99,25647,28151,660,Spring,112363,42694,759,False
2017,05/14,Jacksonville,1.47,79945,12921,99,24530,30178,650,Spring,104475,43099,749,False
2017,05/07,Jacksonville,1.13,155607,26574,224,33910,52241,250,Spring,189517,78815,474,False
2017,04/30,Jacksonville,1.26,150982,24978,121,26376,37214,555,Spring,177358,62192,676,False
2017,04/23,Jacksonville,1.47,85993,16104,78,25194,28670,95,Spring,111187,44774,173,False
2017,04/16,Jacksonville,1.46,83664,16186,70,25862,25718,360,Spring,109526,41904,430,False
2017,04/09,Jacksonville,1.5,81448,17365,142,22044,29968,395,Spring,103492,47333,537,False
2017,04/02,Jacksonville,1.64,84324,16423,171,20349,28239,160,Spring,104673,44662,331,False
2017,03/26,Jacksonville,1.62,81656,16051,125,20444,31040,495,Spring,102100,47091,620,False
2017,03/19,Jacksonville,1.56,72614,15206,167,24402,25501,510,Spring,97016,40707,677,False
2017,03/12,Jacksonville,1.55,78256,17190,85,23969,26579,115,Spring,102225,43769,200,False
2017,03/05,Jacksonville,1.56,71350,16171,82,19070,27887,20,Spring,90420,44058,102,False
2017,02/26,Jacksonville,1.16,90291,20630,66,31645,29517,350,Winter,121936,50147,416,False
2017,02/19,Jacksonville,1.23,72634,18683,89,19864,28137,540,Winter,92498,46820,629,False
2017,02/12,Jacksonville,0.9,107196,33548,348,28073,47170,30,Winter,135269,80718,378,False
2017,02/05,Jacksonville,0.74,191954,65200,357,64165,76520,344,Winter,256119,141720,701,False
2017,01/29,Jacksonville,1.11,87623,29999,236,37567,50878,348,Winter,125190,80877,584,False
2017,01/22,Jacksonville,0.91,75808,50763,376,28445,91120,0,Winter,104253,141883,376,False
2017,01/15,Jacksonville,1.16,80023,30493,188,27774,52642,0,Winter,107797,83135,188,False
2017,01/08,Jacksonville,1.15,47783,23081,148,29267,41411,0,Winter,77050,64492,148,False
2017,01/01,Jacksonville,0.81,94909,46910,302,35501,86106,0,Winter,130410,133016,302,False
2017,12/31,LasVegas,1.04,57663,111439,6018,49190,67480,130,Winter,106853,178919,6148,False
2017,12/24,LasVegas,1.24,63831,66599,6232,60969,36710,176,Winter,124800,103309,6408,False
2017,12/17,LasVegas,1.03,62937,102137,3955,63479,35185,293,Winter,126416,137322,4248,False
2017,12/10,LasVegas,1.03,65071,94140,4760,62945,61291,231,Winter,128016,155431,4991,False
2017,12/03,LasVegas,1.01,66925,127968,4488,47447,68396,297,Winter,114372,196364,4785,False
2017,11/26,LasVegas,1.16,52245,75503,4316,45659,27009,300,Fall,97904,102512,4616,False
2017,11/19,LasVegas,1.13,60519,77336,5388,47255,43420,347,Fall,107774,120756,5735,False
2017,11/12,LasVegas,1.06,57132,110255,5043,42648,76180,67,Fall,99780,186435,5110,False
2017,11/05,LasVegas,1.12,57828,121041,5037,41685,95611,330,Fall,99513,216652,5367,False
2017,10/29,LasVegas,1.29,56224,94603,3515,41859,46967,170,Fall,98083,141570,3685,False
2017,10/22,LasVegas,1.37,61741,74165,682,46482,21023,0,Fall,108223,95188,682,False
2017,10/15,LasVegas,1.45,57479,76990,60,44183,24021,0,Fall,101662,101011,60,False
2017,10/08,LasVegas,1.64,62574,60756,75,47487,24560,0,Fall,110061,85316,75,False
2017,10/01,LasVegas,1.61,58261,67847,62,43605,19750,0,Fall,101866,87597,62,False
2017,09/24,LasVegas,1.61,59560,62383,66,42658,27616,0,Fall,102218,89999,66,False
2017,09/17,LasVegas,1.58,64271,63852,109,45361,27434,0,Fall,109632,91286,109,False
2017,09/10,LasVegas,1.49,116267,26602,5997,43187,23218,120,Fall,159454,49820,6117,False
2017,09/03,LasVegas,1.53,95445,29557,6208,45086,27650,143,Fall,140531,57207,6351,False
2017,08/27,LasVegas,1.48,107288,26219,6548,39816,23140,935,Summer,147104,49359,7483,False
2017,08/20,LasVegas,1.26,109201,44715,7342,34087,65960,376,Summer,143288,110675,7718,False
2017,08/13,LasVegas,1.18,100523,68158,6825,42423,105694,170,Summer,142946,173852,6995,False
2017,08/06,LasVegas,1.3,114985,53059,7126,49026,59193,388,Summer,164011,112252,7514,False
2017,07/30,LasVegas,1.29,113471,46394,7351,58516,62901,270,Summer,171987,109295,7621,False
2017,07/23,LasVegas,1.28,114294,62879,6655,46713,66328,16,Summer,161007,129207,6671,False
2017,07/16,LasVegas,1.22,131681,54114,6343,36179,71540,0,Summer,167860,125654,6343,False
2017,07/09,LasVegas,0.99,138190,54694,7591,75039,124311,0,Summer,213229,179005,7591,False
2017,07/02,LasVegas,1.06,129619,48964,8471,70018,119721,0,Summer,199637,168685,8471,False
2017,06/25,LasVegas,1.03,130867,49034,6653,53411,122522,0,Summer,184278,171556,6653,False
2017,06/18,LasVegas,1.01,133507,55577,6723,55967,105919,0,Summer,189474,161496,6723,False
2017,06/11,LasVegas,0.99,158132,51454,6562,60840,97009,212,Summer,218972,148463,6774,False
2017,06/04,LasVegas,1.05,137454,53764,8227,63050,114357,136,Summer,200504,168121,8363,False
2017,05/28,LasVegas,1.06,130568,50153,10114,62414,111236,0,Spring,192982,161389,10114,False
2017,05/21,LasVegas,1.02,117366,63083,8122,48461,119887,0,Spring,165827,182970,8122,False
2017,05/14,LasVegas,0.98,125448,75420,7459,47410,143342,444,Spring,172858,218762,7903,False
2017,05/07,LasVegas,0.94,160728,76426,7876,50093,173850,0,Spring,210821,250276,7876,False
2017,04/30,LasVegas,0.95,113104,65026,6704,43597,130578,0,Spring,156701,195604,6704,False
2017,04/23,LasVegas,0.84,118344,81560,9126,41132,189154,347,Spring,159476,270714,9473,False
2017,04/16,LasVegas,0.93,119501,58233,9911,56490,166712,0,Spring,175991,224945,9911,False
2017,04/09,LasVegas,1.04,115811,40245,8785,50811,88838,111,Spring,166622,129083,8896,False
2017,04/02,LasVegas,1.04,118797,41149,11317,63726,94730,0,Spring,182523,135879,11317,False
2017,03/26,LasVegas,1.02,117623,43374,9405,64615,90715,0,Spring,182238,134089,9405,False
2017,03/19,LasVegas,1.02,111396,43301,9357,51704,102245,0,Spring,163100,145546,9357,False
2017,03/12,LasVegas,0.99,114790,38280,8807,72719,80846,0,Spring,187509,119126,8807,False
2017,03/05,LasVegas,0.96,119711,49738,8076,53110,115252,0,Spring,172821,164990,8076,False
2017,02/26,LasVegas,0.89,97278,57129,7364,55239,108893,0,Winter,152517,166022,7364,False
2017,02/19,LasVegas,0.93,135001,40837,6859,65647,70253,0,Winter,200648,111090,6859,False
2017,02/12,LasVegas,0.72,128160,59930,8137,53528,157109,0,Winter,181688,217039,8137,False
2017,02/05,LasVegas,0.54,286395,121440,8149,56405,207843,0,Winter,342800,329283,8149,False
2017,01/29,LasVegas,0.93,120542,45790,7716,59095,76001,0,Winter,179637,121791,7716,False
2017,01/22,LasVegas,0.79,133276,64435,6954,44375,133739,69,Winter,177651,198174,7023,False
2017,01/15,LasVegas,0.78,118904,80217,7692,59471,153401,0,Winter,178375,233618,7692,False
2017,01/08,LasVegas,0.81,112947,77763,7983,71141,141383,0,Winter,184088,219146,7983,False
2017,01/01,LasVegas,0.77,95268,75111,7736,62603,123145,0,Winter,157871,198256,7736,False
2017,12/31,LosAngeles,0.88,1368619,755743,75509,959746,14343,38298,Winter,2328365,770086,113807,False
2017,12/24,LosAngeles,1.1,1076720,350754,78272,831557,15344,37179,Winter,1908277,366098,115451,False
2017,12/17,LosAngeles,0.89,1046466,1167417,76600,790545,14767,35119,Winter,1837011,1182184,111719,False
2017,12/10,LosAngeles,1.07,1024592,396712,62000,868361,16284,36269,Winter,1892953,412996,98269,False
2017,12/03,LosAngeles,1.01,1177940,396804,68958,913002,23854,35296,Winter,2090942,420658,104254,False
2017,11/26,LosAngeles,1.19,987928,327525,82683,702784,16197,36801,Fall,1690712,343722,119484,False
2017,11/19,LosAngeles,1.14,1042472,309130,73389,893064,34871,38457,Fall,1935536,344001,111846,False
2017,11/12,LosAngeles,1.08,1225567,413517,72562,851550,23684,39240,Fall,2077117,437201,111802,False
2017,11/05,LosAngeles,1.04,1079147,743292,69039,748133,14912,36715,Fall,1827280,758204,105754,False
2017,10/29,LosAngeles,1.09,1085428,843048,81784,794198,16098,29818,Fall,1879626,859146,111602,False
2017,10/22,LosAngeles,1.49,924450,360936,84635,551747,15614,31253,Fall,1476197,376550,115888,False
2017,10/15,LosAngeles,1.67,741758,385402,94134,509468,15849,33217,Fall,1251226,401251,127351,False
2017,10/08,LosAngeles,1.8,753730,343707,91288,475271,17349,29920,Fall,1229001,361056,121208,False
2017,10/01,LosAngeles,1.77,725653,335816,78098,510568,17512,29379,Fall,1236221,353328,107477,False
2017,09/24,LosAngeles,1.75,768658,337637,79407,529354,16258,29293,Fall,1298012,353895,108700,False
2017,09/17,LosAngeles,1.73,837463,357662,84556,543636,13163,29208,Fall,1381099,370825,113764,False
2017,09/10,LosAngeles,1.74,898753,359807,94971,568315,14394,32809,Fall,1467068,374201,127780,False
2017,09/03,LosAngeles,1.61,1050438,441327,112400,521219,15575,36012,Fall,1571657,456902,148412,False
2017,08/27,LosAngeles,1.66,1096036,344686,105558,523454,14650,32740,Summer,1619490,359336,138298,False
2017,08/20,LosAngeles,1.45,1207541,324882,99791,618120,22264,37265,Summer,1825661,347146,137056,False
2017,08/13,LosAngeles,1.19,1412649,452871,120591,784481,21556,40698,Summer,2197130,474427,161289,False
2017,08/06,LosAngeles,1.22,1359069,414552,109001,793163,20822,46018,Summer,2152232,435374,155019,False
2017,07/30,LosAngeles,1.39,1263812,399835,100595,603467,18679,39637,Summer,1867279,418514,140232,False
2017,07/23,LosAngeles,1.38,1266618,407573,99404,652958,12421,45942,Summer,1919576,419994,145346,False
2017,07/16,LosAngeles,1.37,1327685,409058,105463,658086,14421,43441,Summer,1985771,423479,148904,False
2017,07/09,LosAngeles,1.12,1520215,437585,87693,1285980,788,50712,Summer,2806195,438373,138405,False
2017,07/02,LosAngeles,1.07,1521073,497356,104452,1337890,411,45971,Summer,2858963,497767,150423,False
2017,06/25,LosAngeles,0.92,1609002,414532,90801,1496630,696,44003,Summer,3105632,415228,134804,False
2017,06/18,LosAngeles,0.99,1581223,480083,93204,1424124,963,51722,Summer,3005347,481046,144926,False
2017,06/11,LosAngeles,0.99,1280363,415143,96489,1550403,468,47983,Summer,2830766,415611,144472,False
2017,06/04,LosAngeles,0.96,1330141,418291,89031,1761072,559,38125,Summer,3091213,418850,127156,False
2017,05/28,LosAngeles,1.13,1296066,466479,102414,1324066,300,54580,Spring,2620132,466779,156994,False
2017,05/21,LosAngeles,1.14,1169688,428611,91670,1178399,401,53144,Spring,2348087,429012,144814,False
2017,05/14,LosAngeles,0.94,1376168,430527,88215,1602634,674,53182,Spring,2978802,431201,141397,False
2017,05/07,LosAngeles,0.87,1745366,583071,97893,1727340,488,60153,Spring,3472706,583559,158046,False
2017,04/30,LosAngeles,0.99,1329981,518018,105295,1286252,686,59023,Spring,2616233,518704,164318,False
2017,04/23,LosAngeles,1.04,1118405,429077,108744,1358189,3262,56546,Spring,2476594,432339,165290,False
2017,04/16,LosAngeles,1.18,1044500,455872,109370,1117995,574,61316,Spring,2162495,456446,170686,False
2017,04/09,LosAngeles,1.01,957440,408516,106825,1460394,10162,49907,Spring,2417834,418678,156732,False
2017,04/02,LosAngeles,0.98,975079,428361,95594,1542667,11742,46909,Spring,2517746,440103,142503,False
2017,03/26,LosAngeles,1.12,861802,418362,83244,1168719,1177,50016,Spring,2030521,419539,133260,False
2017,03/19,LosAngeles,1.11,965781,422615,89296,1209897,2474,47805,Spring,2175678,425089,137101,False
2017,03/12,LosAngeles,1.12,974290,439065,94533,1067166,4495,54023,Spring,2041456,443560,148556,False
2017,03/05,LosAngeles,0.99,897311,518369,83307,1214991,6376,48575,Spring,2112302,524745,131882,False
2017,02/26,LosAngeles,0.82,980146,477454,70872,1341305,33291,32007,Winter,2321451,510745,102879,False
2017,02/19,LosAngeles,0.79,1029674,493496,68553,1277346,130416,34431,Winter,2307020,623912,102984,False
2017,02/12,LosAngeles,0.64,1181120,592688,61331,1664506,81240,44743,Winter,2845626,673928,106074,False
2017,02/05,LosAngeles,0.53,1741607,937331,89678,2656630,3465,41513,Winter,4398237,940796,131191,False
2017,01/29,LosAngeles,0.6,1439453,741369,67607,1923042,29993,28981,Winter,3362495,771362,96588,False
2017,01/22,LosAngeles,0.62,1715034,663032,61799,1710186,39625,25874,Winter,3425220,702657,87673,False
2017,01/15,LosAngeles,0.76,1075572,703853,61161,1442445,59205,21168,Winter,2518017,763058,82329,False
2017,01/08,LosAngeles,0.89,969758,692908,72814,1288525,72837,24117,Winter,2258283,765745,96931,False
2017,01/01,LosAngeles,0.84,1223299,829896,56808,1332601,88931,19799,Winter,2555900,918827,76607,False
2017,12/31,Louisville,0.87,26048,34289,270,37617,19711,4,Winter,63665,54000,274,False
2017,12/24,Louisville,1.18,6596,28324,217,23837,21035,12,Winter,30433,49359,229,False
2017,12/17,Louisville,1.07,6894,28129,326,29455,15356,28,Winter,36349,43485,354,False
2017,12/10,Louisville,1.01,6065,37048,147,26607,30198,4,Winter,32672,67246,151,False
2017,12/03,Louisville,1.11,2489,52286,530,9238,44403,1,Winter,11727,96689,531,False
2017,11/26,Louisville,1.45,1858,22808,107,10221,18803,0,Fall,12079,41611,107,False
2017,11/19,Louisville,1.18,2182,33869,79,12675,30480,0,Fall,14857,64349,79,False
2017,11/12,Louisville,1.14,3181,43510,86,11788,42246,0,Fall,14969,85756,86,False
2017,11/05,Louisville,1.18,3045,37125,120,13435,32355,2,Fall,16480,69480,122,False
2017,10/29,Louisville,1.23,3751,44115,56,13041,41950,0,Fall,16792,86065,56,False
2017,10/22,Louisville,1.7,3538,25086,33,13492,20029,0,Fall,17030,45115,33,False
2017,10/15,Louisville,1.79,3403,25005,68,12700,19439,0,Fall,16103,44444,68,False
2017,10/08,Louisville,1.98,4093,17191,71,11687,19822,0,Fall,15780,37013,71,False
2017,10/01,Louisville,1.89,3158,25612,73,14044,19292,0,Fall,17202,44904,73,False
2017,09/24,Louisville,1.88,2256,25575,82,12529,19096,0,Fall,14785,44671,82,False
2017,09/17,Louisville,1.73,2265,31173,79,14322,20969,20,Fall,16587,52142,99,False
2017,09/10,Louisville,1.65,2337,34553,91,15816,25440,366,Fall,18153,59993,457,False
2017,09/03,Louisville,1.64,2707,35073,133,16063,26038,355,Fall,18770,61111,488,False
2017,08/27,Louisville,1.62,3038,33674,103,17157,26001,491,Summer,20195,59675,594,False
2017,08/20,Louisville,1.56,2852,35594,148,24106,25489,453,Summer,26958,61083,601,False
2017,08/13,Louisville,1.38,2736,37308,121,27903,24543,833,Summer,30639,61851,954,False
2017,08/06,Louisville,1.3,2317,37610,218,29610,24173,1211,Summer,31927,61783,1429,False
2017,07/30,Louisville,1.3,2384,33397,133,29280,24102,1130,Summer,31664,57499,1263,False
2017,07/23,Louisville,1.37,2203,37670,134,24730,26604,1143,Summer,26933,64274,1277,False
2017,07/16,Louisville,1.44,3058,41177,211,15204,26375,1189,Summer,18262,67552,1400,False
2017,07/09,Louisville,1.01,2696,45861,209,22207,53245,726,Summer,24903,99106,935,False
2017,07/02,Louisville,1.02,2605,47985,340,23991,38397,338,Summer,26596,86382,678,False
2017,06/25,Louisville,0.97,2137,43420,203,20546,47643,52,Summer,22683,91063,255,False
2017,06/18,Louisville,1.06,2581,49620,541,21822,29725,78,Summer,24403,79345,619,False
2017,06/11,Louisville,1.04,2251,46391,159,17357,45674,419,Summer,19608,92065,578,False
2017,06/04,Louisville,1.06,2191,48994,305,16752,53317,41,Summer,18943,102311,346,False
2017,05/28,Louisville,1.08,2098,48808,305,16202,44055,16,Spring,18300,92863,321,False
2017,05/21,Louisville,1.1,2090,51642,225,14518,35959,3,Spring,16608,87601,228,False
2017,05/14,Louisville,1.27,2266,37229,247,16236,26265,0,Spring,18502,63494,247,False
2017,05/07,Louisville,1.06,2467,57992,426,21513,52904,182,Spring,23980,110896,608,False
2017,04/30,Louisville,1.26,2431,48499,203,18452,23931,145,Spring,20883,72430,348,False
2017,04/23,Louisville,1.17,2091,42839,236,16780,31343,211,Spring,18871,74182,447,False
2017,04/16,Louisville,1.22,2109,47637,213,18406,31705,15,Spring,20515,79342,228,False
2017,04/09,Louisville,1.2,2222,43333,209,17618,26542,0,Spring,19840,69875,209,False
2017,04/02,Louisville,1.15,2228,43114,225,18336,33057,0,Spring,20564,76171,225,False
2017,03/26,Louisville,1.11,2435,46979,163,18244,32209,3,Spring,20679,79188,166,False
2017,03/19,Louisville,1.29,1883,44133,213,17374,10768,15,Spring,19257,54901,228,False
2017,03/12,Louisville,1.18,2122,42103,159,14085,26520,14,Spring,16207,68623,173,False
2017,03/05,Louisville,0.99,1914,49340,183,12670,36951,0,Spring,14584,86291,183,False
2017,02/26,Louisville,0.95,2181,59928,578,15168,28234,6,Winter,17349,88162,584,False
2017,02/19,Louisville,0.94,1979,41851,159,13809,36841,136,Winter,15788,78692,295,False
2017,02/12,Louisville,0.75,2078,58269,357,16002,55257,0,Winter,18080,113526,357,False
2017,02/05,Louisville,0.91,2214,74680,1046,19517,29368,1,Winter,21731,104048,1047,False
2017,01/29,Louisville,0.94,2082,55703,217,17307,40985,13,Winter,19389,96688,230,False
2017,01/22,Louisville,0.94,2407,66870,714,18678,38926,0,Winter,21085,105796,714,False
2017,01/15,Louisville,1.06,2069,43683,281,17644,25682,0,Winter,19713,69365,281,False
2017,01/08,Louisville,0.86,2489,55251,397,17859,42296,15,Winter,20348,97547,412,False
2017,01/01,Louisville,0.77,1692,60441,643,12573,35198,146,Winter,14265,95639,789,False
2017,12/31,MiamiFtLauderdale,1.17,499352,74265,3057,72698,79623,0,Winter,572050,153888,3057,False
2017,12/24,MiamiFtLauderdale,1.45,336796,44094,4987,88550,32139,0,Winter,425346,76233,4987,False
2017,12/17,MiamiFtLauderdale,1.01,449484,63179,5749,69456,72867,0,Winter,518940,136046,5749,False
2017,12/10,MiamiFtLauderdale,1.03,484033,71985,6988,75190,75667,0,Winter,559223,147652,6988,False
2017,12/03,MiamiFtLauderdale,1.35,358080,50526,9947,75459,56202,0,Winter,433539,106728,9947,False
2017,11/26,MiamiFtLauderdale,1.45,302437,44200,1052,70352,46606,0,Fall,372789,90806,1052,False
2017,11/19,MiamiFtLauderdale,1.23,418092,65920,2026,80040,75936,0,Fall,498132,141856,2026,False
2017,11/12,MiamiFtLauderdale,1.42,336664,51672,1669,72870,50234,0,Fall,409534,101906,1669,False
2017,11/05,MiamiFtLauderdale,1.53,314039,47476,392,66124,35137,0,Fall,380163,82613,392,False
2017,10/29,MiamiFtLauderdale,1.22,450543,71919,223,75333,76768,0,Fall,525876,148687,223,False
2017,10/22,MiamiFtLauderdale,1.59,378185,61183,183,61151,57611,0,Fall,439336,118794,183,False
2017,10/15,MiamiFtLauderdale,1.79,324877,49047,32,72027,26089,0,Fall,396904,75136,32,False
2017,10/08,MiamiFtLauderdale,1.92,302210,44414,104,80223,28878,0,Fall,382433,73292,104,False
2017,10/01,MiamiFtLauderdale,2.04,254127,48863,187,54423,42234,0,Fall,308550,91097,187,False
2017,09/24,MiamiFtLauderdale,1.93,291020,42336,237,33217,42039,0,Fall,324237,84375,237,False
2017,09/17,MiamiFtLauderdale,1.84,278164,53156,50,16642,61152,40,Fall,294806,114308,90,False
2017,09/10,MiamiFtLauderdale,1.81,266569,34078,155,34614,23940,3223,Fall,301183,58018,3378,False
2017,09/03,MiamiFtLauderdale,1.98,323445,50947,284,40450,46519,3403,Fall,363895,97466,3687,False
2017,08/27,MiamiFtLauderdale,1.65,302627,49717,289,37812,51132,8624,Summer,340439,100849,8913,False
2017,08/20,MiamiFtLauderdale,1.7,317677,56349,184,34142,54596,5564,Summer,351819,110945,5748,False
2017,08/13,MiamiFtLauderdale,1.51,383486,70899,207,31618,73383,9201,Summer,415104,144282,9408,False
2017,08/06,MiamiFtLauderdale,1.48,341186,64789,324,38651,48348,7854,Summer,379837,113137,8178,False
2017,07/30,MiamiFtLauderdale,1.46,342501,62144,358,34817,55121,6058,Summer,377318,117265,6416,False
2017,07/23,MiamiFtLauderdale,1.47,374063,67585,421,35385,61377,8000,Summer,409448,128962,8421,False
2017,07/16,MiamiFtLauderdale,1.48,367930,65180,301,38434,41978,9792,Summer,406364,107158,10093,False
2017,07/09,MiamiFtLauderdale,1.43,371243,67379,239,44355,55317,11659,Summer,415598,122696,11898,False
2017,07/02,MiamiFtLauderdale,1.44,419259,76464,418,49954,72199,9273,Summer,469213,148663,9691,False
2017,06/25,MiamiFtLauderdale,1.43,349940,66569,127,51069,59391,12748,Summer,401009,125960,12875,False
2017,06/18,MiamiFtLauderdale,1.52,311873,66760,105,51803,62943,12341,Summer,363676,129703,12446,False
2017,06/11,MiamiFtLauderdale,1.48,447672,88004,340,73486,79488,7610,Summer,521158,167492,7950,False
2017,06/04,MiamiFtLauderdale,1.49,449727,85907,238,84992,64412,2635,Summer,534719,150319,2873,False
2017,05/28,MiamiFtLauderdale,1.45,403556,74337,66,102591,65217,0,Spring,506147,139554,66,False
2017,05/21,MiamiFtLauderdale,1.49,383030,75985,127,86440,60137,0,Spring,469470,136122,127,False
2017,05/14,MiamiFtLauderdale,1.5,373017,71834,92,87201,62633,0,Spring,460218,134467,92,False
2017,05/07,MiamiFtLauderdale,1.17,569792,130126,689,96700,112930,0,Spring,666492,243056,689,False
2017,04/30,MiamiFtLauderdale,1.26,511842,127586,121,79251,113901,0,Spring,591093,241487,121,False
2017,04/23,MiamiFtLauderdale,1.51,333198,78525,143,81699,63377,0,Spring,414897,141902,143,False
2017,04/16,MiamiFtLauderdale,1.5,329067,75100,127,73084,56062,0,Spring,402151,131162,127,False
2017,04/09,MiamiFtLauderdale,1.54,312737,74502,242,66358,40164,87,Spring,379095,114666,329,False
2017,04/02,MiamiFtLauderdale,1.71,299394,74726,285,63253,55950,0,Spring,362647,130676,285,False
2017,03/26,MiamiFtLauderdale,1.71,297987,79372,370,59606,61500,150,Spring,357593,140872,520,False
2017,03/19,MiamiFtLauderdale,1.62,297627,79475,350,80525,62486,472,Spring,378152,141961,822,False
2017,03/12,MiamiFtLauderdale,1.7,286726,80308,280,58637,47913,0,Spring,345363,128221,280,False
2017,03/05,MiamiFtLauderdale,1.67,273177,78151,228,56960,55692,0,Spring,330137,133843,228,False
2017,02/26,MiamiFtLauderdale,1.26,328098,90099,97,76060,59447,0,Winter,404158,149546,97,False
2017,02/19,MiamiFtLauderdale,1.35,262617,89037,253,58634,57722,0,Winter,321251,146759,253,False
2017,02/12,MiamiFtLauderdale,0.97,462514,171782,399,67653,102267,359,Winter,530167,274049,758,False
2017,02/05,MiamiFtLauderdale,0.87,689710,281503,629,102844,178368,1144,Winter,792554,459871,1773,False
2017,01/29,MiamiFtLauderdale,1.3,271896,128996,519,99039,108598,670,Winter,370935,237594,1189,False
2017,01/22,MiamiFtLauderdale,1.05,308899,230819,377,71856,181454,106,Winter,380755,412273,483,False
2017,01/15,MiamiFtLauderdale,1.34,251140,125991,544,82722,128082,0,Winter,333862,254073,544,False
2017,01/08,MiamiFtLauderdale,1.4,209904,121128,293,85738,105206,6,Winter,295642,226334,299,False
2017,01/01,MiamiFtLauderdale,0.98,309692,199635,540,84253,193284,0,Winter,393945,392919,540,False
2017,12/31,Nashville,0.81,159028,10137,177,70278,18477,630,Winter,229306,28614,807,False
2017,12/24,Nashville,1.04,96258,6816,201,65116,12231,1377,Winter,161374,19047,1578,False
2017,12/17,Nashville,0.91,97643,7363,224,79113,12580,918,Winter,176756,19943,1142,False
2017,12/10,Nashville,0.9,123093,7029,199,94522,13872,870,Winter,217615,20901,1069,False
2017,12/03,Nashville,1.01,123038,8062,175,78202,18913,949,Winter,201240,26975,1124,False
2017,11/26,Nashville,1.08,83217,6254,183,58959,10358,856,Fall,142176,16612,1039,False
2017,11/19,Nashville,1.02,104128,6946,262,65958,10329,820,Fall,170086,17275,1082,False
2017,11/12,Nashville,1.07,121879,7035,281,63381,9118,936,Fall,185260,16153,1217,False
2017,11/05,Nashville,1.02,144908,8243,354,63826,11123,784,Fall,208734,19366,1138,False
2017,10/29,Nashville,1.14,125954,9477,185,68554,13183,368,Fall,194508,22660,553,False
2017,10/22,Nashville,1.41,97915,9503,252,49860,9599,5,Fall,147775,19102,257,False
2017,10/15,Nashville,1.57,87209,10227,125,53309,10144,3,Fall,140518,20371,128,False
2017,10/08,Nashville,1.76,77117,4016,105,49424,10304,0,Fall,126541,14320,105,False
2017,10/01,Nashville,1.7,73759,21324,90,52292,7431,58,Fall,126051,28755,148,False
2017,09/24,Nashville,1.66,74533,22831,82,54501,7350,113,Fall,129034,30181,195,False
2017,09/17,Nashville,1.48,70892,29793,69,56309,10118,257,Fall,127201,39911,326,False
2017,09/10,Nashville,1.42,72427,37438,93,56903,7881,1336,Fall,129330,45319,1429,False
2017,09/03,Nashville,1.34,76965,42751,76,57883,10273,751,Fall,134848,53024,827,False
2017,08/27,Nashville,1.28,82465,40038,106,48844,10803,2207,Summer,131309,50841,2313,False
2017,08/20,Nashville,1.07,114191,37848,52,90141,17632,1891,Summer,204332,55480,1943,False
2017,08/13,Nashville,1.05,124290,38810,91,87901,16066,1494,Summer,212191,54876,1585,False
2017,08/06,Nashville,1.13,106178,36727,49,86175,12836,1559,Summer,192353,49563,1608,False
2017,07/30,Nashville,1.14,106460,29771,52,65555,14827,1107,Summer,172015,44598,1159,False
2017,07/23,Nashville,1.21,95944,32144,179,71644,9364,2106,Summer,167588,41508,2285,False
2017,07/16,Nashville,1.18,93140,32246,206,71974,13092,1551,Summer,165114,45338,1757,False
2017,07/09,Nashville,0.99,101167,35679,109,105530,22029,2780,Summer,206697,57708,2889,False
2017,07/02,Nashville,0.96,112545,39946,90,110433,15456,2595,Summer,222978,55402,2685,False
2017,06/25,Nashville,0.9,114569,47014,60,105149,18681,1742,Summer,219718,65695,1802,False
2017,06/18,Nashville,1.0,108420,33689,143,105965,10905,1768,Summer,214385,44594,1911,False
2017,06/11,Nashville,1.13,107489,23109,141,74772,10764,2261,Summer,182261,33873,2402,False
2017,06/04,Nashville,1.07,133059,12467,119,106243,14782,2430,Summer,239302,27249,2549,False
2017,05/28,Nashville,0.97,149461,7592,149,85799,37474,2192,Spring,235260,45066,2341,False
2017,05/21,Nashville,0.99,139176,7391,36,86638,23799,2109,Spring,225814,31190,2145,False
2017,05/14,Nashville,1.02,124825,7630,100,72042,18978,1746,Spring,196867,26608,1846,False
2017,05/07,Nashville,0.84,169743,12217,189,163451,21424,1770,Spring,333194,33641,1959,False
2017,04/30,Nashville,0.99,147000,11874,78,105192,20198,1977,Spring,252192,32072,2055,False
2017,04/23,Nashville,1.1,109053,8877,75,97879,8397,1805,Spring,206932,17274,1880,False
2017,04/16,Nashville,1.09,111412,9801,135,102366,5170,1680,Spring,213778,14971,1815,False
2017,04/09,Nashville,1.03,110090,10197,118,122342,6780,1560,Spring,232432,16977,1678,False
2017,04/02,Nashville,0.95,122671,10966,86,139193,7520,1000,Spring,261864,18486,1086,False
2017,03/26,Nashville,0.91,135016,10773,92,122643,6937,1270,Spring,257659,17710,1362,False
2017,03/19,Nashville,0.96,110762,10019,100,99605,5995,1540,Spring,210367,16014,1640,False
2017,03/12,Nashville,0.75,154343,10155,71,89585,6434,1240,Spring,243928,16589,1311,False
2017,03/05,Nashville,0.6,174849,10907,185,186396,6875,110,Spring,361245,17782,295,False
2017,02/26,Nashville,0.88,121849,13162,71,72019,8088,1035,Winter,193868,21250,1106,False
2017,02/19,Nashville,0.82,113867,12392,123,90304,8146,830,Winter,204171,20538,953,False
2017,02/12,Nashville,0.66,139708,30102,246,80701,19120,1514,Winter,220409,49222,1760,False
2017,02/05,Nashville,0.68,182395,43116,149,131344,20622,90,Winter,313739,63738,239,False
2017,01/29,Nashville,0.93,109656,20938,122,92858,14816,0,Winter,202514,35754,122,False
2017,01/22,Nashville,0.87,112820,30481,81,82914,24413,478,Winter,195734,54894,559,False
2017,01/15,Nashville,0.89,109163,20522,121,106434,15372,300,Winter,215597,35894,421,False
2017,01/08,Nashville,0.84,126438,17389,183,98008,12089,985,Winter,224446,29478,1168,False
2017,01/01,Nashville,0.73,112089,27327,71,87099,20952,1535,Winter,199188,48279,1606,False
2017,12/31,NewOrleansMobile,1.06,164147,23239,1336,61080,11333,1143,Winter,225227,34572,2479,False
2017,12/24,NewOrleansMobile,1.14,127281,14372,1613,72271,8224,1106,Winter,199552,22596,2719,False
2017,12/17,NewOrleansMobile,1.03,151885,18381,1505,68849,10321,810,Winter,220734,28702,2315,False
2017,12/10,NewOrleansMobile,1.06,144316,21840,1803,71291,11513,835,Winter,215607,33353,2638,False
2017,12/03,NewOrleansMobile,0.97,163448,19343,2002,77355,3609,790,Winter,240803,22952,2792,False
2017,11/26,NewOrleansMobile,1.27,96043,12239,1145,57613,8817,960,Fall,153656,21056,2105,False
2017,11/19,NewOrleansMobile,1.27,118191,14363,1729,63649,8597,767,Fall,181840,22960,2496,False
2017,11/12,NewOrleansMobile,1.11,176864,25045,2188,83664,4411,816,Fall,260528,29456,3004,False
2017,11/05,NewOrleansMobile,1.32,131134,19876,1893,65167,6089,1403,Fall,196301,25965,3296,False
2017,10/29,NewOrleansMobile,1.11,169106,21885,1787,72752,11155,751,Fall,241858,33040,2538,False
2017,10/22,NewOrleansMobile,1.26,159833,24349,1576,73112,10571,0,Fall,232945,34920,1576,False
2017,10/15,NewOrleansMobile,1.46,135384,18515,173,65362,8511,0,Fall,200746,27026,173,False
2017,10/08,NewOrleansMobile,1.34,207980,24630,31,82449,13738,0,Fall,290429,38368,31,False
2017,10/01,NewOrleansMobile,1.72,132184,21112,9,61436,12793,0,Fall,193620,33905,9,False
2017,09/24,NewOrleansMobile,1.7,129861,22072,19,44407,9616,0,Fall,174268,31688,19,False
2017,09/17,NewOrleansMobile,1.62,136981,25106,108,46789,10177,113,Fall,183770,35283,221,False
2017,09/10,NewOrleansMobile,1.62,123071,24260,164,59451,5951,4436,Fall,182522,30211,4600,False
2017,09/03,NewOrleansMobile,1.57,129857,26734,290,56267,9259,4757,Fall,186124,35993,5047,False
2017,08/27,NewOrleansMobile,1.46,133655,27697,188,58890,5129,4186,Summer,192545,32826,4374,False
2017,08/20,NewOrleansMobile,1.46,128287,25042,77,61052,10098,2386,Summer,189339,35140,2463,False
2017,08/13,NewOrleansMobile,1.39,130628,30558,82,60970,10286,4171,Summer,191598,40844,4253,False
2017,08/06,NewOrleansMobile,1.33,130001,34141,44,56841,10734,9220,Summer,186842,44875,9264,False
2017,07/30,NewOrleansMobile,1.4,142551,30114,41,55778,9484,8066,Summer,198329,39598,8107,False
2017,07/23,NewOrleansMobile,1.39,155838,38067,78,49217,12526,7046,Summer,205055,50593,7124,False
2017,07/16,NewOrleansMobile,1.32,120631,29406,39,64601,9641,8593,Summer,185232,39047,8632,False
2017,07/09,NewOrleansMobile,1.26,156935,23221,28,80324,5261,2156,Summer,237259,28482,2184,False
2017,07/02,NewOrleansMobile,1.27,177146,24028,64,93220,4992,2600,Summer,270366,29020,2664,False
2017,06/25,NewOrleansMobile,1.3,168867,19760,104,94389,8091,1865,Summer,263256,27851,1969,False
2017,06/18,NewOrleansMobile,1.29,177973,25893,157,76256,4569,2885,Summer,254229,30462,3042,False
2017,06/11,NewOrleansMobile,1.32,187011,31940,188,76637,8992,7925,Summer,263648,40932,8113,False
2017,06/04,NewOrleansMobile,1.38,158511,25352,298,53362,5313,13705,Summer,211873,30665,14003,False
2017,05/28,NewOrleansMobile,1.39,182795,30514,267,55454,10461,14115,Spring,238249,40975,14382,False
2017,05/21,NewOrleansMobile,1.36,155348,27177,345,46750,10833,11655,Spring,202098,38010,12000,False
2017,05/14,NewOrleansMobile,1.35,139087,25294,347,49414,10375,16675,Spring,188501,35669,17022,False
2017,05/07,NewOrleansMobile,1.02,261367,53102,220,86740,17223,5185,Spring,348107,70325,5405,False
2017,04/30,NewOrleansMobile,1.32,193112,28592,251,60607,10988,7895,Spring,253719,39580,8146,False
2017,04/23,NewOrleansMobile,1.35,134821,21723,301,52284,8843,9660,Spring,187105,30566,9961,False
2017,04/16,NewOrleansMobile,1.27,156177,33661,241,59163,9889,9590,Spring,215340,43550,9831,False
2017,04/09,NewOrleansMobile,1.34,134722,26489,249,55994,8934,9297,Spring,190716,35423,9546,False
2017,04/02,NewOrleansMobile,1.37,137881,33317,192,53763,9845,8155,Spring,191644,43162,8347,False
2017,03/26,NewOrleansMobile,1.38,133157,29086,355,53280,10526,10107,Spring,186437,39612,10462,False
2017,03/19,NewOrleansMobile,1.32,130993,32649,284,51297,9849,6275,Spring,182290,42498,6559,False
2017,03/12,NewOrleansMobile,1.32,145739,25219,271,51341,9832,6680,Spring,197080,35051,6951,False
2017,03/05,NewOrleansMobile,1.13,134356,50228,184,55427,8536,6180,Spring,189783,58764,6364,False
2017,02/26,NewOrleansMobile,0.98,190219,30519,140,69741,8046,8970,Winter,259960,38565,9110,False
2017,02/19,NewOrleansMobile,1.11,123639,24706,289,54549,7834,9320,Winter,178188,32540,9609,False
2017,02/12,NewOrleansMobile,0.9,160040,30195,443,59560,13862,11900,Winter,219600,44057,12343,False
2017,02/05,NewOrleansMobile,0.61,400599,80089,402,119084,26378,6680,Winter,519683,106467,7082,False
2017,01/29,NewOrleansMobile,0.97,208314,36546,316,77868,15523,5670,Winter,286182,52069,5986,False
2017,01/22,NewOrleansMobile,1.06,138670,34757,273,56028,29497,8105,Winter,194698,64254,8378,False
2017,01/15,NewOrleansMobile,1.01,171326,35657,232,60508,16912,6445,Winter,231834,52569,6677,False
2017,01/08,NewOrleansMobile,1.1,124108,31296,316,52403,13645,9115,Winter,176511,44941,9431,False
2017,01/01,NewOrleansMobile,0.81,175385,42839,242,68817,24039,7348,Winter,244202,66878,7590,False
2017,12/31,NewYork,1.33,36680,816261,445,269325,78507,0,Winter,306005,894768,445,False
2017,12/24,NewYork,1.34,36684,791089,1217,379573,24894,2,Winter,416257,815983,1219,False
2017,12/17,NewYork,1.41,35511,661369,601,465885,18174,17,Winter,501396,679543,618,False
2017,12/10,NewYork,1.14,48483,1906061,1561,411052,23130,19,Winter,459535,1929191,1580,False
2017,12/03,NewYork,1.41,42352,652690,580,466132,30177,0,Winter,508484,682867,580,False
2017,11/26,NewYork,1.42,39943,696301,697,373479,99837,0,Fall,413422,796138,697,False
2017,11/19,NewYork,1.37,47063,654065,710,448431,185014,16,Fall,495494,839079,726,False
2017,11/12,NewYork,1.52,51661,667319,710,369347,33312,0,Fall,421008,700631,710,False
2017,11/05,NewYork,1.41,61830,632293,600,563910,60984,23,Fall,625740,693277,623,False
2017,10/29,NewYork,1.57,74423,788262,779,330959,23366,15,Fall,405382,811628,794,False
2017,10/22,NewYork,1.54,71422,788731,491,368385,24011,3,Fall,439807,812742,494,False
2017,10/15,NewYork,1.68,75694,747793,632,319602,33027,0,Fall,395296,780820,632,False
2017,10/08,NewYork,1.69,75444,669974,872,340114,19056,0,Fall,415558,689030,872,False
2017,10/01,NewYork,1.67,83287,707902,547,377569,32584,0,Fall,460856,740486,547,False
2017,09/24,NewYork,1.65,77197,716125,599,362090,22488,3,Fall,439287,738613,602,False
2017,09/17,NewYork,1.61,71450,693111,408,355131,34823,0,Fall,426581,727934,408,False
2017,09/10,NewYork,1.61,76107,681320,640,356286,35547,1055,Fall,432393,716867,1695,False
2017,09/03,NewYork,1.8,72172,630743,517,360305,9201,5051,Fall,432477,639944,5568,False
2017,08/27,NewYork,1.81,73400,639876,702,358843,13593,14570,Summer,432243,653469,15272,False
2017,08/20,NewYork,1.75,72101,582403,620,377884,20393,3785,Summer,449985,602796,4405,False
2017,08/13,NewYork,1.58,64027,686338,1222,462811,49542,3296,Summer,526838,735880,4518,False
2017,08/06,NewYork,1.56,59767,821262,2432,358318,24812,10827,Summer,418085,846074,13259,False
2017,07/30,NewYork,1.52,63098,856414,3849,362404,17642,2816,Summer,425502,874056,6665,False
2017,07/23,NewYork,1.55,63537,830714,3112,380873,21311,7328,Summer,444410,852025,10440,False
2017,07/16,NewYork,1.57,71450,859372,3388,368995,13580,10976,Summer,440445,872952,14364,False
2017,07/09,NewYork,1.63,82965,800414,3563,494674,42918,18132,Summer,577639,843332,21695,False
2017,07/02,NewYork,1.72,56685,733184,3145,270378,223986,17180,Summer,327063,957170,20325,False
2017,06/25,NewYork,1.47,53675,1060721,3691,260423,126518,16568,Summer,314098,1187239,20259,False
2017,06/18,NewYork,1.82,55732,765117,3600,290382,113734,13592,Summer,346114,878851,17192,False
2017,06/11,NewYork,1.74,54293,753430,3000,322838,233754,6867,Summer,377131,987184,9867,False
2017,06/04,NewYork,1.83,51740,834879,3267,345141,90033,10398,Summer,396881,924912,13665,False
2017,05/28,NewYork,1.75,52861,824445,4083,372163,178834,18757,Spring,425024,1003279,22840,False
2017,05/21,NewYork,1.8,54128,817106,3335,352350,70436,885,Spring,406478,887542,4220,False
2017,05/14,NewYork,1.75,51358,797684,4111,445866,71417,16981,Spring,497224,869101,21092,False
2017,05/07,NewYork,1.65,56814,920313,3634,451173,305309,9579,Spring,507987,1225622,13213,False
2017,04/30,NewYork,1.84,48042,808258,2747,314750,44523,9777,Spring,362792,852781,12524,False
2017,04/23,NewYork,1.68,45532,838408,2853,312758,41885,6171,Spring,358290,880293,9024,False
2017,04/16,NewYork,1.76,38975,775310,4900,339953,55759,7991,Spring,378928,831069,12891,False
2017,04/09,NewYork,1.75,37746,775729,2839,407168,51164,3073,Spring,444914,826893,5912,False
2017,04/02,NewYork,1.74,36138,791416,4113,340915,48526,216,Spring,377053,839942,4329,False
2017,03/26,NewYork,1.72,28449,717035,20182,330935,49533,8756,Spring,359384,766568,28938,False
2017,03/19,NewYork,1.7,16705,737596,17545,336742,40754,6531,Spring,353447,778350,24076,False
2017,03/12,NewYork,1.76,16828,755172,12532,326854,49775,2540,Spring,343682,804947,15072,False
2017,03/05,NewYork,1.39,31240,1065008,34775,297818,33380,3345,Spring,329058,1098388,38120,False
2017,02/26,NewYork,1.55,37239,855650,7080,269130,65872,6408,Winter,306369,921522,13488,False
2017,02/19,NewYork,1.28,107882,609206,6704,286438,41374,527,Winter,394320,650580,7231,False
2017,02/12,NewYork,1.19,294591,1177334,13287,400217,63416,6549,Winter,694808,1240750,19836,False
2017,02/05,NewYork,1.24,172265,1744342,279630,290463,50135,7645,Winter,462728,1794477,287275,False
2017,01/29,NewYork,1.52,17844,816423,94445,285574,51331,4944,Winter,303418,867754,99389,False
2017,01/22,NewYork,1.48,15652,1169600,206537,288384,36337,5404,Winter,304036,1205937,211941,False
2017,01/15,NewYork,1.38,14301,995747,58355,275101,38860,1896,Winter,289402,1034607,60251,False
2017,01/08,NewYork,1.29,18585,1207607,6403,258470,40822,186,Winter,277055,1248429,6589,False
2017,01/01,NewYork,1.44,10498,668183,22804,208504,30684,307,Winter,219002,698867,23111,False
2017,12/31,NorthernNewEngland,1.13,12055,455794,1957,16181,27328,0,Winter,28236,483122,1957,False
2017,12/24,NorthernNewEngland,1.36,8585,251130,1335,24294,62465,0,Winter,32879,313595,1335,False
2017,12/17,NorthernNewEngland,1.26,8588,304318,2955,18037,60707,0,Winter,26625,365025,2955,False
2017,12/10,NorthernNewEngland,1.29,9450,265318,1317,33221,55269,0,Winter,42671,320587,1317,False
2017,12/03,NorthernNewEngland,1.1,15373,576981,1540,20648,21564,0,Winter,36021,598545,1540,False
2017,11/26,NorthernNewEngland,1.41,7679,210476,1350,15877,35483,0,Fall,23556,245959,1350,False
2017,11/19,NorthernNewEngland,1.36,8451,230533,1285,16744,54591,0,Fall,25195,285124,1285,False
2017,11/12,NorthernNewEngland,1.01,19108,588116,3876,15795,54675,0,Fall,34903,642791,3876,False
2017,11/05,NorthernNewEngland,1.51,9954,229668,1209,18323,29437,0,Fall,28277,259105,1209,False
2017,10/29,NorthernNewEngland,1.5,10155,237554,1307,32792,22356,0,Fall,42947,259910,1307,False
2017,10/22,NorthernNewEngland,1.52,12997,237665,1461,25885,22966,0,Fall,38882,260631,1461,False
2017,10/15,NorthernNewEngland,1.58,12295,244434,1566,17241,22827,0,Fall,29536,267261,1566,False
2017,10/08,NorthernNewEngland,1.61,13747,203354,1304,14987,33928,0,Fall,28734,237282,1304,False
2017,10/01,NorthernNewEngland,1.64,12237,217700,1440,20376,38766,0,Fall,32613,256466,1440,False
2017,09/24,NorthernNewEngland,1.63,10778,233287,1510,13437,37878,0,Fall,24215,271165,1510,False
2017,09/17,NorthernNewEngland,1.59,17182,213664,1190,18883,30805,106,Fall,36065,244469,1296,False
2017,09/10,NorthernNewEngland,1.74,23481,229059,1536,19750,36065,2646,Fall,43231,265124,4182,False
2017,09/03,NorthernNewEngland,1.88,24015,215287,1644,16764,28132,2366,Fall,40779,243419,4010,False
2017,08/27,NorthernNewEngland,1.83,11729,202013,1677,19695,41491,950,Summer,31424,243504,2627,False
2017,08/20,NorthernNewEngland,1.82,5632,242365,2441,22942,46083,3496,Summer,28574,288448,5937,False
2017,08/13,NorthernNewEngland,1.24,8993,476884,5005,19689,39173,4643,Summer,28682,516057,9648,False
2017,08/06,NorthernNewEngland,1.59,7918,369483,4703,22061,55252,2993,Summer,29979,424735,7696,False
2017,07/30,NorthernNewEngland,1.55,7321,340883,4312,18260,40432,1726,Summer,25581,381315,6038,False
2017,07/23,NorthernNewEngland,1.38,7288,387463,6472,10484,49641,3526,Summer,17772,437104,9998,False
2017,07/16,NorthernNewEngland,1.39,12060,404809,11916,12580,46560,3012,Summer,24640,451369,14928,False
2017,07/09,NorthernNewEngland,1.48,12466,397668,11922,22095,36856,5205,Summer,34561,434524,17127,False
2017,07/02,NorthernNewEngland,1.57,9383,330212,22416,29585,36241,4725,Summer,38968,366453,27141,False
2017,06/25,NorthernNewEngland,1.62,8947,270962,13004,28816,33800,3790,Summer,37763,304762,16794,False
2017,06/18,NorthernNewEngland,1.52,9653,327624,7455,31581,40114,3660,Summer,41234,367738,11115,False
2017,06/11,NorthernNewEngland,1.62,9491,326672,2468,26940,37008,3903,Summer,36431,363680,6371,False
2017,06/04,NorthernNewEngland,1.66,8209,322243,2107,31580,36384,1111,Summer,39789,358627,3218,False
2017,05/28,NorthernNewEngland,1.66,10552,357297,2336,41798,32252,813,Spring,52350,389549,3149,False
2017,05/21,NorthernNewEngland,1.54,10135,314676,2188,34182,32016,90,Spring,44317,346692,2278,False
2017,05/14,NorthernNewEngland,1.53,7559,295163,2628,41685,44152,0,Spring,49244,339315,2628,False
2017,05/07,NorthernNewEngland,1.23,8809,334984,4090,41452,154825,38,Spring,50261,489809,4128,False
2017,04/30,NorthernNewEngland,1.39,9127,296827,1939,41352,58543,0,Spring,50479,355370,1939,False
2017,04/23,NorthernNewEngland,1.38,12604,255970,2244,41763,92156,0,Spring,54367,348126,2244,False
2017,04/16,NorthernNewEngland,1.46,11163,314450,2270,45791,43804,0,Spring,56954,358254,2270,False
2017,04/09,NorthernNewEngland,1.33,14320,418277,2325,50867,29981,2,Spring,65187,448258,2327,False
2017,04/02,NorthernNewEngland,1.45,12862,298461,2600,36643,71634,0,Spring,49505,370095,2600,False
2017,03/26,NorthernNewEngland,1.38,10551,299053,2432,43814,60380,537,Spring,54365,359433,2969,False
2017,03/19,NorthernNewEngland,1.43,7926,267013,2512,45010,58150,0,Spring,52936,325163,2512,False
2017,03/12,NorthernNewEngland,1.41,8862,272805,2790,27188,86213,0,Spring,36050,359018,2790,False
2017,03/05,NorthernNewEngland,1.38,9417,318710,4245,52455,0,0,Spring,61872,318710,4245,False
2017,02/26,NorthernNewEngland,1.25,9612,363051,5133,56404,0,0,Winter,66016,363051,5133,False
2017,02/19,NorthernNewEngland,1.37,8811,295892,3364,67249,3,0,Winter,76060,295895,3364,False
2017,02/12,NorthernNewEngland,1.13,13508,424253,7548,56051,3,0,Winter,69559,424256,7548,False
2017,02/05,NorthernNewEngland,1.13,23160,625037,4984,48524,0,0,Winter,71684,625037,4984,False
2017,01/29,NorthernNewEngland,1.21,15901,348629,3634,55222,0,0,Winter,71123,348629,3634,False
2017,01/22,NorthernNewEngland,1.17,16606,421568,9377,54789,3,0,Winter,71395,421571,9377,False
2017,01/15,NorthernNewEngland,1.25,13397,330248,6370,71246,0,0,Winter,84643,330248,6370,False
2017,01/08,NorthernNewEngland,1.19,13448,348811,5517,57223,0,0,Winter,70671,348811,5517,False
2017,01/01,NorthernNewEngland,1.11,20667,414792,3313,37466,0,0,Winter,58133,414792,3313,False
2017,12/31,Orlando,1.16,314324,38867,665,56521,51536,0,Winter,370845,90403,665,False
2017,12/24,Orlando,1.39,178469,21232,779,60988,30820,0,Winter,239457,52052,779,False
2017,12/17,Orlando,1.01,248830,30567,865,56490,44549,0,Winter,305320,75116,865,False
2017,12/10,Orlando,1.02,267852,33749,892,63079,59365,0,Winter,330931,93114,892,False
2017,12/03,Orlando,1.31,202974,23478,987,60278,30905,3,Winter,263252,54383,990,False
2017,11/26,Orlando,1.4,171834,19833,645,56566,23490,0,Fall,228400,43323,645,False
2017,11/19,Orlando,1.2,212316,27720,907,63245,45015,3,Fall,275561,72735,910,False
2017,11/12,Orlando,1.38,203135,24511,902,80933,20525,0,Fall,284068,45036,902,False
2017,11/05,Orlando,1.48,185134,22655,698,54667,27265,0,Fall,239801,49920,698,False
2017,10/29,Orlando,1.22,257257,33771,570,77035,30786,0,Fall,334292,64557,570,False
2017,10/22,Orlando,1.56,214853,27481,613,50444,34933,0,Fall,265297,62414,613,False
2017,10/15,Orlando,1.74,176622,22938,94,57999,30926,0,Fall,234621,53864,94,False
2017,10/08,Orlando,1.85,195935,23473,50,63299,22104,0,Fall,259234,45577,50,False
2017,10/01,Orlando,2.0,166612,29616,15,42497,23856,3,Fall,209109,53472,18,False
2017,09/24,Orlando,1.83,172557,22851,114,39067,29207,3,Fall,211624,52058,117,False
2017,09/17,Orlando,1.76,181121,30283,63,16154,44255,3,Fall,197275,74538,66,False
2017,09/10,Orlando,1.7,159141,19370,698,49005,22215,3196,Fall,208146,41585,3894,False
2017,09/03,Orlando,1.8,189267,26200,653,58009,19778,1986,Fall,247276,45978,2639,False
2017,08/27,Orlando,1.57,189042,27713,101,46809,27371,5718,Summer,235851,55084,5819,False
2017,08/20,Orlando,1.57,191383,28989,54,37834,33852,5850,Summer,229217,62841,5904,False
2017,08/13,Orlando,1.44,227667,38433,166,41567,47374,8706,Summer,269234,85807,8872,False
2017,08/06,Orlando,1.41,209093,34123,147,44905,31827,6258,Summer,253998,65950,6405,False
2017,07/30,Orlando,1.4,208380,32846,204,46344,29287,4360,Summer,254724,62133,4564,False
2017,07/23,Orlando,1.38,237300,33319,196,48111,36664,6142,Summer,285411,69983,6338,False
2017,07/16,Orlando,1.42,202249,34024,218,51403,36936,6920,Summer,253652,70960,7138,False
2017,07/09,Orlando,1.4,207541,33999,126,58274,31959,11175,Summer,265815,65958,11301,False
2017,07/02,Orlando,1.4,247137,50254,190,61248,45105,10240,Summer,308385,95359,10430,False
2017,06/25,Orlando,1.35,230886,38375,94,60122,40833,6095,Summer,291008,79208,6189,False
2017,06/18,Orlando,1.4,215668,32674,115,49398,34065,7305,Summer,265066,66739,7420,False
2017,06/11,Orlando,1.41,246114,41215,61,61632,46130,6210,Summer,307746,87345,6271,False
2017,06/04,Orlando,1.41,250523,40813,48,59333,48034,1673,Summer,309856,88847,1721,False
2017,05/28,Orlando,1.4,238131,39531,74,71721,31992,40,Spring,309852,71523,114,False
2017,05/21,Orlando,1.41,225241,38535,103,60657,32650,218,Spring,285898,71185,321,False
2017,05/14,Orlando,1.42,203335,33864,77,60404,24508,0,Spring,263739,58372,77,False
2017,05/07,Orlando,1.17,340439,66961,98,67552,54085,0,Spring,407991,121046,98,False
2017,04/30,Orlando,1.24,312135,64372,47,53232,50039,0,Spring,365367,114411,47,False
2017,04/23,Orlando,1.44,220178,41901,58,57365,26467,0,Spring,277543,68368,58,False
2017,04/16,Orlando,1.47,181939,38374,32,49866,35583,0,Spring,231805,73957,32,False
2017,04/09,Orlando,1.49,189598,39854,48,46129,35589,0,Spring,235727,75443,48,False
2017,04/02,Orlando,1.59,179139,38059,60,45744,34620,164,Spring,224883,72679,224,False
2017,03/26,Orlando,1.62,164358,38333,88,44649,34365,0,Spring,209007,72698,88,False
2017,03/19,Orlando,1.53,160686,38524,47,56308,31630,0,Spring,216994,70154,47,False
2017,03/12,Orlando,1.52,163532,41183,75,51987,33232,0,Spring,215519,74415,75,False
2017,03/05,Orlando,1.55,159001,39733,36,41112,30993,0,Spring,200113,70726,36,False
2017,02/26,Orlando,1.25,172780,46592,70,53501,34737,3,Winter,226281,81329,73,False
2017,02/19,Orlando,1.26,149730,40603,58,40951,30721,44,Winter,190681,71324,102,False
2017,02/12,Orlando,0.95,242212,81697,264,48557,57365,0,Winter,290769,139062,264,False
2017,02/05,Orlando,0.85,362670,151154,307,94810,101426,830,Winter,457480,252580,1137,False
2017,01/29,Orlando,1.24,153528,72365,196,70535,67422,0,Winter,224063,139787,196,False
2017,01/22,Orlando,1.0,167213,125193,178,66571,121936,180,Winter,233784,247129,358,False
2017,01/15,Orlando,1.27,148500,72248,175,69128,66907,0,Winter,217628,139155,175,False
2017,01/08,Orlando,1.28,118255,62039,116,65681,55671,5,Winter,183936,117710,121,False
2017,01/01,Orlando,0.95,166581,110283,151,61681,108384,0,Winter,228262,218667,151,False
2017,12/31,Philadelphia,1.35,17238,210750,276,79090,27426,0,Winter,96328,238176,276,False
2017,12/24,Philadelphia,1.34,17276,226538,472,116972,18161,0,Winter,134248,244699,472,False
2017,12/17,Philadelphia,1.43,17554,195308,131,114735,16471,2,Winter,132289,211779,133,False
2017,12/10,Philadelphia,1.23,23492,418502,518,113064,20276,0,Winter,136556,438778,518,False
2017,12/03,Philadelphia,1.35,20978,209391,293,128086,20793,0,Winter,149064,230184,293,False
2017,11/26,Philadelphia,1.38,17523,172416,269,118548,28309,0,Fall,136071,200725,269,False
2017,11/19,Philadelphia,1.34,22293,175118,402,131913,54389,0,Fall,154206,229507,402,False
2017,11/12,Philadelphia,1.45,28196,195219,203,108280,24629,0,Fall,136476,219848,203,False
2017,11/05,Philadelphia,1.4,38006,174069,181,141562,30808,0,Fall,179568,204877,181,False
2017,10/29,Philadelphia,1.53,40321,209091,274,111580,5986,5,Fall,151901,215077,279,False
2017,10/22,Philadelphia,1.53,39322,201632,288,122293,12659,0,Fall,161615,214291,288,False
2017,10/15,Philadelphia,1.64,44235,197307,235,110631,16556,0,Fall,154866,213863,235,False
2017,10/08,Philadelphia,1.67,43189,163922,336,117136,6584,0,Fall,160325,170506,336,False
2017,10/01,Philadelphia,1.62,45811,195759,255,133321,14840,0,Fall,179132,210599,255,False
2017,09/24,Philadelphia,1.58,47744,204123,395,121155,10231,4,Fall,168899,214354,399,False
2017,09/17,Philadelphia,1.54,41947,195393,131,114989,13754,23,Fall,156936,209147,154,False
2017,09/10,Philadelphia,1.54,49621,185295,179,116229,4683,2600,Fall,165850,189978,2779,False
2017,09/03,Philadelphia,1.7,46296,199034,223,111664,4430,2255,Fall,157960,203464,2478,False
2017,08/27,Philadelphia,1.68,45068,196136,604,117020,11204,252,Summer,162088,207340,856,False
2017,08/20,Philadelphia,1.64,41521,188024,1049,118791,16327,2383,Summer,160312,204351,3432,False
2017,08/13,Philadelphia,1.54,37776,200247,682,126569,18466,2148,Summer,164345,218713,2830,False
2017,08/06,Philadelphia,1.48,33708,225677,1472,107141,12272,2380,Summer,140849,237949,3852,False
2017,07/30,Philadelphia,1.47,36123,238811,1343,117153,9611,986,Summer,153276,248422,2329,False
2017,07/23,Philadelphia,1.47,35968,227600,415,117089,10184,2103,Summer,153057,237784,2518,False
2017,07/16,Philadelphia,1.51,42039,224289,513,105159,6522,2945,Summer,147198,230811,3458,False
2017,07/09,Philadelphia,1.59,44522,225551,494,111684,18000,5866,Summer,156206,243551,6360,False
2017,07/02,Philadelphia,1.68,38790,196153,582,93672,31592,4696,Summer,132462,227745,5278,False
2017,06/25,Philadelphia,1.5,40402,268986,632,89625,17872,4711,Summer,130027,286858,5343,False
2017,06/18,Philadelphia,1.75,41177,219693,586,95067,20864,2850,Summer,136244,240557,3436,False
2017,06/11,Philadelphia,1.73,38042,205769,620,101707,31846,1940,Summer,139749,237615,2560,False
2017,06/04,Philadelphia,1.8,38390,221022,643,118507,15415,327,Summer,156897,236437,970,False
2017,05/28,Philadelphia,1.74,41076,232834,662,130634,27089,445,Spring,171710,259923,1107,False
2017,05/21,Philadelphia,1.75,39609,214417,619,118137,12100,191,Spring,157746,226517,810,False
2017,05/14,Philadelphia,1.75,38509,194669,536,142282,11346,631,Spring,180791,206015,1167,False
2017,05/07,Philadelphia,1.66,42673,249542,919,155183,42203,834,Spring,197856,291745,1753,False
2017,04/30,Philadelphia,1.78,36817,222850,492,119345,7305,94,Spring,156162,230155,586,False
2017,04/23,Philadelphia,1.66,34157,208134,416,105813,15167,0,Spring,139970,223301,416,False
2017,04/16,Philadelphia,1.74,31877,220755,406,120676,16680,0,Spring,152553,237435,406,False
2017,04/09,Philadelphia,1.7,30725,213528,566,143053,10506,220,Spring,173778,224034,786,False
2017,04/02,Philadelphia,1.68,30716,208155,757,138280,7821,0,Spring,168996,215976,757,False
2017,03/26,Philadelphia,1.66,24691,219076,2819,124540,8828,0,Spring,149231,227904,2819,False
2017,03/19,Philadelphia,1.66,16003,220282,3440,119317,14115,0,Spring,135320,234397,3440,False
2017,03/12,Philadelphia,1.74,16961,230010,6116,112097,12054,375,Spring,129058,242064,6491,False
2017,03/05,Philadelphia,1.48,15629,245417,13667,130174,5062,0,Spring,145803,250479,13667,False
2017,02/26,Philadelphia,1.49,18063,251740,2094,122476,16639,0,Winter,140539,268379,2094,False
2017,02/19,Philadelphia,1.37,29184,205018,1022,125901,7863,294,Winter,155085,212881,1316,False
2017,02/12,Philadelphia,1.19,69860,269591,3923,208810,19337,694,Winter,278670,288928,4617,False
2017,02/05,Philadelphia,1.28,77182,383060,58041,111889,13700,1781,Winter,189071,396760,59822,False
2017,01/29,Philadelphia,1.48,27673,248553,20098,114418,10028,543,Winter,142091,258581,20641,False
2017,01/22,Philadelphia,1.51,18201,287008,58242,114958,9387,1547,Winter,133159,296395,59789,False
2017,01/15,Philadelphia,1.44,16847,282239,8983,118443,9006,220,Winter,135290,291245,9203,False
2017,01/08,Philadelphia,1.39,16209,298757,1201,111625,7753,198,Winter,127834,306510,1399,False
2017,01/01,Philadelphia,1.4,12767,217447,3090,83428,5163,43,Winter,96195,222610,3133,False
2017,12/31,PhoenixTucson,0.75,422070,283040,12415,173098,93945,1903,Winter,595168,376985,14318,False
2017,12/24,PhoenixTucson,0.75,488446,176311,14450,230660,93116,3493,Winter,719106,269427,17943,False
2017,12/17,PhoenixTucson,0.7,508369,216817,8575,207680,86441,4003,Winter,716049,303258,12578,False
2017,12/10,PhoenixTucson,0.64,731583,200595,10237,199484,77062,3676,Winter,931067,277657,13913,False
2017,12/03,PhoenixTucson,0.72,678640,215949,10981,156307,70637,3362,Winter,834947,286586,14343,False
2017,11/26,PhoenixTucson,0.77,529091,181823,10223,133534,72473,2681,Fall,662625,254296,12904,False
2017,11/19,PhoenixTucson,0.6,953957,202003,10913,117939,139564,2991,Fall,1071896,341567,13904,False
2017,11/12,PhoenixTucson,0.72,691378,271700,10123,166855,106780,1886,Fall,858233,378480,12009,False
2017,11/05,PhoenixTucson,0.79,555816,227846,9212,330740,81893,2526,Fall,886556,309739,11738,False
2017,10/29,PhoenixTucson,0.98,368642,273118,7336,145789,69622,1627,Fall,514431,342740,8963,False
2017,10/22,PhoenixTucson,1.04,352330,241655,3878,170612,41122,3,Fall,522942,282777,3881,False
2017,10/15,PhoenixTucson,1.17,338241,217038,2634,168675,49516,1,Fall,506916,266554,2635,False
2017,10/08,PhoenixTucson,1.28,334851,146162,2097,183526,47192,16,Fall,518377,193354,2113,False
2017,10/01,PhoenixTucson,1.31,289195,153391,2561,184421,36823,80,Fall,473616,190214,2641,False
2017,09/24,PhoenixTucson,1.24,337495,155470,2333,132493,57632,17,Fall,469988,213102,2350,False
2017,09/17,PhoenixTucson,1.22,375755,152686,2172,139237,61433,3,Fall,514992,214119,2175,False
2017,09/10,PhoenixTucson,1.2,397475,129503,3441,141600,55189,417,Fall,539075,184692,3858,False
2017,09/03,PhoenixTucson,1.2,407081,136998,5005,109254,66904,2667,Fall,516335,203902,7672,False
2017,08/27,PhoenixTucson,1.18,378232,125819,10404,144419,50196,6275,Summer,522651,176015,16679,False
2017,08/20,PhoenixTucson,1.14,404665,127106,12550,152307,72488,4827,Summer,556972,199594,17377,False
2017,08/13,PhoenixTucson,1.01,458381,178230,12192,178802,109113,3670,Summer,637183,287343,15862,False
2017,08/06,PhoenixTucson,0.94,493642,198503,11502,166106,101493,3684,Summer,659748,299996,15186,False
2017,07/30,PhoenixTucson,0.96,482854,163669,12228,160062,109657,2445,Summer,642916,273326,14673,False
2017,07/23,PhoenixTucson,0.89,540131,267082,12298,148179,104409,488,Summer,688310,371491,12786,False
2017,07/16,PhoenixTucson,0.92,499391,211064,12355,141156,108849,703,Summer,640547,319913,13058,False
2017,07/09,PhoenixTucson,0.75,568223,232289,12866,321383,213096,0,Summer,889606,445385,12866,False
2017,07/02,PhoenixTucson,0.77,551528,185311,14893,276703,195838,383,Summer,828231,381149,15276,False
2017,06/25,PhoenixTucson,0.77,551529,184895,12891,239584,207048,1473,Summer,791113,391943,14364,False
2017,06/18,PhoenixTucson,0.7,592933,295319,12531,235981,189932,0,Summer,828914,485251,12531,False
2017,06/11,PhoenixTucson,0.68,786718,187402,14150,235639,193693,0,Summer,1022357,381095,14150,False
2017,06/04,PhoenixTucson,0.76,575382,178626,14892,251109,207645,393,Summer,826491,386271,15285,False
2017,05/28,PhoenixTucson,0.81,535029,206991,17174,211188,205430,1279,Spring,746217,412421,18453,False
2017,05/21,PhoenixTucson,0.74,511917,268221,14020,193930,175110,536,Spring,705847,443331,14556,False
2017,05/14,PhoenixTucson,0.69,612625,239024,14939,275375,154056,1097,Spring,888000,393080,16036,False
2017,05/07,PhoenixTucson,0.65,813990,282109,16944,213850,219720,148,Spring,1027840,501829,17092,False
2017,04/30,PhoenixTucson,0.75,480904,236525,13569,128890,220515,133,Spring,609794,457040,13702,False
2017,04/23,PhoenixTucson,0.7,544507,243224,17245,128243,263385,1248,Spring,672750,506609,18493,False
2017,04/16,PhoenixTucson,0.73,621533,193885,19435,227061,193282,95,Spring,848594,387167,19530,False
2017,04/09,PhoenixTucson,0.65,707466,220405,18966,145354,171728,318,Spring,852820,392133,19284,False
2017,04/02,PhoenixTucson,0.67,692107,190493,20666,213105,197107,1540,Spring,905212,387600,22206,False
2017,03/26,PhoenixTucson,0.57,990504,203409,20130,219158,174184,548,Spring,1209662,377593,20678,False
2017,03/19,PhoenixTucson,0.68,598359,205006,19620,229269,188397,630,Spring,827628,393403,20250,False
2017,03/12,PhoenixTucson,0.65,714430,176678,18778,240361,113409,933,Spring,954791,290087,19711,False
2017,03/05,PhoenixTucson,0.67,551312,221516,15504,250902,136918,777,Spring,802214,358434,16281,False
2017,02/26,PhoenixTucson,0.65,558763,289095,14923,113594,169659,188,Winter,672357,458754,15111,False
2017,02/19,PhoenixTucson,0.67,624947,260052,14748,126572,145260,290,Winter,751519,405312,15038,False
2017,02/12,PhoenixTucson,0.54,917584,257573,18976,118301,269542,898,Winter,1035885,527115,19874,False
2017,02/05,PhoenixTucson,0.46,1200632,531226,18324,113752,330583,6030,Winter,1314384,861809,24354,False
2017,01/29,PhoenixTucson,0.58,799387,246921,16440,114964,202520,286,Winter,914351,449441,16726,False
2017,01/22,PhoenixTucson,0.54,909748,296612,15561,98982,280317,0,Winter,1008730,576929,15561,False
2017,01/15,PhoenixTucson,0.6,689503,362435,13938,136614,267595,100,Winter,826117,630030,14038,False
2017,01/08,PhoenixTucson,0.73,515078,275341,16071,140574,191804,0,Winter,655652,467145,16071,False
2017,01/01,PhoenixTucson,0.63,560445,325471,15079,117177,151421,43,Winter,677622,476892,15122,False
2017,12/31,Pittsburgh,1.01,76689,30458,2273,28145,13299,0,Winter,104834,43757,2273,False
2017,12/24,Pittsburgh,1.29,29723,18387,1008,32590,6235,0,Winter,62313,24622,1008,False
2017,12/17,Pittsburgh,1.01,66813,29425,2193,30505,12957,0,Winter,97318,42382,2193,False
2017,12/10,Pittsburgh,1.27,34239,19312,1573,31900,6411,0,Winter,66139,25723,1573,False
2017,12/03,Pittsburgh,1.18,36640,20642,1451,27782,7383,0,Winter,64422,28025,1451,False
2017,11/26,Pittsburgh,1.02,60144,26227,2176,23424,12148,0,Fall,83568,38375,2176,False
2017,11/19,Pittsburgh,1.5,28168,17531,1896,35828,5660,0,Fall,63996,23191,1896,False
2017,11/12,Pittsburgh,1.51,30062,15533,1162,35203,5858,0,Fall,65265,21391,1162,False
2017,11/05,Pittsburgh,1.54,29627,17235,1064,32659,4843,0,Fall,62286,22078,1064,False
2017,10/29,Pittsburgh,1.52,30939,20179,1067,32383,5823,0,Fall,63322,26002,1067,False
2017,10/22,Pittsburgh,1.54,35800,22216,1088,34330,6485,0,Fall,70130,28701,1088,False
2017,10/15,Pittsburgh,1.56,34869,21509,1142,32424,8015,0,Fall,67293,29524,1142,False
2017,10/08,Pittsburgh,1.6,35817,10330,1240,29940,7542,0,Fall,65757,17872,1240,False
2017,10/01,Pittsburgh,1.33,43623,22847,1404,26558,11333,0,Fall,70181,34180,1404,False
2017,09/24,Pittsburgh,1.32,44018,25081,1558,23199,8788,16,Fall,67217,33869,1574,False
2017,09/17,Pittsburgh,1.29,43083,24457,1747,27434,7722,166,Fall,70517,32179,1913,False
2017,09/10,Pittsburgh,1.31,42781,23778,1402,23892,7239,980,Fall,66673,31017,2382,False
2017,09/03,Pittsburgh,1.31,43246,27966,1880,23478,6839,1525,Fall,66724,34805,3405,False
2017,08/27,Pittsburgh,1.28,43026,26492,1743,27608,7352,463,Summer,70634,33844,2206,False
2017,08/20,Pittsburgh,1.29,42108,25108,1582,26702,7058,1556,Summer,68810,32166,3138,False
2017,08/13,Pittsburgh,1.27,44556,26086,1284,26432,7035,1533,Summer,70988,33121,2817,False
2017,08/06,Pittsburgh,1.29,41518,28322,1457,26823,6373,1100,Summer,68341,34695,2557,False
2017,07/30,Pittsburgh,1.29,41263,27919,1465,26704,6275,723,Summer,67967,34194,2188,False
2017,07/23,Pittsburgh,1.29,42723,25661,1369,26991,7230,1036,Summer,69714,32891,2405,False
2017,07/16,Pittsburgh,1.26,44572,26346,1538,25479,6868,1540,Summer,70051,33214,3078,False
2017,07/09,Pittsburgh,1.25,45339,30916,1471,30093,6444,2310,Summer,75432,37360,3781,False
2017,07/02,Pittsburgh,1.25,50926,30335,1779,33133,6770,1924,Summer,84059,37105,3703,False
2017,06/25,Pittsburgh,1.26,47201,29968,1660,30778,8391,2210,Summer,77979,38359,3870,False
2017,06/18,Pittsburgh,1.29,47857,32486,1543,27652,8201,2002,Summer,75509,40687,3545,False
2017,06/11,Pittsburgh,1.33,51973,29897,1738,24054,7650,2052,Summer,76027,37547,3790,False
2017,06/04,Pittsburgh,1.33,51219,27379,1919,34198,8279,559,Summer,85417,35658,2478,False
2017,05/28,Pittsburgh,1.32,60061,29709,1890,44354,7658,0,Spring,104415,37367,1890,False
2017,05/21,Pittsburgh,1.02,105432,48642,3875,34916,14778,0,Spring,140348,63420,3875,False
2017,05/14,Pittsburgh,1.33,51068,20279,1751,41341,3086,329,Spring,92409,23365,2080,False
2017,05/07,Pittsburgh,1.03,107597,50334,3681,38144,14979,0,Spring,145741,65313,3681,False
2017,04/30,Pittsburgh,1.05,101894,53722,3641,31302,14958,41,Spring,133196,68680,3682,False
2017,04/23,Pittsburgh,1.34,48209,24388,1515,35733,7732,0,Spring,83942,32120,1515,False
2017,04/16,Pittsburgh,1.33,44551,23042,1422,40217,6777,0,Spring,84768,29819,1422,False
2017,04/09,Pittsburgh,1.36,48580,25212,1465,36384,7553,0,Spring,84964,32765,1465,False
2017,04/02,Pittsburgh,1.37,50365,27047,1687,35344,8500,0,Spring,85709,35547,1687,False
2017,03/26,Pittsburgh,1.34,43115,27137,1559,38441,7432,0,Spring,81556,34569,1559,False
2017,03/19,Pittsburgh,1.34,37849,28735,1151,35408,7133,0,Spring,73257,35868,1151,False
2017,03/12,Pittsburgh,1.34,37402,29383,1358,33537,6941,0,Spring,70939,36324,1358,False
2017,03/05,Pittsburgh,1.02,80177,47353,2909,28421,15705,0,Spring,108598,63058,2909,False
2017,02/26,Pittsburgh,1.33,37871,26478,1492,31339,6724,0,Winter,69210,33202,1492,False
2017,02/19,Pittsburgh,1.33,32493,24711,1212,27745,5416,0,Winter,60238,30127,1212,False
2017,02/12,Pittsburgh,1.28,31075,28242,1114,34235,5547,0,Winter,65310,33789,1114,False
2017,02/05,Pittsburgh,1.02,67986,47941,2927,27741,11383,0,Winter,95727,59324,2927,False
2017,01/29,Pittsburgh,1.26,34693,30342,1353,35389,5446,0,Winter,70082,35788,1353,False
2017,01/22,Pittsburgh,1.04,68732,45716,3110,30703,11041,0,Winter,99435,56757,3110,False
2017,01/15,Pittsburgh,1.08,74537,47948,3405,29876,12376,0,Winter,104413,60324,3405,False
2017,01/08,Pittsburgh,1.02,65343,47296,2616,27826,9698,0,Winter,93169,56994,2616,False
2017,01/01,Pittsburgh,1.02,58724,42203,2553,28298,9264,0,Winter,87022,51467,2553,False
2017,12/31,Portland,0.89,93210,250586,16024,204432,50366,330,Winter,297642,300952,16354,False
2017,12/24,Portland,1.33,64005,141179,12577,128039,61593,347,Winter,192044,202772,12924,False
2017,12/17,Portland,1.31,74946,158604,10853,133500,52414,594,Winter,208446,211018,11447,False
2017,12/10,Portland,1.29,110651,93996,15325,147247,57068,452,Winter,257898,151064,15777,False
2017,12/03,Portland,0.88,260954,168336,12318,295944,39575,302,Winter,556898,207911,12620,False
2017,11/26,Portland,1.48,99591,69191,12659,105787,48468,495,Fall,205378,117659,13154,False
2017,11/19,Portland,1.53,105421,72924,13313,84675,72816,1000,Fall,190096,145740,14313,False
2017,11/12,Portland,1.11,178779,115334,12996,231215,54586,410,Fall,409994,169920,13406,False
2017,11/05,Portland,1.03,225938,150840,14808,246798,42932,246,Fall,472736,193772,15054,False
2017,10/29,Portland,1.29,152604,128666,15431,175517,47898,511,Fall,328121,176564,15942,False
2017,10/22,Portland,1.36,138574,127745,14424,189637,40584,434,Fall,328211,168329,14858,False
2017,10/15,Portland,1.25,150707,240106,11215,91834,52424,643,Fall,242541,292530,11858,False
2017,10/08,Portland,1.9,92601,111769,14976,87516,54855,1706,Fall,180117,166624,16682,False
2017,10/01,Portland,1.84,97772,104336,14152,92339,52994,700,Fall,190111,157330,14852,False
2017,09/24,Portland,1.82,93965,95406,13094,93608,57417,687,Fall,187573,152823,13781,False
2017,09/17,Portland,1.83,99284,104444,12499,91160,70070,761,Fall,190444,174514,13260,False
2017,09/10,Portland,1.87,103658,106229,16044,85879,71546,1178,Fall,189537,177775,17222,False
2017,09/03,Portland,1.76,113711,118369,14533,106243,61915,357,Fall,219954,180284,14890,False
2017,08/27,Portland,1.34,168216,97433,12732,266476,52445,275,Summer,434692,149878,13007,False
2017,08/20,Portland,1.32,191682,131531,15625,276359,55932,486,Summer,468041,187463,16111,False
2017,08/13,Portland,1.71,100657,122555,14938,113265,81462,45,Summer,213922,204017,14983,False
2017,08/06,Portland,1.58,125451,146938,16332,162070,89822,262,Summer,287521,236760,16594,False
2017,07/30,Portland,1.34,145857,211102,14356,116878,87177,280,Summer,262735,298279,14636,False
2017,07/23,Portland,1.15,163681,240248,15020,99301,87801,74,Summer,262982,328049,15094,False
2017,07/16,Portland,1.38,141903,173049,14908,108090,91624,893,Summer,249993,264673,15801,False
2017,07/09,Portland,0.7,228987,231828,13755,656040,5097,360,Summer,885027,236925,14115,False
2017,07/02,Portland,0.99,138050,193657,15389,417909,1832,236,Summer,555959,195489,15625,False
2017,06/25,Portland,0.96,162934,169403,19050,450916,634,409,Summer,613850,170037,19459,False
2017,06/18,Portland,0.97,151651,165833,15531,422053,312,152,Summer,573704,166145,15683,False
2017,06/11,Portland,1.0,128990,168571,18215,401672,1316,171,Summer,530662,169887,18386,False
2017,06/04,Portland,1.12,120671,128831,23470,423593,2161,229,Summer,544264,130992,23699,False
2017,05/28,Portland,0.97,162040,194722,23352,438469,2179,86,Spring,600509,196901,23438,False
2017,05/21,Portland,1.01,160576,189301,21411,378471,433,151,Spring,539047,189734,21562,False
2017,05/14,Portland,0.95,162605,154258,20830,412487,14659,305,Spring,575092,168917,21135,False
2017,05/07,Portland,0.91,229401,253020,22084,370157,58789,373,Spring,599558,311809,22457,False
2017,04/30,Portland,0.84,220613,175669,20230,521942,1439,208,Spring,742555,177108,20438,False
2017,04/23,Portland,0.91,165357,200048,19111,370457,588,512,Spring,535814,200636,19623,False
2017,04/16,Portland,0.98,151790,168188,18907,403966,732,294,Spring,555756,168920,19201,False
2017,04/09,Portland,1.08,156932,145011,22074,385964,3215,279,Spring,542896,148226,22353,False
2017,04/02,Portland,1.12,152601,137424,20885,359313,1923,157,Spring,511914,139347,21042,False
2017,03/26,Portland,1.12,142591,127964,16620,338024,4248,463,Spring,480615,132212,17083,False
2017,03/19,Portland,1.11,149500,129099,19059,334445,1589,518,Spring,483945,130688,19577,False
2017,03/12,Portland,0.84,131660,200564,18137,536468,35442,667,Spring,668128,236006,18804,False
2017,03/05,Portland,0.89,142356,159767,17968,272980,177251,226,Spring,415336,337018,18194,False
2017,02/26,Portland,0.7,134185,153225,17614,352429,219524,653,Winter,486614,372749,18267,False
2017,02/19,Portland,0.76,151715,176142,16930,354510,169575,550,Winter,506225,345717,17480,False
2017,02/12,Portland,0.77,159697,113321,15145,397601,38270,479,Winter,557298,151591,15624,False
2017,02/05,Portland,0.68,173944,260237,17285,678871,57776,1035,Winter,852815,318013,18320,False
2017,01/29,Portland,0.76,153610,175048,17090,423872,138350,1489,Winter,577482,313398,18579,False
2017,01/22,Portland,0.87,107651,194199,16169,331105,62282,155,Winter,438756,256481,16324,False
2017,01/15,Portland,0.85,109638,187142,17794,415774,27321,454,Winter,525412,214463,18248,False
2017,01/08,Portland,0.85,137600,252977,16698,423677,46173,517,Winter,561277,299150,17215,False
2017,01/01,Portland,0.73,100273,269506,13235,468972,17284,561,Winter,569245,286790,13796,False
2017,12/31,RaleighGreensboro,0.92,90432,134861,5994,178330,9970,1,Winter,268762,144831,5995,False
2017,12/24,RaleighGreensboro,1.27,77545,71380,3882,92648,2858,0,Winter,170193,74238,3882,False
2017,12/17,RaleighGreensboro,1.24,79511,70218,3459,97660,2310,4,Winter,177171,72528,3463,False
2017,12/10,RaleighGreensboro,1.03,91718,76259,4128,180009,4863,0,Winter,271727,81122,4128,False
2017,12/03,RaleighGreensboro,1.18,91761,119171,3892,89249,3222,0,Winter,181010,122393,3892,False
2017,11/26,RaleighGreensboro,1.36,64578,73321,3144,82420,2032,0,Fall,146998,75353,3144,False
2017,11/19,RaleighGreensboro,1.36,72444,79451,3778,89013,2925,2,Fall,161457,82376,3780,False
2017,11/12,RaleighGreensboro,1.4,77868,80926,4326,88458,2553,0,Fall,166326,83479,4326,False
2017,11/05,RaleighGreensboro,1.39,87732,82461,4552,94086,2431,0,Fall,181818,84892,4552,False
2017,10/29,RaleighGreensboro,1.48,76356,82013,4266,85668,3216,1,Fall,162024,85229,4267,False
2017,10/22,RaleighGreensboro,1.63,62822,87018,5007,71573,2580,0,Fall,134395,89598,5007,False
2017,10/15,RaleighGreensboro,1.63,72524,89294,5003,71183,5987,0,Fall,143707,95281,5003,False
2017,10/08,RaleighGreensboro,1.7,70536,91083,4383,73770,3637,1,Fall,144306,94720,4384,False
2017,10/01,RaleighGreensboro,1.63,67533,96920,4787,76700,3978,0,Fall,144233,100898,4787,False
2017,09/24,RaleighGreensboro,1.54,70581,111227,4434,82873,3944,0,Fall,153454,115171,4434,False
2017,09/17,RaleighGreensboro,1.47,81352,94454,4978,91738,2026,10,Fall,173090,96480,4988,False
2017,09/10,RaleighGreensboro,1.57,58910,97907,5296,85481,1770,960,Fall,144391,99677,6256,False
2017,09/03,RaleighGreensboro,1.54,63349,96363,5765,91379,2160,4513,Fall,154728,98523,10278,False
2017,08/27,RaleighGreensboro,1.47,92921,90069,5520,100986,2240,1540,Summer,193907,92309,7060,False
2017,08/20,RaleighGreensboro,1.42,85619,98672,5226,100691,3695,3820,Summer,186310,102367,9046,False
2017,08/13,RaleighGreensboro,1.39,63759,102293,5709,95749,5384,2510,Summer,159508,107677,8219,False
2017,08/06,RaleighGreensboro,1.29,84938,97693,5724,95244,3590,1483,Summer,180182,101283,7207,False
2017,07/30,RaleighGreensboro,1.31,88828,96173,5723,93129,4554,643,Summer,181957,100727,6366,False
2017,07/23,RaleighGreensboro,1.31,72790,94919,6495,106561,3974,2020,Summer,179351,98893,8515,False
2017,07/16,RaleighGreensboro,1.3,54756,94289,6881,109084,3044,2533,Summer,163840,97333,9414,False
2017,07/09,RaleighGreensboro,1.25,92214,91091,5985,113413,1835,5001,Summer,205627,92926,10986,False
2017,07/02,RaleighGreensboro,1.22,95259,93112,6531,112838,2159,4635,Summer,208097,95271,11166,False
2017,06/25,RaleighGreensboro,1.24,92985,87499,6296,105884,1991,2770,Summer,198869,89490,9066,False
2017,06/18,RaleighGreensboro,1.34,63136,95583,6670,93661,1772,3035,Summer,156797,97355,9705,False
2017,06/11,RaleighGreensboro,1.3,77343,110902,7279,101531,1864,3675,Summer,178874,112766,10954,False
2017,06/04,RaleighGreensboro,1.43,85319,110335,7020,95259,2878,3100,Summer,180578,113213,10120,False
2017,05/28,RaleighGreensboro,1.41,85122,112526,7817,109210,3820,0,Spring,194332,116346,7817,False
2017,05/21,RaleighGreensboro,1.39,87350,110400,6949,104411,3162,0,Spring,191761,113562,6949,False
2017,05/14,RaleighGreensboro,1.33,83304,100720,6401,119259,1812,0,Spring,202563,102532,6401,False
2017,05/07,RaleighGreensboro,1.33,103481,124384,9620,134892,3117,0,Spring,238373,127501,9620,False
2017,04/30,RaleighGreensboro,1.44,87512,108724,6537,102811,3670,0,Spring,190323,112394,6537,False
2017,04/23,RaleighGreensboro,1.4,80081,100517,6401,116286,1590,137,Spring,196367,102107,6538,False
2017,04/16,RaleighGreensboro,1.44,78077,102376,6206,100591,866,0,Spring,178668,103242,6206,False
2017,04/09,RaleighGreensboro,1.45,75202,95458,6114,90352,1204,0,Spring,165554,96662,6114,False
2017,04/02,RaleighGreensboro,1.39,75587,115160,6188,111590,1399,0,Spring,187177,116559,6188,False
2017,03/26,RaleighGreensboro,1.41,68136,124783,7118,95202,1419,0,Spring,163338,126202,7118,False
2017,03/19,RaleighGreensboro,1.39,67152,117247,6082,89175,1290,0,Spring,156327,118537,6082,False
2017,03/12,RaleighGreensboro,1.42,78536,110931,7528,83251,1291,0,Spring,161787,112222,7528,False
2017,03/05,RaleighGreensboro,1.32,65892,114010,10062,90822,1311,0,Spring,156714,115321,10062,False
2017,02/26,RaleighGreensboro,1.21,75319,154834,11165,86960,1311,0,Winter,162279,156145,11165,False
2017,02/19,RaleighGreensboro,1.27,74958,112011,8812,90004,1060,0,Winter,164962,113071,8812,False
2017,02/12,RaleighGreensboro,1.18,93335,96469,8372,92787,1502,138,Winter,186122,97971,8510,False
2017,02/05,RaleighGreensboro,0.97,123228,230068,23080,76260,2607,554,Winter,199488,232675,23634,False
2017,01/29,RaleighGreensboro,1.26,89311,113615,9272,81864,2185,0,Winter,171175,115800,9272,False
2017,01/22,RaleighGreensboro,1.14,88147,135723,18581,80560,3984,0,Winter,168707,139707,18581,False
2017,01/15,RaleighGreensboro,1.27,73384,111891,8946,80590,2435,0,Winter,153974,114326,8946,False
2017,01/08,RaleighGreensboro,1.22,91874,105089,10444,95734,2051,0,Winter,187608,107140,10444,False
2017,01/01,RaleighGreensboro,1.18,74754,125855,13633,66525,2664,0,Winter,141279,128519,13633,False
2017,12/31,RichmondNorfolk,0.83,101602,102532,1995,97601,11720,10,Winter,199203,114252,2005,False
2017,12/24,RichmondNorfolk,1.19,49403,70977,1201,75698,8969,0,Winter,125101,79946,1201,False
2017,12/17,RichmondNorfolk,1.13,48414,67932,999,77442,4954,3,Winter,125856,72886,1002,False
2017,12/10,RichmondNorfolk,1.04,66481,75996,1058,103972,5623,34,Winter,170453,81619,1092,False
2017,12/03,RichmondNorfolk,1.02,78900,105291,1306,71392,4865,30,Winter,150292,110156,1336,False
2017,11/26,RichmondNorfolk,1.24,43700,63665,1021,51601,3363,0,Fall,95301,67028,1021,False
2017,11/19,RichmondNorfolk,1.23,48360,70014,1097,64562,3227,32,Fall,112922,73241,1129,False
2017,11/12,RichmondNorfolk,1.26,58938,69122,982,69009,2411,59,Fall,127947,71533,1041,False
2017,11/05,RichmondNorfolk,1.15,82955,75403,1474,87156,3547,61,Fall,170111,78950,1535,False
2017,10/29,RichmondNorfolk,1.33,53015,82269,1275,78089,3026,3,Fall,131104,85295,1278,False
2017,10/22,RichmondNorfolk,1.39,44086,86692,1441,70959,2854,10,Fall,115045,89546,1451,False
2017,10/15,RichmondNorfolk,1.46,43036,92849,1580,67819,6056,0,Fall,110855,98905,1580,False
2017,10/08,RichmondNorfolk,1.62,43388,49967,1517,60012,4231,0,Fall,103400,54198,1517,False
2017,10/01,RichmondNorfolk,1.54,39836,90617,1295,68462,5430,0,Fall,108298,96047,1295,False
2017,09/24,RichmondNorfolk,1.47,42524,84541,1112,75856,2562,122,Fall,118380,87103,1234,False
2017,09/17,RichmondNorfolk,1.44,44304,81995,1367,70410,2293,260,Fall,114714,84288,1627,False
2017,09/10,RichmondNorfolk,1.47,46253,64865,1324,74003,2082,3926,Fall,120256,66947,5250,False
2017,09/03,RichmondNorfolk,1.44,47932,81520,1786,73080,2370,1317,Fall,121012,83890,3103,False
2017,08/27,RichmondNorfolk,1.38,47758,75623,1559,86399,3209,844,Summer,134157,78832,2403,False
2017,08/20,RichmondNorfolk,1.33,51667,76235,1638,84245,5869,4445,Summer,135912,82104,6083,False
2017,08/13,RichmondNorfolk,1.35,55347,81849,1853,67332,4184,3580,Summer,122679,86033,5433,False
2017,08/06,RichmondNorfolk,1.26,60135,90862,1893,74984,2762,3463,Summer,135119,93624,5356,False
2017,07/30,RichmondNorfolk,1.26,61959,85046,1831,74994,4529,1550,Summer,136953,89575,3381,False
2017,07/23,RichmondNorfolk,1.13,96431,83045,2068,80562,1952,2759,Summer,176993,84997,4827,False
2017,07/16,RichmondNorfolk,1.17,89083,79805,1830,90560,2757,3769,Summer,179643,82562,5599,False
2017,07/09,RichmondNorfolk,1.19,71681,84932,2084,89396,2634,7050,Summer,161077,87566,9134,False
2017,07/02,RichmondNorfolk,1.21,71544,83589,2458,90410,2797,6361,Summer,161954,86386,8819,False
2017,06/25,RichmondNorfolk,1.21,70138,97759,1913,71831,4301,5885,Summer,141969,102060,7798,False
2017,06/18,RichmondNorfolk,1.28,63304,98223,1955,75119,1746,5214,Summer,138423,99969,7169,False
2017,06/11,RichmondNorfolk,1.31,63325,101559,2489,74457,57,6745,Summer,137782,101616,9234,False
2017,06/04,RichmondNorfolk,1.38,68705,108536,2472,77842,1729,1765,Summer,146547,110265,4237,False
2017,05/28,RichmondNorfolk,1.25,85850,104655,2662,88523,6414,5,Spring,174373,111069,2667,False
2017,05/21,RichmondNorfolk,1.17,85990,95579,2457,82632,4363,27,Spring,168622,99942,2484,False
2017,05/14,RichmondNorfolk,1.13,84866,60389,2298,105063,4141,250,Spring,189929,64530,2548,False
2017,05/07,RichmondNorfolk,1.12,119254,102627,3870,135956,2975,847,Spring,255210,105602,4717,False
2017,04/30,RichmondNorfolk,1.18,89984,87015,2182,102188,3730,27,Spring,192172,90745,2209,False
2017,04/23,RichmondNorfolk,1.25,64102,92451,2142,103485,577,12,Spring,167587,93028,2154,False
2017,04/16,RichmondNorfolk,1.28,68940,85592,2315,93488,787,0,Spring,162428,86379,2315,False
2017,04/09,RichmondNorfolk,1.22,81759,90074,2229,85939,508,0,Spring,167698,90582,2229,False
2017,04/02,RichmondNorfolk,1.19,67802,87489,2400,130221,98,2,Spring,198023,87587,2402,False
2017,03/26,RichmondNorfolk,1.26,79200,90219,2473,85387,695,350,Spring,164587,90914,2823,False
2017,03/19,RichmondNorfolk,1.29,66618,101944,2551,77669,1688,0,Spring,144287,103632,2551,False
2017,03/12,RichmondNorfolk,1.35,72440,98330,2941,78718,1946,0,Spring,151158,100276,2941,False
2017,03/05,RichmondNorfolk,1.31,60435,89549,4281,74615,1522,0,Spring,135050,91071,4281,False
2017,02/26,RichmondNorfolk,1.13,79067,131383,4209,65695,965,0,Winter,144762,132348,4209,False
2017,02/19,RichmondNorfolk,1.18,68120,90486,3142,78087,1175,0,Winter,146207,91661,3142,False
2017,02/12,RichmondNorfolk,1.13,89620,96337,2392,66109,1071,0,Winter,155729,97408,2392,False
2017,02/05,RichmondNorfolk,1.0,131147,162972,7578,76374,1531,0,Winter,207521,164503,7578,False
2017,01/29,RichmondNorfolk,1.18,87900,104490,3433,62577,929,340,Winter,150477,105419,3773,False
2017,01/22,RichmondNorfolk,1.13,94347,107935,6890,75851,1617,0,Winter,170198,109552,6890,False
2017,01/15,RichmondNorfolk,1.15,96322,89916,3884,69981,1164,43,Winter,166303,91080,3927,False
2017,01/08,RichmondNorfolk,1.18,91466,106264,3253,73168,975,0,Winter,164634,107239,3253,False
2017,01/01,RichmondNorfolk,1.11,82444,85577,5485,65961,1104,179,Winter,148405,86681,5664,False
2017,12/31,Roanoke,0.81,63533,44810,99,64304,21865,14,Winter,127837,66675,113,False
2017,12/24,Roanoke,1.09,32538,35304,79,58617,11139,0,Winter,91155,46443,79,False
2017,12/17,Roanoke,1.08,29951,31312,85,56079,6554,18,Winter,86030,37866,103,False
2017,12/10,Roanoke,1.05,38481,36370,73,57738,5284,12,Winter,96219,41654,85,False
2017,12/03,Roanoke,0.99,56316,47267,149,57210,5518,73,Winter,113526,52785,222,False
2017,11/26,Roanoke,1.16,25890,29449,133,32592,4082,0,Fall,58482,33531,133,False
2017,11/19,Roanoke,1.09,31004,31095,158,46213,4130,3,Fall,77217,35225,161,False
2017,11/12,Roanoke,1.19,43121,31995,173,46960,4235,12,Fall,90081,36230,185,False
2017,11/05,Roanoke,1.08,65571,34149,209,69792,6641,55,Fall,135363,40790,264,False
2017,10/29,Roanoke,1.3,36192,35007,265,69621,2255,0,Fall,105813,37262,265,False
2017,10/22,Roanoke,1.42,26729,35118,103,50154,3297,29,Fall,76883,38415,132,False
2017,10/15,Roanoke,1.49,27140,37806,114,44950,4815,0,Fall,72090,42621,114,False
2017,10/08,Roanoke,1.66,26135,16257,73,38450,6362,0,Fall,64585,22619,73,False
2017,10/01,Roanoke,1.59,25019,35234,85,45303,6874,0,Fall,70322,42108,85,False
2017,09/24,Roanoke,1.51,25124,39485,71,49231,4111,55,Fall,74355,43596,126,False
2017,09/17,Roanoke,1.5,26063,35969,45,47157,3583,412,Fall,73220,39552,457,False
2017,09/10,Roanoke,1.53,25756,28947,95,48825,4896,1561,Fall,74581,33843,1656,False
2017,09/03,Roanoke,1.45,27598,37446,91,43969,5061,1337,Fall,71567,42507,1428,False
2017,08/27,Roanoke,1.43,30304,35205,102,54510,5540,983,Summer,84814,40745,1085,False
2017,08/20,Roanoke,1.41,28139,35074,64,52792,5474,1721,Summer,80931,40548,1785,False
2017,08/13,Roanoke,1.38,26240,40274,137,36751,4721,1586,Summer,62991,44995,1723,False
2017,08/06,Roanoke,1.29,28072,42704,168,48158,3335,1680,Summer,76230,46039,1848,False
2017,07/30,Roanoke,1.29,25323,41333,182,49647,5730,1260,Summer,74970,47063,1442,False
2017,07/23,Roanoke,1.17,36513,40395,320,58375,3505,2038,Summer,94888,43900,2358,False
2017,07/16,Roanoke,1.16,42470,40719,222,67961,6304,2242,Summer,110431,47023,2464,False
2017,07/09,Roanoke,1.11,29283,43863,232,78578,2538,3300,Summer,107861,46401,3532,False
2017,07/02,Roanoke,1.13,29008,44059,88,75455,4063,3422,Summer,104463,48122,3510,False
2017,06/25,Roanoke,1.15,28194,47197,97,58834,9493,2315,Summer,87028,56690,2412,False
2017,06/18,Roanoke,1.16,30545,47417,97,69630,2860,2250,Summer,100175,50277,2347,False
2017,06/11,Roanoke,1.16,31085,50163,93,70183,610,2905,Summer,101268,50773,2998,False
2017,06/04,Roanoke,1.23,35865,51698,76,58885,4011,560,Summer,94750,55709,636,False
2017,05/28,Roanoke,1.15,42689,46416,107,62798,13638,60,Spring,105487,60054,167,False
2017,05/21,Roanoke,1.01,39721,44645,152,78050,9942,6,Spring,117771,54587,158,False
2017,05/14,Roanoke,0.99,49148,24238,98,83409,7994,39,Spring,132557,32232,137,False
2017,05/07,Roanoke,1.02,55938,55664,124,106593,2951,17,Spring,162531,58615,141,False
2017,04/30,Roanoke,1.22,30906,45408,58,80694,5352,0,Spring,111600,50760,58,False
2017,04/23,Roanoke,1.24,27263,41988,75,73624,3372,0,Spring,100887,45360,75,False
2017,04/16,Roanoke,1.2,30316,41034,73,85993,1105,0,Spring,116309,42139,73,False
2017,04/09,Roanoke,1.26,32290,47113,54,65146,1180,112,Spring,97436,48293,166,False
2017,04/02,Roanoke,1.15,32991,50584,94,84689,1015,0,Spring,117680,51599,94,False
2017,03/26,Roanoke,1.21,29493,47162,70,69195,895,0,Spring,98688,48057,70,False
2017,03/19,Roanoke,1.23,28859,52182,79,59561,935,0,Spring,88420,53117,79,False
2017,03/12,Roanoke,1.26,31344,50614,161,59939,1585,0,Spring,91283,52199,161,False
2017,03/05,Roanoke,1.15,31738,48916,159,67685,737,0,Spring,99423,49653,159,False
2017,02/26,Roanoke,1.13,33526,62461,176,56665,738,0,Winter,90191,63199,176,False
2017,02/19,Roanoke,1.12,32841,43497,69,64383,767,0,Winter,97224,44264,69,False
2017,02/12,Roanoke,1.03,49551,48583,189,59563,1245,0,Winter,109114,49828,189,False
2017,02/05,Roanoke,0.97,75074,76042,151,59129,1337,408,Winter,134203,77379,559,False
2017,01/29,Roanoke,1.13,37601,50930,146,53902,963,283,Winter,91503,51893,429,False
2017,01/22,Roanoke,1.04,48905,46802,142,66764,883,0,Winter,115669,47685,142,False
2017,01/15,Roanoke,1.06,50449,43695,94,63041,780,2,Winter,113490,44475,96,False
2017,01/08,Roanoke,1.13,44014,48526,92,52587,842,8,Winter,96601,49368,100,False
2017,01/01,Roanoke,0.97,43011,43260,125,55319,535,95,Winter,98330,43795,220,False
2017,12/31,Sacramento,1.03,130774,396250,922,46215,521,3689,Winter,176989,396771,4611,False
2017,12/24,Sacramento,1.14,128124,287781,989,46568,579,5489,Winter,174692,288360,6478,False
2017,12/17,Sacramento,1.2,122866,225425,795,49298,868,5292,Winter,172164,226293,6087,False
2017,12/10,Sacramento,1.07,157173,266189,910,45079,526,4659,Winter,202252,266715,5569,False
2017,12/03,Sacramento,1.17,132009,238373,779,52589,502,3539,Winter,184598,238875,4318,False
2017,11/26,Sacramento,1.45,98689,153842,1205,44903,467,5836,Fall,143592,154309,7041,False
2017,11/19,Sacramento,1.45,107079,174514,696,43875,822,4486,Fall,150954,175336,5182,False
2017,11/12,Sacramento,1.23,120349,268009,984,48720,546,3542,Fall,169069,268555,4526,False
2017,11/05,Sacramento,1.36,129130,234394,1020,38736,429,3910,Fall,167866,234823,4930,False
2017,10/29,Sacramento,1.45,120962,209801,798,42643,515,86,Fall,163605,210316,884,False
2017,10/22,Sacramento,1.58,93869,204224,851,37630,468,180,Fall,131499,204692,1031,False
2017,10/15,Sacramento,1.68,89884,208158,800,42344,833,196,Fall,132228,208991,996,False
2017,10/08,Sacramento,1.66,94059,214294,934,37953,1407,257,Fall,132012,215701,1191,False
2017,10/01,Sacramento,1.74,81753,191731,927,41898,1572,188,Fall,123651,193303,1115,False
2017,09/24,Sacramento,1.7,89050,187831,962,34708,2069,196,Fall,123758,189900,1158,False
2017,09/17,Sacramento,1.61,124583,189307,912,39044,587,153,Fall,163627,189894,1065,False
2017,09/10,Sacramento,1.63,121828,195817,1392,41469,98,473,Fall,163297,195915,1865,False
2017,09/03,Sacramento,1.79,122718,194468,1544,39031,91,314,Fall,161749,194559,1858,False
2017,08/27,Sacramento,1.87,120934,178392,1937,39281,109,1186,Summer,160215,178501,3123,False
2017,08/20,Sacramento,1.82,117500,164389,4321,41838,1275,2045,Summer,159338,165664,6366,False
2017,08/13,Sacramento,1.44,142234,263667,3221,43675,1227,1860,Summer,185909,264894,5081,False
2017,08/06,Sacramento,1.46,150669,267998,1923,47817,1200,1406,Summer,198486,269198,3329,False
2017,07/30,Sacramento,1.41,149729,306327,2243,42049,1129,1933,Summer,191778,307456,4176,False
2017,07/23,Sacramento,1.46,148014,247469,2242,43739,1268,1496,Summer,191753,248737,3738,False
2017,07/16,Sacramento,1.58,159107,257399,4592,37654,1102,1253,Summer,196761,258501,5845,False
2017,07/09,Sacramento,1.44,174813,267561,13473,46835,669,2070,Summer,221648,268230,15543,False
2017,07/02,Sacramento,1.55,157249,285875,12975,50509,676,1970,Summer,207758,286551,14945,False
2017,06/25,Sacramento,1.5,166509,261622,9937,52113,561,1505,Summer,218622,262183,11442,False
2017,06/18,Sacramento,1.59,164647,215644,10699,53795,757,3385,Summer,218442,216401,14084,False
2017,06/11,Sacramento,1.55,164987,210729,9745,50595,601,3913,Summer,215582,211330,13658,False
2017,06/04,Sacramento,1.61,160860,210208,2618,51366,316,3183,Summer,212226,210524,5801,False
2017,05/28,Sacramento,1.55,161377,265045,1129,51629,373,2080,Spring,213006,265418,3209,False
2017,05/21,Sacramento,1.64,140005,211234,1385,49064,475,1794,Spring,189069,211709,3179,False
2017,05/14,Sacramento,1.56,152535,199991,1396,54722,509,1295,Spring,207257,200500,2691,False
2017,05/07,Sacramento,1.4,157076,348134,1707,49645,567,3315,Spring,206721,348701,5022,False
2017,04/30,Sacramento,1.62,143615,197927,874,46808,210,2278,Spring,190423,198137,3152,False
2017,04/23,Sacramento,1.6,140311,183045,1050,44010,117,1965,Spring,184321,183162,3015,False
2017,04/16,Sacramento,1.58,137216,183753,1072,47374,158,1240,Spring,184590,183911,2312,False
2017,04/09,Sacramento,1.36,131487,248393,1003,46825,5,3878,Spring,178312,248398,4881,False
2017,04/02,Sacramento,1.58,141455,192900,1102,48822,47,1405,Spring,190277,192947,2507,False
2017,03/26,Sacramento,1.57,136446,190537,1187,44746,95,2212,Spring,181192,190632,3399,False
2017,03/19,Sacramento,1.59,126853,190505,1309,51316,38,2191,Spring,178169,190543,3500,False
2017,03/12,Sacramento,1.61,113887,189365,1980,47380,80,2087,Spring,161267,189445,4067,False
2017,03/05,Sacramento,1.32,162323,212458,5241,50741,393,189,Spring,213064,212851,5430,False
2017,02/26,Sacramento,1.08,163501,282428,6156,45582,242,1349,Winter,209083,282670,7505,False
2017,02/19,Sacramento,1.2,126780,247569,8981,45747,8,2743,Winter,172527,247577,11724,False
2017,02/12,Sacramento,1.08,173371,188127,9247,51822,186,840,Winter,225193,188313,10087,False
2017,02/05,Sacramento,0.98,321474,418158,11962,56599,43,570,Winter,378073,418201,12532,False
2017,01/29,Sacramento,1.08,203929,247415,7505,52021,35,2386,Winter,255950,247450,9891,False
2017,01/22,Sacramento,0.98,166864,321763,2248,41368,487,0,Winter,208232,322250,2248,False
2017,01/15,Sacramento,1.2,147645,275717,670,42762,2404,230,Winter,190407,278121,900,False
2017,01/08,Sacramento,1.15,156654,276138,642,66987,4336,2045,Winter,223641,280474,2687,False
2017,01/01,Sacramento,0.98,144876,339664,660,37920,2018,1625,Winter,182796,341682,2285,False
2017,12/31,SanDiego,0.98,199514,268431,15509,129566,4704,1973,Winter,329080,273135,17482,False
2017,12/24,SanDiego,1.17,147688,120566,15186,106944,4227,2718,Winter,254632,124793,17904,False
2017,12/17,SanDiego,0.73,147099,439224,17641,108179,4196,2748,Winter,255278,443420,20389,False
2017,12/10,SanDiego,1.13,156011,148747,11293,114750,8734,2611,Winter,270761,157481,13904,False
2017,12/03,SanDiego,1.08,186079,147995,13899,124045,4828,2719,Winter,310124,152823,16618,False
2017,11/26,SanDiego,1.24,146577,114715,17443,93366,9153,3211,Fall,239943,123868,20654,False
2017,11/19,SanDiego,1.25,146119,102909,14767,133210,9919,2552,Fall,279329,112828,17319,False
2017,11/12,SanDiego,1.16,168076,140122,16004,100528,5510,3351,Fall,268604,145632,19355,False
2017,11/05,SanDiego,1.04,162044,219943,17093,88039,3916,2386,Fall,250083,223859,19479,False
2017,10/29,SanDiego,1.0,169061,309160,19020,91706,4481,504,Fall,260767,313641,19524,False
2017,10/22,SanDiego,1.57,130818,123575,17091,68339,4057,0,Fall,199157,127632,17091,False
2017,10/15,SanDiego,1.67,101926,136483,20792,59356,4357,0,Fall,161282,140840,20792,False
2017,10/08,SanDiego,1.83,114286,122377,21165,52846,4152,0,Fall,167132,126529,21165,False
2017,10/01,SanDiego,1.78,118114,122964,17450,59173,4038,0,Fall,177287,127002,17450,False
2017,09/24,SanDiego,1.74,123024,119911,17120,67782,3117,3,Fall,190806,123028,17123,False
2017,09/17,SanDiego,1.71,132005,118470,18093,68684,3908,0,Fall,200689,122378,18093,False
2017,09/10,SanDiego,1.71,132530,124344,17826,71727,4603,190,Fall,204257,128947,18016,False
2017,09/03,SanDiego,1.52,146612,158752,22496,68847,5456,235,Fall,215459,164208,22731,False
2017,08/27,SanDiego,1.79,143124,120383,19739,67689,4535,975,Summer,210813,124918,20714,False
2017,08/20,SanDiego,1.65,150962,110759,20546,88428,6993,1346,Summer,239390,117752,21892,False
2017,08/13,SanDiego,1.24,188851,165179,23999,113037,7028,1014,Summer,301888,172207,25013,False
2017,08/06,SanDiego,1.34,191792,140575,21769,113356,6642,2399,Summer,305148,147217,24168,False
2017,07/30,SanDiego,1.48,174486,137655,21223,101946,6750,1951,Summer,276432,144405,23174,False
2017,07/23,SanDiego,1.46,190512,135877,19475,101991,4401,3112,Summer,292503,140278,22587,False
2017,07/16,SanDiego,1.48,181912,134913,22438,102399,4884,2994,Summer,284311,139797,25432,False
2017,07/09,SanDiego,1.21,216297,151179,16976,187255,150,3553,Summer,403552,151329,20529,False
2017,07/02,SanDiego,1.23,200562,165727,23222,191413,47,3507,Summer,391975,165774,26729,False
2017,06/25,SanDiego,1.05,212203,131972,19457,220632,197,1778,Summer,432835,132169,21235,False
2017,06/18,SanDiego,1.1,214632,163049,19625,189387,386,4650,Summer,404019,163435,24275,False
2017,06/11,SanDiego,1.17,177782,134393,19857,187655,160,2963,Summer,365437,134553,22820,False
2017,06/04,SanDiego,1.13,184953,132976,20220,219392,163,2278,Summer,404345,133139,22498,False
2017,05/28,SanDiego,1.27,183306,147790,22850,172875,21,5649,Spring,356181,147811,28499,False
2017,05/21,SanDiego,1.27,164861,134099,20302,158571,65,3622,Spring,323432,134164,23924,False
2017,05/14,SanDiego,1.08,196722,132664,18988,206313,90,2167,Spring,403035,132754,21155,False
2017,05/07,SanDiego,1.05,221144,148033,20790,221019,202,1855,Spring,442163,148235,22645,False
2017,04/30,SanDiego,1.18,166863,136882,26022,166655,128,1828,Spring,333518,137010,27850,False
2017,04/23,SanDiego,1.18,156330,132449,25784,184124,1068,610,Spring,340454,133517,26394,False
2017,04/16,SanDiego,1.29,148202,137653,22572,156168,122,905,Spring,304370,137775,23477,False
2017,04/09,SanDiego,1.22,145442,128010,23321,160950,2652,685,Spring,306392,130662,24006,False
2017,04/02,SanDiego,1.22,144114,131344,20997,154152,4013,706,Spring,298266,135357,21703,False
2017,03/26,SanDiego,1.28,133247,128683,20148,147197,285,905,Spring,280444,128968,21053,False
2017,03/19,SanDiego,1.25,150847,132525,19948,154726,1291,1016,Spring,305573,133816,20964,False
2017,03/12,SanDiego,1.24,157513,139859,22386,122585,1039,1927,Spring,280098,140898,24313,False
2017,03/05,SanDiego,1.04,163424,176304,19186,157805,549,430,Spring,321229,176853,19616,False
2017,02/26,SanDiego,0.88,203828,150939,16296,196998,3449,563,Winter,400826,154388,16859,False
2017,02/19,SanDiego,0.97,164517,156159,17240,154010,5009,395,Winter,318527,161168,17635,False
2017,02/12,SanDiego,0.7,203848,199351,13290,220708,7652,280,Winter,424556,207003,13570,False
2017,02/05,SanDiego,0.63,260418,290223,20313,318872,2886,25,Winter,579290,293109,20338,False
2017,01/29,SanDiego,0.65,282233,253233,14380,209999,13407,3055,Winter,492232,266640,17435,False
2017,01/22,SanDiego,0.74,313593,174728,15139,179361,13050,0,Winter,492954,187778,15139,False
2017,01/15,SanDiego,0.87,156924,216675,14469,168153,23244,722,Winter,325077,239919,15191,False
2017,01/08,SanDiego,0.96,146165,222743,15301,161975,36309,340,Winter,308140,259052,15641,False
2017,01/01,SanDiego,0.93,149666,206181,15014,150517,37802,1128,Winter,300183,243983,16142,False
2017,12/31,SanFrancisco,0.92,174144,860294,1733,136909,32,1703,Winter,311053,860326,3436,False
2017,12/24,SanFrancisco,1.15,178487,560097,2244,117345,31,2716,Winter,295832,560128,4960,False
2017,12/17,SanFrancisco,1.4,189827,374644,2099,105441,50,2562,Winter,295268,374694,4661,False
2017,12/10,SanFrancisco,1.05,302200,593521,2372,91822,55,2898,Winter,394022,593576,5270,False
2017,12/03,SanFrancisco,1.28,310481,387168,1966,97333,108,1797,Winter,407814,387276,3763,False
2017,11/26,SanFrancisco,1.52,166448,359471,2154,100099,60,2706,Fall,266547,359531,4860,False
2017,11/19,SanFrancisco,1.48,195380,366968,1909,91293,128,2015,Fall,286673,367096,3924,False
2017,11/12,SanFrancisco,1.27,289970,496390,2439,84463,73,1770,Fall,374433,496463,4209,False
2017,11/05,SanFrancisco,1.41,261561,435912,3140,84961,94,1956,Fall,346522,436006,5096,False
2017,10/29,SanFrancisco,1.56,197107,428002,4543,85850,44,1018,Fall,282957,428046,5561,False
2017,10/22,SanFrancisco,1.57,138067,551292,2933,75647,103,329,Fall,213714,551395,3262,False
2017,10/15,SanFrancisco,1.76,120680,461963,3144,84850,231,369,Fall,205530,462194,3513,False
2017,10/08,SanFrancisco,1.65,118596,587792,2921,70491,419,488,Fall,189087,588211,3409,False
2017,10/01,SanFrancisco,1.79,106075,477519,3125,72812,451,468,Fall,178887,477970,3593,False
2017,09/24,SanFrancisco,1.76,118405,461050,2948,70570,463,313,Fall,188975,461513,3261,False
2017,09/17,SanFrancisco,1.81,129172,428254,3490,86891,163,346,Fall,216063,428417,3836,False
2017,09/10,SanFrancisco,1.71,157322,434164,4117,92218,190,621,Fall,249540,434354,4738,False
2017,09/03,SanFrancisco,1.78,151679,421880,4061,88850,76,1311,Fall,240529,421956,5372,False
2017,08/27,SanFrancisco,2.09,151421,360906,5531,80015,147,2131,Summer,231436,361053,7662,False
2017,08/20,SanFrancisco,2.07,147449,304989,10147,94445,932,3577,Summer,241894,305921,13724,False
2017,08/13,SanFrancisco,1.29,164086,569847,9914,72666,1062,3817,Summer,236752,570909,13731,False
2017,08/06,SanFrancisco,1.62,156780,472631,4524,85993,753,2873,Summer,242773,473384,7397,False
2017,07/30,SanFrancisco,1.3,162330,657673,5039,67138,930,4330,Summer,229468,658603,9369,False
2017,07/23,SanFrancisco,1.66,166906,421727,5650,78075,1063,1760,Summer,244981,422790,7410,False
2017,07/16,SanFrancisco,1.74,182480,472009,8044,67144,896,1753,Summer,249624,472905,9797,False
2017,07/09,SanFrancisco,1.69,194695,421757,25793,68952,1248,2630,Summer,263647,423005,28423,False
2017,07/02,SanFrancisco,1.7,172013,420653,19625,82113,1385,5017,Summer,254126,422038,24642,False
2017,06/25,SanFrancisco,1.53,196221,568576,18879,86302,1532,3424,Summer,282523,570108,22303,False
2017,06/18,SanFrancisco,1.77,202024,336284,16709,100785,1133,3450,Summer,302809,337417,20159,False
2017,06/11,SanFrancisco,1.8,181965,318250,14342,91219,1136,1691,Summer,273184,319386,16033,False
2017,06/04,SanFrancisco,1.83,200052,350369,6248,89727,1108,2920,Summer,289779,351477,9168,False
2017,05/28,SanFrancisco,1.78,183361,386005,4497,85402,805,4003,Spring,268763,386810,8500,False
2017,05/21,SanFrancisco,1.86,167436,380367,4360,97322,1157,1658,Spring,264758,381524,6018,False
2017,05/14,SanFrancisco,1.77,182705,349569,5175,110145,1127,3653,Spring,292850,350696,8828,False
2017,05/07,SanFrancisco,1.42,212488,646869,6803,86569,619,3478,Spring,299057,647488,10281,False
2017,04/30,SanFrancisco,1.93,151929,369058,4331,84446,671,1667,Spring,236375,369729,5998,False
2017,04/23,SanFrancisco,1.83,178827,347730,4219,79196,550,3040,Spring,258023,348280,7259,False
2017,04/16,SanFrancisco,1.69,229167,349889,4769,84582,250,1621,Spring,313749,350139,6390,False
2017,04/09,SanFrancisco,1.22,216253,667301,4849,72736,125,688,Spring,288989,667426,5537,False
2017,04/02,SanFrancisco,1.79,180896,358599,5732,85552,67,1689,Spring,266448,358666,7421,False
2017,03/26,SanFrancisco,1.79,173628,349036,7123,81760,213,6219,Spring,255388,349249,13342,False
2017,03/19,SanFrancisco,1.79,185340,358216,6446,87289,342,1416,Spring,272629,358558,7862,False
2017,03/12,SanFrancisco,1.8,173434,354307,7050,82363,407,3345,Spring,255797,354714,10395,False
2017,03/05,SanFrancisco,1.59,234739,334851,12269,86669,1172,2539,Spring,321408,336023,14808,False
2017,02/26,SanFrancisco,1.18,286807,509449,14078,76653,988,3709,Winter,363460,510437,17787,False
2017,02/19,SanFrancisco,1.17,191375,578275,25011,66457,962,1604,Winter,257832,579237,26615,False
2017,02/12,SanFrancisco,1.14,265975,394642,22683,76702,1053,4925,Winter,342677,395695,27608,False
2017,02/05,SanFrancisco,0.84,560686,900172,21331,71464,976,3344,Winter,632150,901148,24675,False
2017,01/29,SanFrancisco,1.13,371071,438456,15021,73349,844,10906,Winter,444420,439300,25927,False
2017,01/22,SanFrancisco,0.94,297208,722757,5364,59393,3290,1498,Winter,356601,726047,6862,False
2017,01/15,SanFrancisco,1.23,211588,566260,2752,60288,5710,1667,Winter,271876,571970,4419,False
2017,01/08,SanFrancisco,1.22,196279,665608,2547,80425,6315,2594,Winter,276704,671923,5141,False
2017,01/01,SanFrancisco,0.95,260100,717625,2490,60397,5515,1045,Winter,320497,723140,3535,False
2017,12/31,Seattle,1.1,167408,182686,699,161594,46404,355,Winter,329002,229090,1054,False
2017,12/24,Seattle,1.46,95687,123764,653,120140,54232,365,Winter,215827,177996,1018,False
2017,12/17,Seattle,1.49,80005,107435,465,125095,48311,513,Winter,205100,155746,978,False
2017,12/10,Seattle,1.39,85240,116349,706,134944,51994,677,Winter,220184,168343,1383,False
2017,12/03,Seattle,1.26,113961,107904,680,231869,45507,260,Winter,345830,153411,940,False
2017,11/26,Seattle,1.61,73725,102163,700,94616,50872,345,Fall,168341,153035,1045,False
2017,11/19,Seattle,1.62,80544,109554,1324,91853,63374,814,Fall,172397,172928,2138,False
2017,11/12,Seattle,1.34,121406,117475,3994,203897,51294,554,Fall,325303,168769,4548,False
2017,11/05,Seattle,1.37,119514,114867,6037,222651,40236,237,Fall,342165,155103,6274,False
2017,10/29,Seattle,1.53,109352,121941,14722,169263,36815,261,Fall,278615,158756,14983,False
2017,10/22,Seattle,1.48,115638,168488,10445,134104,39747,279,Fall,249742,208235,10724,False
2017,10/15,Seattle,1.74,85159,168426,10887,98698,47512,658,Fall,183857,215938,11545,False
2017,10/08,Seattle,2.02,66345,129937,813,102890,56577,1881,Fall,169235,186514,2694,False
2017,10/01,Seattle,2.01,72930,126903,659,107521,54904,1021,Fall,180451,181807,1680,False
2017,09/24,Seattle,1.99,78736,129549,781,104351,53318,731,Fall,183087,182867,1512,False
2017,09/17,Seattle,1.88,101821,168223,648,96743,62936,904,Fall,198564,231159,1552,False
2017,09/10,Seattle,2.07,83635,140863,713,93344,68261,1281,Fall,176979,209124,1994,False
2017,09/03,Seattle,1.94,83934,146966,604,113635,62704,1230,Fall,197569,209670,1834,False
2017,08/27,Seattle,1.54,148933,138239,435,225974,48406,343,Summer,374907,186645,778,False
2017,08/20,Seattle,1.67,126277,145202,447,168561,56032,376,Summer,294838,201234,823,False
2017,08/13,Seattle,1.81,108558,159897,558,104087,64712,422,Summer,212645,224609,980,False
2017,08/06,Seattle,1.73,124307,178899,965,115658,73095,776,Summer,239965,251994,1741,False
2017,07/30,Seattle,1.72,115910,169760,2027,112306,69630,1176,Summer,228216,239390,3203,False
2017,07/23,Seattle,1.54,110161,215252,5868,105736,72025,115,Summer,215897,287277,5983,False
2017,07/16,Seattle,1.68,122341,165493,762,107734,76671,357,Summer,230075,242164,1119,False
2017,07/09,Seattle,1.0,186651,182881,1023,534148,34,325,Summer,720799,182915,1348,False
2017,07/02,Seattle,1.21,125597,179521,840,376182,56,723,Summer,501779,179577,1563,False
2017,06/25,Seattle,1.17,129823,162186,1038,386543,73,394,Summer,516366,162259,1432,False
2017,06/18,Seattle,1.16,128838,170657,521,395578,92,412,Summer,524416,170749,933,False
2017,06/11,Seattle,1.21,105557,169870,835,387996,91,209,Summer,493553,169961,1044,False
2017,06/04,Seattle,1.21,110722,172954,454,396509,168,299,Summer,507231,173122,753,False
2017,05/28,Seattle,1.19,128463,191777,763,407840,57,99,Spring,536303,191834,862,False
2017,05/21,Seattle,1.25,126440,172836,745,327052,154,846,Spring,453492,172990,1591,False
2017,05/14,Seattle,1.09,161654,182174,646,411542,4195,89,Spring,573196,186369,735,False
2017,05/07,Seattle,1.0,251868,251822,499,435657,22522,106,Spring,687525,274344,605,False
2017,04/30,Seattle,0.92,194789,170398,470,538920,1467,366,Spring,733709,171865,836,False
2017,04/23,Seattle,1.11,135560,203465,670,313046,250,108,Spring,448606,203715,778,False
2017,04/16,Seattle,1.09,131986,151806,404,397484,217,487,Spring,529470,152023,891,False
2017,04/09,Seattle,0.96,196844,228960,209,411247,280,817,Spring,608091,229240,1026,False
2017,04/02,Seattle,1.18,103029,176357,319,338015,310,344,Spring,441044,176667,663,False
2017,03/26,Seattle,1.16,99301,166232,323,341802,213,299,Spring,441103,166445,622,False
2017,03/19,Seattle,1.14,109446,158477,329,330536,1660,248,Spring,439982,160137,577,False
2017,03/12,Seattle,0.91,106731,212055,584,507284,19483,724,Spring,614015,231538,1308,False
2017,03/05,Seattle,0.94,125507,199518,773,295803,180388,1083,Spring,421310,379906,1856,False
2017,02/26,Seattle,0.8,115599,177935,3415,446738,79634,411,Winter,562337,257569,3826,False
2017,02/19,Seattle,0.87,95175,157514,512,423476,81596,611,Winter,518651,239110,1123,False
2017,02/12,Seattle,0.77,122056,182222,664,359133,85567,450,Winter,481189,267789,1114,False
2017,02/05,Seattle,0.76,160260,306958,957,471283,152490,1193,Winter,631543,459448,2150,False
2017,01/29,Seattle,0.86,114095,187068,478,496669,40312,306,Winter,610764,227380,784,False
2017,01/22,Seattle,0.85,102662,256663,556,393137,112547,326,Winter,495799,369210,882,False
2017,01/15,Seattle,0.93,88731,212640,894,442607,10132,532,Winter,531338,222772,1426,False
2017,01/08,Seattle,0.8,106390,348112,274,456141,26533,609,Winter,562531,374645,883,False
2017,01/01,Seattle,0.84,79598,267691,705,469004,4461,538,Winter,548602,272152,1243,False
2017,12/31,SouthCarolina,0.99,210307,80809,3034,124648,41191,725,Winter,334955,122000,3759,False
2017,12/24,SouthCarolina,1.22,133334,48531,2380,84037,23046,2872,Winter,217371,71577,5252,False
2017,12/17,SouthCarolina,1.04,174025,54684,2567,84686,30354,2049,Winter,258711,85038,4616,False
2017,12/10,SouthCarolina,1.02,169611,55404,2823,119935,32440,2349,Winter,289546,87844,5172,False
2017,12/03,SouthCarolina,1.12,166920,72687,2909,81124,24366,1895,Winter,248044,97053,4804,False
2017,11/26,SouthCarolina,1.25,125872,47631,2004,72283,19651,1882,Fall,198155,67282,3886,False
2017,11/19,SouthCarolina,1.23,136349,49469,2736,81408,23870,1933,Fall,217757,73339,4669,False
2017,11/12,SouthCarolina,1.23,165782,55018,2954,90110,24929,1552,Fall,255892,79947,4506,False
2017,11/05,SouthCarolina,1.28,134738,56451,2686,89967,23352,1084,Fall,224705,79803,3770,False
2017,10/29,SouthCarolina,1.32,139889,57049,2572,74082,35393,1355,Fall,213971,92442,3927,False
2017,10/22,SouthCarolina,1.57,130878,56508,2299,63298,22359,5,Fall,194176,78867,2304,False
2017,10/15,SouthCarolina,1.69,125345,60281,1836,62685,25649,9,Fall,188030,85930,1845,False
2017,10/08,SouthCarolina,1.56,161942,57386,1635,61514,33613,20,Fall,223456,90999,1655,False
2017,10/01,SouthCarolina,1.64,135045,74889,1574,61373,23291,8,Fall,196418,98180,1582,False
2017,09/24,SouthCarolina,1.57,147297,66856,1530,61065,23511,23,Fall,208362,90367,1553,False
2017,09/17,SouthCarolina,1.46,145609,70155,1756,65724,27476,555,Fall,211333,97631,2311,False
2017,09/10,SouthCarolina,1.42,127817,60589,1332,73147,19863,3397,Fall,200964,80452,4729,False
2017,09/03,SouthCarolina,1.44,150242,66384,1908,79464,25545,4970,Fall,229706,91929,6878,False
2017,08/27,SouthCarolina,1.41,155801,65899,1788,78518,24604,7077,Summer,234319,90503,8865,False
2017,08/20,SouthCarolina,1.4,158452,70864,2138,84288,28388,4711,Summer,242740,99252,6849,False
2017,08/13,SouthCarolina,1.36,154159,86025,2120,93633,28100,6940,Summer,247792,114125,9060,False
2017,08/06,SouthCarolina,1.37,128394,85339,1997,89592,25937,4976,Summer,217986,111276,6973,False
2017,07/30,SouthCarolina,1.3,168379,84509,1851,75567,26297,2937,Summer,243946,110806,4788,False
2017,07/23,SouthCarolina,1.3,183065,83184,1969,86140,22272,6080,Summer,269205,105456,8049,False
2017,07/16,SouthCarolina,1.28,176984,84547,2236,91437,25312,5125,Summer,268421,109859,7361,False
2017,07/09,SouthCarolina,1.24,171133,76166,2472,94038,26927,9780,Summer,265171,103093,12252,False
2017,07/02,SouthCarolina,1.28,179977,86915,2600,94511,38696,10561,Summer,274488,125611,13161,False
2017,06/25,SouthCarolina,1.17,190192,75673,2127,87432,43444,7650,Summer,277624,119117,9777,False
2017,06/18,SouthCarolina,1.3,159850,74051,2187,81818,23600,14585,Summer,241668,97651,16772,False
2017,06/11,SouthCarolina,1.3,189016,79763,2567,87105,34472,11710,Summer,276121,114235,14277,False
2017,06/04,SouthCarolina,1.33,213834,76898,2442,86890,38375,4745,Summer,300724,115273,7187,False
2017,05/28,SouthCarolina,1.41,181618,78082,2859,102225,23365,5150,Spring,283843,101447,8009,False
2017,05/21,SouthCarolina,1.38,163512,72321,2900,91713,27830,5055,Spring,255225,100151,7955,False
2017,05/14,SouthCarolina,1.34,163820,65765,2816,103782,27148,4560,Spring,267602,92913,7376,False
2017,05/07,SouthCarolina,1.19,256780,92639,3231,120193,54591,3975,Spring,376973,147230,7206,False
2017,04/30,SouthCarolina,1.34,208521,87676,2203,88444,38293,3949,Spring,296965,125969,6152,False
2017,04/23,SouthCarolina,1.36,161218,72371,2161,109288,27426,1586,Spring,270506,99797,3747,False
2017,04/16,SouthCarolina,1.37,161105,75615,2256,92236,34384,3245,Spring,253341,109999,5501,False
2017,04/09,SouthCarolina,1.38,153802,72253,2212,82167,31317,4116,Spring,235969,103570,6328,False
2017,04/02,SouthCarolina,1.38,141146,73888,2180,122294,24716,2285,Spring,263440,98604,4465,False
2017,03/26,SouthCarolina,1.41,146122,75527,2188,91327,26397,1905,Spring,237449,101924,4093,False
2017,03/19,SouthCarolina,1.37,128918,76830,2452,89623,33294,1685,Spring,218541,110124,4137,False
2017,03/12,SouthCarolina,1.4,135698,76260,2778,79135,31292,670,Spring,214833,107552,3448,False
2017,03/05,SouthCarolina,1.31,137486,76876,4078,78628,29047,25,Spring,216114,105923,4103,False
2017,02/26,SouthCarolina,1.06,189463,97078,4420,91626,20450,1170,Winter,281089,117528,5590,False
2017,02/19,SouthCarolina,1.14,150107,76620,2862,78346,22320,1190,Winter,228453,98940,4052,False
2017,02/12,SouthCarolina,0.99,190775,83866,2382,92656,25474,65,Winter,283431,109340,2447,False
2017,02/05,SouthCarolina,0.81,365828,182799,6024,92596,58746,102,Winter,458424,241545,6126,False
2017,01/29,SouthCarolina,1.11,174671,85091,3175,91776,40642,54,Winter,266447,125733,3229,False
2017,01/22,SouthCarolina,1.0,159931,121922,6643,98463,64777,0,Winter,258394,186699,6643,False
2017,01/15,SouthCarolina,1.14,167680,86901,2850,70024,42458,0,Winter,237704,129359,2850,False
2017,01/08,SouthCarolina,1.15,154597,75966,3127,83272,35695,0,Winter,237869,111661,3127,False
2017,01/01,SouthCarolina,1.0,166822,105262,5223,57344,67509,0,Winter,224166,172771,5223,False
2017,12/31,Spokane,0.94,30325,36245,501,24405,6544,63,Winter,54730,42789,564,False
2017,12/24,Spokane,1.32,17243,20939,534,20309,7796,71,Winter,37552,28735,605,False
2017,12/17,Spokane,1.34,16166,17749,328,20076,6919,36,Winter,36242,24668,364,False
2017,12/10,Spokane,1.2,20460,20182,397,26559,6994,32,Winter,47019,27176,429,False
2017,12/03,Spokane,1.16,23473,17884,378,33362,5310,57,Winter,56835,23194,435,False
2017,11/26,Spokane,1.49,12988,15594,252,14612,5404,0,Fall,27600,20998,252,False
2017,11/19,Spokane,1.3,17283,16712,410,17010,12808,7,Fall,34293,29520,417,False
2017,11/12,Spokane,1.17,23286,19991,458,37987,5076,130,Fall,61273,25067,588,False
2017,11/05,Spokane,1.32,22345,19106,286,31681,5078,32,Fall,54026,24184,318,False
2017,10/29,Spokane,1.41,20428,21686,276,23106,5310,60,Fall,43534,26996,336,False
2017,10/22,Spokane,1.31,21170,32061,223,17308,6657,30,Fall,38478,38718,253,False
2017,10/15,Spokane,1.6,15839,26443,98,13661,7156,84,Fall,29500,33599,182,False
2017,10/08,Spokane,1.82,13845,22168,38,13676,6543,44,Fall,27521,28711,82,False
2017,10/01,Spokane,1.83,13935,20908,26,13317,7186,45,Fall,27252,28094,71,False
2017,09/24,Spokane,1.84,13393,20303,124,13723,6762,41,Fall,27116,27065,165,False
2017,09/17,Spokane,1.66,16477,28242,34,12775,7598,90,Fall,29252,35840,124,False
2017,09/10,Spokane,1.89,15581,21528,94,11533,8688,67,Fall,27114,30216,161,False
2017,09/03,Spokane,1.58,20808,22824,102,24386,7714,4,Fall,45194,30538,106,False
2017,08/27,Spokane,1.42,24242,22050,71,34697,5902,4,Summer,58939,27952,75,False
2017,08/20,Spokane,1.65,19604,23704,189,19888,8696,0,Summer,39492,32400,189,False
2017,08/13,Spokane,1.67,16296,26112,100,16335,9284,11,Summer,32631,35396,111,False
2017,08/06,Spokane,1.55,20501,29823,121,17489,9861,34,Summer,37990,39684,155,False
2017,07/30,Spokane,1.56,18393,29605,88,16550,10298,130,Summer,34943,39903,218,False
2017,07/23,Spokane,1.44,17050,35913,88,13712,10899,2,Summer,30762,46812,90,False
2017,07/16,Spokane,1.35,26467,25825,241,23087,10239,250,Summer,49554,36064,491,False
2017,07/09,Spokane,0.97,26682,32986,119,68576,46,44,Summer,95258,33032,163,False
2017,07/02,Spokane,1.2,19186,34732,150,48093,35,109,Summer,67279,34767,259,False
2017,06/25,Spokane,1.12,22126,27886,69,53465,377,0,Summer,75591,28263,69,False
2017,06/18,Spokane,1.11,21695,28464,84,53053,8,7,Summer,74748,28472,91,False
2017,06/11,Spokane,1.16,16949,27300,62,50207,13,49,Summer,67156,27313,111,False
2017,06/04,Spokane,1.16,18046,29061,52,50585,0,10,Summer,68631,29061,62,False
2017,05/28,Spokane,1.15,20265,31394,156,50674,33,13,Spring,70939,31427,169,False
2017,05/21,Spokane,1.14,20886,26056,196,44915,143,75,Spring,65801,26199,271,False
2017,05/14,Spokane,1.08,23815,31405,68,53015,18,86,Spring,76830,31423,154,False
2017,05/07,Spokane,1.0,35074,44285,68,57195,4035,331,Spring,92269,48320,399,False
2017,04/30,Spokane,1.02,22231,28664,64,63101,688,2,Spring,85332,29352,66,False
2017,04/23,Spokane,1.02,21016,31935,63,47076,6,55,Spring,68092,31941,118,False
2017,04/16,Spokane,1.09,22310,24057,131,55362,6,8,Spring,77672,24063,139,False
2017,04/09,Spokane,0.93,31685,42399,28,51852,316,13,Spring,83537,42715,41,False
2017,04/02,Spokane,1.12,20769,26687,12,47511,43,32,Spring,68280,26730,44,False
2017,03/26,Spokane,1.09,20638,24121,21,48412,9,5,Spring,69050,24130,26,False
2017,03/19,Spokane,0.92,22275,24389,64,63117,1074,29,Spring,85392,25463,93,False
2017,03/12,Spokane,0.83,23152,30302,51,74945,4149,199,Spring,98097,34451,250,False
2017,03/05,Spokane,0.85,22154,31330,54,43180,32199,21,Spring,65334,63529,75,False
2017,02/26,Spokane,0.75,19681,26454,531,58196,17637,90,Winter,77877,44091,621,False
2017,02/19,Spokane,0.85,19026,19163,314,53957,8989,30,Winter,72983,28152,344,False
2017,02/12,Spokane,0.77,21706,27884,42,44301,16496,60,Winter,66007,44380,102,False
2017,02/05,Spokane,0.76,30442,47312,527,63590,23843,68,Winter,94032,71155,595,False
2017,01/29,Spokane,0.84,20867,25238,27,56084,9927,48,Winter,76951,35165,75,False
2017,01/22,Spokane,0.88,19006,38753,153,49749,5680,86,Winter,68755,44433,239,False
2017,01/15,Spokane,0.93,15011,31840,438,58001,2063,20,Winter,73012,33903,458,False
2017,01/08,Spokane,0.78,16655,59371,68,61628,7043,163,Winter,78283,66414,231,False
2017,01/01,Spokane,0.87,11707,43700,511,58631,415,76,Winter,70338,44115,587,False
2017,12/31,StLouis,1.14,96909,6606,263,67703,20686,0,Winter,164612,27292,263,False
2017,12/24,StLouis,1.38,71923,12725,321,52479,12490,0,Winter,124402,25215,321,False
2017,12/17,StLouis,1.17,70752,5892,273,59608,17799,0,Winter,130360,23691,273,False
2017,12/10,StLouis,1.18,59840,6577,153,61719,28120,0,Winter,121559,34697,153,False
2017,12/03,StLouis,1.37,61716,6514,320,41245,22371,0,Winter,102961,28885,320,False
2017,11/26,StLouis,1.31,59506,10345,547,37032,18813,0,Fall,96538,29158,547,False
2017,11/19,StLouis,1.23,70695,6761,374,58388,15987,0,Fall,129083,22748,374,False
2017,11/12,StLouis,1.3,89557,7643,136,51019,20896,0,Fall,140576,28539,136,False
2017,11/05,StLouis,1.55,58145,16129,588,44600,6221,0,Fall,102745,22350,588,False
2017,10/29,StLouis,1.34,83829,11655,117,34224,4562,0,Fall,118053,16217,117,False
2017,10/22,StLouis,1.61,72104,8866,81,34007,5199,5,Fall,106111,14065,86,False
2017,10/15,StLouis,1.75,56251,17904,50,41063,10136,27,Fall,97314,28040,77,False
2017,10/08,StLouis,1.83,50280,6489,77,51510,19224,9,Fall,101790,25713,86,False
2017,10/01,StLouis,1.83,53230,6365,139,48257,21570,13,Fall,101487,27935,152,False
2017,09/24,StLouis,1.83,55004,7796,126,58921,23031,9,Fall,113925,30827,135,False
2017,09/17,StLouis,1.72,52470,9190,74,46655,14303,39,Fall,99125,23493,113,False
2017,09/10,StLouis,1.47,109797,15410,55,61599,10532,150,Fall,171396,25942,205,False
2017,09/03,StLouis,1.69,71468,15124,147,53354,11043,4633,Fall,124822,26167,4780,False
2017,08/27,StLouis,1.71,68563,18506,214,53462,6959,5874,Summer,122025,25465,6088,False
2017,08/20,StLouis,1.6,77753,20659,233,60881,5823,2702,Summer,138634,26482,2935,False
2017,08/13,StLouis,1.49,81583,16239,251,60139,7179,4133,Summer,141722,23418,4384,False
2017,08/06,StLouis,1.49,73948,18312,174,57720,9088,4588,Summer,131668,27400,4762,False
2017,07/30,StLouis,1.52,66450,19148,157,62761,4260,2117,Summer,129211,23408,2274,False
2017,07/23,StLouis,1.33,99724,17159,192,66945,5322,4915,Summer,166669,22481,5107,False
2017,07/16,StLouis,1.45,77376,17792,217,66888,11069,3219,Summer,144264,28861,3436,False
2017,07/09,StLouis,1.26,107971,10695,123,94133,2005,35,Summer,202104,12700,158,False
2017,07/02,StLouis,1.14,102625,9979,461,78516,525,66,Summer,181141,10504,527,False
2017,06/25,StLouis,1.31,76172,13284,121,79384,15959,494,Summer,155556,29243,615,False
2017,06/18,StLouis,1.3,76343,14887,140,87817,20679,2124,Summer,164160,35566,2264,False
2017,06/11,StLouis,1.32,76191,15824,224,84981,16665,3556,Summer,161172,32489,3780,False
2017,06/04,StLouis,1.28,80655,13450,895,90030,21035,5471,Summer,170685,34485,6366,False
2017,05/28,StLouis,1.23,79848,14664,490,102547,17838,4924,Spring,182395,32502,5414,False
2017,05/21,StLouis,1.17,93195,13886,178,98532,20541,2859,Spring,191727,34427,3037,False
2017,05/14,StLouis,1.3,67091,10233,147,89952,29354,50,Spring,157043,39587,197,False
2017,05/07,StLouis,1.37,85199,18033,265,78386,32515,394,Spring,163585,50548,659,False
2017,04/30,StLouis,1.37,118005,22429,203,59450,191,462,Spring,177455,22620,665,False
2017,04/23,StLouis,1.51,82661,23248,252,67084,57,1308,Spring,149745,23305,1560,False
2017,04/16,StLouis,1.52,65731,20965,237,55907,77,1869,Spring,121638,21042,2106,False
2017,04/09,StLouis,1.27,77305,12263,83,55522,21,0,Spring,132827,12284,83,False
2017,04/02,StLouis,1.33,63506,8377,75,44610,26,0,Spring,108116,8403,75,False
2017,03/26,StLouis,1.33,46092,8922,72,55422,383,66,Spring,101514,9305,138,False
2017,03/19,StLouis,1.18,64278,9737,94,51285,10900,0,Spring,115563,20637,94,False
2017,03/12,StLouis,1.36,48343,10325,49,43898,321,0,Spring,92241,10646,49,False
2017,03/05,StLouis,1.38,48508,8252,60,48821,6872,0,Spring,97329,15124,60,False
2017,02/26,StLouis,1.29,53308,12854,123,61695,14271,0,Winter,115003,27125,123,False
2017,02/19,StLouis,1.09,76057,8727,161,52365,7213,0,Winter,128422,15940,161,False
2017,02/12,StLouis,0.99,60850,12420,163,79283,98,230,Winter,140133,12518,393,False
2017,02/05,StLouis,0.88,131630,15888,160,79805,9792,0,Winter,211435,25680,160,False
2017,01/29,StLouis,1.0,80253,15081,159,63464,33402,0,Winter,143717,48483,159,False
2017,01/22,StLouis,1.14,63018,8315,105,54350,29635,0,Winter,117368,37950,105,False
2017,01/15,StLouis,1.11,71169,10367,63,72670,28999,0,Winter,143839,39366,63,False
2017,01/08,StLouis,1.11,65552,10274,133,58010,18595,48,Winter,123562,28869,181,False
2017,01/01,StLouis,1.11,90181,10226,212,39615,4087,0,Winter,129796,14313,212,False
2017,12/31,Syracuse,1.39,2596,41694,23,11544,3218,0,Winter,14140,44912,23,False
2017,12/24,Syracuse,1.31,2688,34404,45,17602,3042,0,Winter,20290,37446,45,False
2017,12/17,Syracuse,1.3,2485,30082,44,13821,2784,0,Winter,16306,32866,44,False
2017,12/10,Syracuse,1.24,2531,34341,32,19843,3216,0,Winter,22374,37557,32,False
2017,12/03,Syracuse,1.25,2791,57129,47,19354,1517,0,Winter,22145,58646,47,False
2017,11/26,Syracuse,1.29,2027,25986,37,13893,2858,0,Fall,15920,28844,37,False
2017,11/19,Syracuse,1.43,3191,38882,55,15009,3989,0,Fall,18200,42871,55,False
2017,11/12,Syracuse,1.32,4073,37767,65,17129,3266,0,Fall,21202,41033,65,False
2017,11/05,Syracuse,1.44,3247,29429,67,7444,11838,0,Fall,10691,41267,67,False
2017,10/29,Syracuse,1.46,4026,30151,29,5103,14310,0,Fall,9129,44461,29,False
2017,10/22,Syracuse,1.51,9115,23293,47,9164,2384,0,Fall,18279,25677,47,False
2017,10/15,Syracuse,1.57,9713,25427,63,6112,2398,0,Fall,15825,27825,63,False
2017,10/08,Syracuse,1.57,8991,18883,12,10518,7046,0,Fall,19509,25929,12,False
2017,10/01,Syracuse,1.58,8960,26794,26,7107,4144,0,Fall,16067,30938,26,False
2017,09/24,Syracuse,1.47,4475,28923,29,17095,3341,3,Fall,21570,32264,32,False
2017,09/17,Syracuse,1.38,3606,36375,17,17869,4337,146,Fall,21475,40712,163,False
2017,09/10,Syracuse,1.59,2235,45425,26,21065,2169,1560,Fall,23300,47594,1586,False
2017,09/03,Syracuse,1.64,2114,36157,13,18165,2042,1090,Fall,20279,38199,1103,False
2017,08/27,Syracuse,1.41,1316,37148,13,23840,433,296,Summer,25156,37581,309,False
2017,08/20,Syracuse,1.42,796,36561,19,21641,392,1246,Summer,22437,36953,1265,False
2017,08/13,Syracuse,1.45,995,49060,95,26760,504,1073,Summer,27755,49564,1168,False
2017,08/06,Syracuse,1.4,1279,41361,55,24827,988,810,Summer,26106,42349,865,False
2017,07/30,Syracuse,1.43,1121,36769,36,25309,496,726,Summer,26430,37265,762,False
2017,07/23,Syracuse,1.38,1193,40041,249,24946,760,840,Summer,26139,40801,1089,False
2017,07/16,Syracuse,1.38,1077,42756,906,22863,766,1220,Summer,23940,43522,2126,False
2017,07/09,Syracuse,1.38,1001,45176,381,26802,1161,3005,Summer,27803,46337,3386,False
2017,07/02,Syracuse,1.42,1523,47455,253,19118,2184,1235,Summer,20641,49639,1488,False
2017,06/25,Syracuse,1.48,1578,44074,113,9107,2081,1220,Summer,10685,46155,1333,False
2017,06/18,Syracuse,1.54,1407,43878,350,13074,1366,1390,Summer,14481,45244,1740,False
2017,06/11,Syracuse,1.66,1072,42974,113,9561,2500,2320,Summer,10633,45474,2433,False
2017,06/04,Syracuse,1.65,976,42117,21,17366,2528,1245,Summer,18342,44645,1266,False
2017,05/28,Syracuse,1.71,912,54932,57,29067,1795,570,Spring,29979,56727,627,False
2017,05/21,Syracuse,1.6,954,39537,25,22216,2684,123,Spring,23170,42221,148,False
2017,05/14,Syracuse,1.66,1032,43170,42,28525,2180,0,Spring,29557,45350,42,False
2017,05/07,Syracuse,1.63,1032,52450,43,29203,6375,0,Spring,30235,58825,43,False
2017,04/30,Syracuse,1.36,1552,59920,20,30442,4552,0,Spring,31994,64472,20,False
2017,04/23,Syracuse,1.5,2063,36408,18,21108,3854,0,Spring,23171,40262,18,False
2017,04/16,Syracuse,1.6,2160,40347,18,29196,3434,0,Spring,31356,43781,18,False
2017,04/09,Syracuse,1.61,1222,46634,10,14344,17568,0,Spring,15566,64202,10,False
2017,04/02,Syracuse,1.6,2542,40061,8,22629,10011,0,Spring,25171,50072,8,False
2017,03/26,Syracuse,1.37,1578,56606,10,26771,3311,0,Spring,28349,59917,10,False
2017,03/19,Syracuse,1.59,1084,40909,6,22773,3673,0,Spring,23857,44582,6,False
2017,03/12,Syracuse,1.53,950,43531,9,16225,13121,0,Spring,17175,56652,9,False
2017,03/05,Syracuse,1.42,989,50667,9,20971,30,79,Spring,21960,50697,88,False
2017,02/26,Syracuse,1.57,1108,40969,4,18169,8,161,Winter,19277,40977,165,False
2017,02/19,Syracuse,1.71,831,44732,6,15679,358,0,Winter,16510,45090,6,False
2017,02/12,Syracuse,1.5,1335,45061,66,20869,567,0,Winter,22204,45628,66,False
2017,02/05,Syracuse,1.49,1216,78340,44,24392,34,0,Winter,25608,78374,44,False
2017,01/29,Syracuse,1.36,1270,44228,101,25395,813,0,Winter,26665,45041,101,False
2017,01/22,Syracuse,1.52,1341,52570,16,24856,1075,0,Winter,26197,53645,16,False
2017,01/15,Syracuse,1.4,1109,37401,21,29465,601,0,Winter,30574,38002,21,False
2017,01/08,Syracuse,1.43,1221,41382,11,24733,4,0,Winter,25954,41386,11,False
2017,01/01,Syracuse,1.55,853,47182,7,16175,65,0,Winter,17028,47247,7,False
2017,12/31,Tampa,1.16,364499,55831,610,59003,68988,0,Winter,423502,124819,610,False
2017,12/24,Tampa,1.4,210851,27970,717,62931,33312,0,Winter,273782,61282,717,False
2017,12/17,Tampa,1.0,288732,41565,706,65991,52052,0,Winter,354723,93617,706,False
2017,12/10,Tampa,1.02,293951,45874,840,66383,67840,0,Winter,360334,113714,840,False
2017,12/03,Tampa,1.27,249846,34029,805,67280,29645,0,Winter,317126,63674,805,False
2017,11/26,Tampa,1.4,188536,25479,476,57222,24228,0,Fall,245758,49707,476,False
2017,11/19,Tampa,1.21,251741,39402,740,65591,49323,0,Fall,317332,88725,740,False
2017,11/12,Tampa,1.35,240719,33019,830,73813,35609,0,Fall,314532,68628,830,False
2017,11/05,Tampa,1.48,204472,30501,696,54636,33327,0,Fall,259108,63828,696,False
2017,10/29,Tampa,1.19,310309,48829,661,69292,50787,0,Fall,379601,99616,661,False
2017,10/22,Tampa,1.54,235502,36022,487,53966,40475,0,Fall,289468,76497,487,False
2017,10/15,Tampa,1.71,201650,30918,66,57769,37636,0,Fall,259419,68554,66,False
2017,10/08,Tampa,1.76,232556,34336,51,60089,35488,0,Fall,292645,69824,51,False
2017,10/01,Tampa,1.96,184126,34452,47,52502,27533,0,Fall,236628,61985,47,False
2017,09/24,Tampa,1.86,196122,29716,28,32356,35372,20,Fall,228478,65088,48,False
2017,09/17,Tampa,1.76,207920,40380,42,8294,48037,6,Fall,216214,88417,48,False
2017,09/10,Tampa,1.76,171031,22401,701,27150,21804,3643,Fall,198181,44205,4344,False
2017,09/03,Tampa,1.89,203765,31318,89,41222,15912,2396,Fall,244987,47230,2485,False
2017,08/27,Tampa,1.63,198709,33927,98,24226,29160,5603,Summer,222935,63087,5701,False
2017,08/20,Tampa,1.64,199550,35017,84,12351,37069,5306,Summer,211901,72086,5390,False
2017,08/13,Tampa,1.49,241771,49334,107,14979,53594,7841,Summer,256750,102928,7948,False
2017,08/06,Tampa,1.46,207551,40584,88,26777,32206,5431,Summer,234328,72790,5519,False
2017,07/30,Tampa,1.44,212489,38534,93,27042,34834,4255,Summer,239531,73368,4348,False
2017,07/23,Tampa,1.42,238382,42528,135,18132,43928,6121,Summer,256514,86456,6256,False
2017,07/16,Tampa,1.5,209888,40717,137,16459,36103,6510,Summer,226347,76820,6647,False
2017,07/09,Tampa,1.45,211134,42947,137,21337,37338,10757,Summer,232471,80285,10894,False
2017,07/02,Tampa,1.45,258323,61821,235,23812,55106,8285,Summer,282135,116927,8520,False
2017,06/25,Tampa,1.39,236685,45798,58,31292,38658,5320,Summer,267977,84456,5378,False
2017,06/18,Tampa,1.43,225053,42017,62,24077,38791,6745,Summer,249130,80808,6807,False
2017,06/11,Tampa,1.42,258974,51596,84,44926,49924,5095,Summer,303900,101520,5179,False
2017,06/04,Tampa,1.43,262533,53444,15,49481,51963,1350,Summer,312014,105407,1365,False
2017,05/28,Tampa,1.41,261273,50673,70,64058,42796,0,Spring,325331,93469,70,False
2017,05/21,Tampa,1.44,224341,46054,33,64869,38515,6,Spring,289210,84569,39,False
2017,05/14,Tampa,1.43,215699,42141,60,59447,25620,16,Spring,275146,67761,76,False
2017,05/07,Tampa,1.15,366742,90035,80,71538,54009,0,Spring,438280,144044,80,False
2017,04/30,Tampa,1.25,339907,84557,49,54629,55030,0,Spring,394536,139587,49,False
2017,04/23,Tampa,1.46,224054,51111,15,56892,26297,15,Spring,280946,77408,30,False
2017,04/16,Tampa,1.48,199036,48021,28,51870,36538,0,Spring,250906,84559,28,False
2017,04/09,Tampa,1.5,197024,48831,64,47099,34786,3,Spring,244123,83617,67,False
2017,04/02,Tampa,1.63,191494,49716,58,42505,37917,0,Spring,233999,87633,58,False
2017,03/26,Tampa,1.67,175398,49480,45,44188,39025,58,Spring,219586,88505,103,False
2017,03/19,Tampa,1.58,174757,47825,67,56385,33211,22,Spring,231142,81036,89,False
2017,03/12,Tampa,1.57,170948,50945,60,52520,35677,0,Spring,223468,86622,60,False
2017,03/05,Tampa,1.59,166308,49556,33,42018,34621,6,Spring,208326,84177,39,False
2017,02/26,Tampa,1.23,209754,61504,54,60609,37414,0,Winter,270363,98918,54,False
2017,02/19,Tampa,1.29,160252,57390,44,45296,34541,0,Winter,205548,91931,44,False
2017,02/12,Tampa,0.95,244896,108692,143,64717,66097,109,Winter,309613,174789,252,False
2017,02/05,Tampa,0.79,432114,200199,273,150022,110241,291,Winter,582136,310440,564,False
2017,01/29,Tampa,1.21,183508,90757,207,93866,76118,793,Winter,277374,166875,1000,False
2017,01/22,Tampa,1.0,178179,151852,116,80110,137540,0,Winter,258289,289392,116,False
2017,01/15,Tampa,1.24,176596,89720,152,81860,77557,0,Winter,258456,167277,152,False
2017,01/08,Tampa,1.27,131948,75346,100,80554,63758,0,Winter,212502,139104,100,False
2017,01/01,Tampa,0.93,202816,150261,71,87852,137059,0,Winter,290668,287320,71,False
2017,12/31,WestTexNewMexico,0.89,347248,158559,5628,78402,137088,96,Winter,425650,295647,5724,False
2017,12/24,WestTexNewMexico,0.93,402476,150206,7966,96489,112764,66,Winter,498965,262970,8032,False
2017,12/17,WestTexNewMexico,0.85,390096,161122,6208,94766,101820,10,Winter,484862,262942,6218,False
2017,12/10,WestTexNewMexico,0.86,384349,133201,5774,104486,123222,103,Winter,488835,256423,5877,False
2017,12/03,WestTexNewMexico,0.85,359419,224516,6690,70520,138586,148,Winter,429939,363102,6838,False
2017,11/26,WestTexNewMexico,0.91,354268,104956,5465,74684,83606,114,Fall,428952,188562,5579,False
2017,11/19,WestTexNewMexico,0.95,333777,119338,6035,73894,118062,3889,Fall,407671,237400,9924,False
2017,11/12,WestTexNewMexico,0.93,375798,165578,9438,67655,140060,597,Fall,443453,305638,10035,False
2017,11/05,WestTexNewMexico,0.94,381629,199062,8891,62748,139154,30,Fall,444377,338216,8921,False
2017,10/29,WestTexNewMexico,1.02,340028,169026,4847,65993,80063,60,Fall,406021,249089,4907,False
2017,10/22,WestTexNewMexico,1.04,390067,159230,2000,63878,58487,0,Fall,453945,217717,2000,False
2017,10/15,WestTexNewMexico,1.15,378161,115974,360,55077,65984,0,Fall,433238,181958,360,False
2017,10/08,WestTexNewMexico,1.2,371142,99797,288,61163,58609,0,Fall,432305,158406,288,False
2017,10/01,WestTexNewMexico,1.22,357909,121221,517,62874,55932,0,Fall,420783,177153,517,False
2017,09/24,WestTexNewMexico,1.22,363596,99990,415,68799,51236,6,Fall,432395,151226,421,False
2017,09/17,WestTexNewMexico,1.2,348290,103677,1179,88720,44120,0,Fall,437010,147797,1179,False
2017,09/10,WestTexNewMexico,1.14,439332,67241,5766,103192,33659,0,Fall,542524,100900,5766,False
2017,09/03,WestTexNewMexico,1.14,448083,71179,6037,95618,45849,6,Fall,543701,117028,6043,False
2017,08/27,WestTexNewMexico,1.08,432526,65673,6963,100976,38460,480,Summer,533502,104133,7443,False
2017,08/20,WestTexNewMexico,1.01,462664,91342,7461,100740,108212,2460,Summer,563404,199554,9921,False
2017,08/13,WestTexNewMexico,0.95,479443,113710,12037,110195,151506,391,Summer,589638,265216,12428,False
2017,08/06,WestTexNewMexico,0.95,532554,121535,7915,124742,84285,196,Summer,657296,205820,8111,False
2017,07/30,WestTexNewMexico,1.01,496316,107799,8697,141547,82057,1254,Summer,637863,189856,9951,False
2017,07/23,WestTexNewMexico,1.03,488728,118607,9864,125662,100565,5516,Summer,614390,219172,15380,False
2017,07/16,WestTexNewMexico,0.95,473343,152255,24289,111162,126588,0,Summer,584505,278843,24289,False
2017,07/09,WestTexNewMexico,0.84,549857,109308,8436,192156,223256,0,Summer,742013,332564,8436,False
2017,07/02,WestTexNewMexico,0.86,541032,87497,10276,168553,216224,0,Summer,709585,303721,10276,False
2017,06/25,WestTexNewMexico,0.85,565529,82613,8881,150840,214264,0,Summer,716369,296877,8881,False
2017,06/18,WestTexNewMexico,0.87,578248,88224,10539,164735,205157,41,Summer,742983,293381,10580,False
2017,06/11,WestTexNewMexico,0.83,638208,88563,10519,165191,187785,0,Summer,803399,276348,10519,False
2017,06/04,WestTexNewMexico,0.83,660903,87083,10771,146358,199564,0,Summer,807261,286647,10771,False
2017,05/28,WestTexNewMexico,0.91,586236,88983,15734,139601,212182,0,Spring,725837,301165,15734,False
2017,05/21,WestTexNewMexico,0.89,545326,89271,12452,135057,217157,0,Spring,680383,306428,12452,False
2017,05/14,WestTexNewMexico,0.84,622089,105351,12177,143675,225078,0,Spring,765764,330429,12177,False
2017,05/07,WestTexNewMexico,0.82,643961,121509,12243,127690,254083,0,Spring,771651,375592,12243,False
2017,04/30,WestTexNewMexico,0.81,550326,85308,11068,125278,206309,0,Spring,675604,291617,11068,False
2017,04/23,WestTexNewMexico,0.75,583229,105373,13999,118216,287509,0,Spring,701445,392882,13999,False
2017,04/16,WestTexNewMexico,0.82,593840,87765,19105,149148,265581,0,Spring,742988,353346,19105,False
2017,04/09,WestTexNewMexico,0.9,463332,59419,17752,124912,152937,0,Spring,588244,212356,17752,False
2017,04/02,WestTexNewMexico,0.86,492263,60337,22050,141881,169923,0,Spring,634144,230260,22050,False
2017,03/26,WestTexNewMexico,0.84,533119,65918,17073,139768,155022,0,Spring,672887,220940,17073,False
2017,03/19,WestTexNewMexico,0.84,550156,60673,18046,122778,162525,0,Spring,672934,223198,18046,False
2017,03/12,WestTexNewMexico,0.86,425584,60264,19234,138151,170106,0,Spring,563735,230370,19234,False
2017,03/05,WestTexNewMexico,0.84,466853,55790,28477,128328,161570,0,Spring,595181,217360,28477,False
2017,02/26,WestTexNewMexico,0.79,471215,67019,15924,126854,183184,0,Winter,598069,250203,15924,False
2017,02/19,WestTexNewMexico,0.8,520135,62561,15797,143141,128723,0,Winter,663276,191284,15797,False
2017,02/12,WestTexNewMexico,0.65,634306,74919,16662,146277,249895,0,Winter,780583,324814,16662,False
2017,02/05,WestTexNewMexico,0.52,1067388,127511,18640,144985,279028,0,Winter,1212373,406539,18640,False
2017,01/29,WestTexNewMexico,0.74,607131,61234,15028,159375,136376,0,Winter,766506,197610,15028,False
2017,01/22,WestTexNewMexico,0.67,653900,95147,14466,113880,223558,0,Winter,767780,318705,14466,False
2017,01/15,WestTexNewMexico,0.73,565135,98377,17186,153857,234040,0,Winter,718992,332417,17186,False
2017,01/08,WestTexNewMexico,0.76,486063,102288,15502,151408,199527,30,Winter,637471,301815,15532,False
2017,01/01,WestTexNewMexico,0.75,394004,96731,16147,134847,178016,2,Winter,528851,274747,16149,False
2018,03/25,Albany,1.57,16361,109045,65,19273,4270,380,Spring,35634,113315,445,False
2018,03/18,Albany,1.35,13234,61037,55,26755,3721,500,Spring,39989,64758,555,False
2018,03/11,Albany,1.12,15823,110950,70,14480,3033,291,Spring,30303,113983,361,False
2018,03/04,Albany,1.08,12002,105069,95,16128,5941,283,Spring,28130,111010,378,False
2018,02/25,Albany,1.28,10368,59723,48,30126,3702,310,Winter,40494,63425,358,False
2018,02/18,Albany,1.43,5499,61661,75,15677,2336,380,Winter,21176,63997,455,False
2018,02/11,Albany,1.45,8183,95548,61,13264,4295,451,Winter,21447,99843,512,False
2018,02/04,Albany,1.03,7625,195725,143,10571,2422,250,Winter,18196,198147,393,False
2018,01/28,Albany,1.57,3101,74627,55,11614,4159,66,Winter,14715,78786,121,False
2018,01/21,Albany,1.69,3133,116520,88,10023,5429,0,Winter,13156,121949,88,False
2018,01/14,Albany,1.42,2897,76570,44,10012,5721,0,Winter,12909,82291,44,False
2018,01/07,Albany,1.13,2940,76192,42,8633,10707,23,Winter,11573,86899,65,False
2018,03/25,Atlanta,1.04,281209,33187,1831,227944,77406,3065,Spring,509153,110593,4896,False
2018,03/18,Atlanta,0.95,323507,36770,1828,267740,97851,2752,Spring,591247,134621,4580,False
2018,03/11,Atlanta,0.96,320199,36356,1628,260152,74963,2520,Spring,580351,111319,4148,False
2018,03/04,Atlanta,1.08,272245,37136,1763,178019,103016,2371,Spring,450264,140152,4134,False
2018,02/25,Atlanta,1.06,257877,35083,1579,201139,88126,2433,Winter,459016,123209,4012,False
2018,02/18,Atlanta,1.04,229255,30082,1325,198897,76224,2661,Winter,428152,106306,3986,False
2018,02/11,Atlanta,0.87,349354,39349,1608,241870,89401,2344,Winter,591224,128750,3952,False
2018,02/04,Atlanta,0.86,474887,55158,1755,292317,131566,2107,Winter,767204,186724,3862,False
2018,01/28,Atlanta,1.08,267126,37573,1661,165156,83774,4167,Winter,432282,121347,5828,False
2018,01/21,Atlanta,1.1,288131,56731,1612,158655,128969,5320,Winter,446786,185700,6932,False
2018,01/14,Atlanta,1.1,298975,60229,1604,171508,134436,4011,Winter,470483,194665,5615,False
2018,01/07,Atlanta,0.98,364463,47869,1459,217644,78287,4191,Winter,582107,126156,5650,False
2018,03/25,BaltimoreWashington,1.23,108250,591934,4205,277508,2777,1363,Spring,385758,594711,5568,False
2018,03/18,BaltimoreWashington,1.16,114754,505245,5034,483402,2918,1886,Spring,598156,508163,6920,False
2018,03/11,BaltimoreWashington,1.36,104341,484252,4933,278834,2348,70,Spring,383175,486600,5003,False
2018,03/04,BaltimoreWashington,1.25,102687,619501,5269,256822,4225,66,Spring,359509,623726,5335,False
2018,02/25,BaltimoreWashington,1.37,104218,479773,4765,243370,3930,236,Winter,347588,483703,5001,False
2018,02/18,BaltimoreWashington,1.42,92816,487724,4694,206322,4030,926,Winter,299138,491754,5620,False
2018,02/11,BaltimoreWashington,1.41,112222,545365,4700,233808,4287,173,Winter,346030,549652,4873,False
2018,02/04,BaltimoreWashington,1.12,139312,708495,5611,369085,2512,86,Winter,508397,711007,5697,False
2018,01/28,BaltimoreWashington,1.12,115283,805041,4257,225931,2019,6,Winter,341214,807060,4263,False
2018,01/21,BaltimoreWashington,1.18,129351,659069,4321,304382,5088,0,Winter,433733,664157,4321,False
2018,01/14,BaltimoreWashington,1.49,91785,485963,4234,212956,4783,3,Winter,304741,490746,4237,False
2018,01/07,BaltimoreWashington,1.5,89883,466602,4167,189304,21356,0,Winter,279187,487958,4167,False
2018,03/25,Boise,1.28,40361,2026,9200,24809,9434,7,Spring,65170,11460,9207,False
2018,03/18,Boise,1.03,49145,6654,7737,20536,34626,343,Spring,69681,41280,8080,False
2018,03/11,Boise,1.26,28399,2279,12280,28668,8931,51,Spring,57067,11210,12331,False
2018,03/04,Boise,1.22,44454,1835,10101,26585,8061,32,Spring,71039,9896,10133,False
2018,02/25,Boise,1.09,42116,7518,11798,17586,33806,357,Winter,59702,41324,12155,False
2018,02/18,Boise,1.25,39772,2363,8575,21029,9032,59,Winter,60801,11395,8634,False
2018,02/11,Boise,1.14,48308,2816,10558,19862,11540,19,Winter,68170,14356,10577,False
2018,02/04,Boise,1.07,39582,8511,22490,17470,40491,155,Winter,57052,49002,22645,False
2018,01/28,Boise,1.12,66653,1971,6961,20717,8682,38,Winter,87370,10653,6999,False
2018,01/21,Boise,1.25,49711,2157,6343,22463,8026,26,Winter,72174,10183,6369,False
2018,01/14,Boise,1.15,49335,7414,8298,19135,26830,97,Winter,68470,34244,8395,False
2018,01/07,Boise,1.3,45936,2658,7511,21784,7752,54,Winter,67720,10410,7565,False
2018,03/25,Boston,1.39,26019,479186,1883,109938,22955,1480,Spring,135957,502141,3363,False
2018,03/18,Boston,1.38,24831,443903,1853,101891,28125,1571,Spring,126722,472028,3424,False
2018,03/11,Boston,1.34,23641,479640,1840,102902,19475,1591,Spring,126543,499115,3431,False
2018,03/04,Boston,1.19,20384,645988,1884,88147,27442,1341,Spring,108531,673430,3225,False
2018,02/25,Boston,1.41,19622,376506,1796,112254,15890,1204,Winter,131876,392396,3000,False
2018,02/18,Boston,1.51,16054,378699,2422,99085,17672,1087,Winter,115139,396371,3509,False
2018,02/11,Boston,1.3,23220,703749,6620,86124,13366,1223,Winter,109344,717115,7843,False
2018,02/04,Boston,1.39,21309,566751,3293,98025,36068,486,Winter,119334,602819,3779,False
2018,01/28,Boston,1.22,14384,680080,2656,77511,25561,80,Winter,91895,705641,2736,False
2018,01/21,Boston,1.12,15177,865836,6492,85468,26806,0,Winter,100645,892642,6492,False
2018,01/14,Boston,1.49,10669,393026,2533,81610,45311,0,Winter,92279,438337,2533,False
2018,01/07,Boston,1.28,12012,557314,4961,58834,52294,0,Winter,70846,609608,4961,False
2018,03/25,BuffaloRochester,1.21,18266,82910,80,20541,41090,702,Spring,38807,124000,782,False
2018,03/18,BuffaloRochester,1.14,16300,70320,63,22589,56334,750,Spring,38889,126654,813,False
2018,03/11,BuffaloRochester,1.16,18057,83259,57,41026,41959,814,Spring,59083,125218,871,False
2018,03/04,BuffaloRochester,1.19,13533,75344,67,23485,55219,540,Spring,37018,130563,607,False
2018,02/25,BuffaloRochester,1.23,12862,69046,64,43442,25218,695,Winter,56304,94264,759,False
2018,02/18,BuffaloRochester,1.28,10951,66055,74,32089,34562,353,Winter,43040,100617,427,False
2018,02/11,BuffaloRochester,1.27,12749,74595,84,41236,21391,1001,Winter,53985,95986,1085,False
2018,02/04,BuffaloRochester,1.32,13478,99364,84,14935,60228,563,Winter,28413,159592,647,False
2018,01/28,BuffaloRochester,1.27,8099,76070,96,12060,62156,154,Winter,20159,138226,250,False
2018,01/21,BuffaloRochester,1.29,8269,75965,61,26340,51249,0,Winter,34609,127214,61,False
2018,01/14,BuffaloRochester,1.32,8239,80916,40,27693,42180,0,Winter,35932,123096,40,False
2018,01/07,BuffaloRochester,1.28,8645,92302,56,12248,48624,0,Winter,20893,140926,56,False
2018,03/25,Charlotte,1.32,68088,87220,5567,92743,4926,1,Spring,160831,92146,5568,False
2018,03/18,Charlotte,0.99,73274,93954,5330,218181,5583,0,Spring,291455,99537,5330,False
2018,03/11,Charlotte,1.27,72847,98059,6212,96038,6503,1,Spring,168885,104562,6213,False
2018,03/04,Charlotte,1.32,67459,80515,6005,97703,7376,0,Spring,165162,87891,6005,False
2018,02/25,Charlotte,1.34,63442,91258,5678,86338,2535,0,Winter,149780,93793,5678,False
2018,02/18,Charlotte,1.36,53547,75445,5423,85685,4293,0,Winter,139232,79738,5423,False
2018,02/11,Charlotte,1.18,69727,67904,5261,113041,6197,0,Winter,182768,74101,5261,False
2018,02/04,Charlotte,0.99,86708,99117,6476,208289,10567,0,Winter,294997,109684,6476,False
2018,01/28,Charlotte,1.37,68666,79639,4802,89456,5327,0,Winter,158122,84966,4802,False
2018,01/21,Charlotte,1.11,74246,80371,4657,165016,7031,1,Winter,239262,87402,4658,False
2018,01/14,Charlotte,1.38,60751,97094,5512,82964,4937,0,Winter,143715,102031,5512,False
2018,01/07,Charlotte,1.36,69157,80320,4915,84280,4627,0,Winter,153437,84947,4915,False
2018,03/25,Chicago,1.36,142681,463136,174975,103579,22467,1362,Spring,246260,485603,176337,False
2018,03/18,Chicago,1.42,85185,435552,174149,110035,34764,1483,Spring,195220,470316,175632,False
2018,03/11,Chicago,1.54,95041,454041,142564,100438,37184,1150,Spring,195479,491225,143714,False
2018,03/04,Chicago,1.53,109595,465039,104755,97377,42517,1442,Spring,206972,507556,106197,False
2018,02/25,Chicago,1.51,74465,452448,131640,91023,44466,879,Winter,165488,496914,132519,False
2018,02/18,Chicago,1.53,67207,403149,131732,98803,35146,276,Winter,166010,438295,132008,False
2018,02/11,Chicago,1.39,131360,488374,154223,85210,37063,945,Winter,216570,525437,155168,False
2018,02/04,Chicago,0.88,257095,1235325,158735,91953,59112,423,Winter,349048,1294437,159158,False
2018,01/28,Chicago,1.36,108233,515116,124271,79871,120462,13,Winter,188104,635578,124284,False
2018,01/21,Chicago,1.42,110759,473797,154585,79124,133370,10,Winter,189883,607167,154595,False
2018,01/14,Chicago,1.64,82376,440322,134141,93374,12782,0,Winter,175750,453104,134141,False
2018,01/07,Chicago,1.5,132853,475772,139314,85019,9161,19,Winter,217872,484933,139333,False
2018,03/25,CincinnatiDayton,1.08,70493,27183,9616,140702,20939,8332,Spring,211195,48122,17948,False
2018,03/18,CincinnatiDayton,1.07,68444,16626,10114,119963,25174,4739,Spring,188407,41800,14853,False
2018,03/11,CincinnatiDayton,1.01,65139,22713,10175,146773,30140,861,Spring,211912,52853,11036,False
2018,03/04,CincinnatiDayton,1.02,69312,20912,9651,146627,14918,4519,Spring,215939,35830,14170,False
2018,02/25,CincinnatiDayton,1.03,59106,31605,9097,135219,24337,3998,Winter,194325,55942,13095,False
2018,02/18,CincinnatiDayton,0.83,71473,15783,7110,108121,28080,1159,Winter,179594,43863,8269,False
2018,02/11,CincinnatiDayton,0.8,98065,31216,11211,124062,34478,6364,Winter,222127,65694,17575,False
2018,02/04,CincinnatiDayton,0.76,102019,67966,13825,165544,29548,1311,Winter,267563,97514,15136,False
2018,01/28,CincinnatiDayton,0.92,78131,27858,11786,155062,9071,2,Winter,233193,36929,11788,False
2018,01/21,CincinnatiDayton,0.89,92142,54830,12823,148818,13170,22,Winter,240960,68000,12845,False
2018,01/14,CincinnatiDayton,1.15,59620,30542,19975,123961,9260,6,Winter,183581,39802,19981,False
2018,01/07,CincinnatiDayton,0.91,98045,37713,18889,130642,18046,254,Winter,228687,55759,19143,False
2018,03/25,Columbus,0.96,77671,21732,3272,133163,28160,778,Spring,210834,49892,4050,False
2018,03/18,Columbus,1.01,62775,15964,2293,95448,39893,522,Spring,158223,55857,2815,False
2018,03/11,Columbus,1.05,60498,22813,2942,85932,39844,76,Spring,146430,62657,3018,False
2018,03/04,Columbus,1.04,61462,17792,2208,103725,21557,784,Spring,165187,39349,2992,False
2018,02/25,Columbus,1.03,55429,28466,3406,85192,34250,2434,Winter,140621,62716,5840,False
2018,02/18,Columbus,1.02,47570,13758,2239,76906,36898,1819,Winter,124476,50656,4058,False
2018,02/11,Columbus,0.82,79239,26356,2998,73393,34338,2003,Winter,152632,60694,5001,False
2018,02/04,Columbus,0.73,108554,61748,5329,117614,39927,223,Winter,226168,101675,5552,False
2018,01/28,Columbus,1.03,60555,23671,3175,83156,16932,32,Winter,143711,40603,3207,False
2018,01/21,Columbus,0.99,75486,52395,4298,63261,18897,13,Winter,138747,71292,4311,False
2018,01/14,Columbus,1.07,77236,24462,3266,75499,14125,28,Winter,152735,38587,3294,False
2018,01/07,Columbus,0.84,112638,32262,4167,89971,17360,356,Winter,202609,49622,4523,False
2018,03/25,DallasFtWorth,0.73,788734,219585,6423,673212,94356,21039,Spring,1461946,313941,27462,False
2018,03/18,DallasFtWorth,0.87,656842,247599,4978,329530,103951,19346,Spring,986372,351550,24324,False
2018,03/11,DallasFtWorth,0.87,688566,213463,5709,329344,100310,18766,Spring,1017910,313773,24475,False
2018,03/04,DallasFtWorth,0.77,673535,263895,6341,449577,86867,20924,Spring,1123112,350762,27265,False
2018,02/25,DallasFtWorth,0.74,807933,231111,6306,477107,75376,19063,Winter,1285040,306487,25369,False
2018,02/18,DallasFtWorth,0.77,780856,250380,5033,268220,102051,15428,Winter,1049076,352431,20461,False
2018,02/11,DallasFtWorth,0.72,768415,212945,5327,461849,87861,17004,Winter,1230264,300806,22331,False
2018,02/04,DallasFtWorth,0.67,855815,340887,6655,583353,86725,11965,Winter,1439168,427612,18620,False
2018,01/28,DallasFtWorth,0.82,781164,187033,5596,378776,80095,427,Winter,1159940,267128,6023,False
2018,01/21,DallasFtWorth,0.85,728035,216211,6291,410340,76287,72,Winter,1138375,292498,6363,False
2018,01/14,DallasFtWorth,0.93,677477,316020,7862,240134,91381,304,Winter,917611,407401,8166,False
2018,01/07,DallasFtWorth,0.92,587439,258369,5543,183640,104915,302,Winter,771079,363284,5845,False
2018,03/25,Denver,1.02,176286,222958,16540,121655,413042,0,Spring,297941,636000,16540,False
2018,03/18,Denver,1.02,163394,260747,15483,129403,441922,2,Spring,292797,702669,15485,False
2018,03/11,Denver,1.16,159389,205340,16598,156327,250452,0,Spring,315716,455792,16598,False
2018,03/04,Denver,1.01,192776,258652,15526,137337,330166,0,Spring,330113,588818,15526,False
2018,02/25,Denver,0.99,166753,254657,14153,137052,445944,52,Winter,303805,700601,14205,False
2018,02/18,Denver,1.16,159850,197244,12929,126126,247827,0,Winter,285976,445071,12929,False
2018,02/11,Denver,0.91,234995,251174,13754,86599,469530,0,Winter,321594,720704,13754,False
2018,02/04,Denver,0.87,234985,468889,11698,88502,577453,0,Winter,323487,1046342,11698,False
2018,01/28,Denver,1.15,181751,215803,9803,111320,254537,1,Winter,293071,470340,9804,False
2018,01/21,Denver,1.16,147297,233968,14834,101867,374703,1,Winter,249164,608671,14835,False
2018,01/14,Denver,1.1,178992,323916,11963,121454,366815,0,Winter,300446,690731,11963,False
2018,01/07,Denver,1.01,184830,292349,14102,112396,360171,0,Winter,297226,652520,14102,False
2018,03/25,Detroit,1.15,82568,72460,62078,211303,21812,27413,Spring,293871,94272,89491,False
2018,03/18,Detroit,1.09,82792,43727,29920,220038,37118,15002,Spring,302830,80845,44922,False
2018,03/11,Detroit,1.14,82676,65334,47721,178042,49942,19577,Spring,260718,115276,67298,False
2018,03/04,Detroit,1.18,89601,41375,26105,216775,13655,12533,Spring,306376,55030,38638,False
2018,02/25,Detroit,1.08,72595,90296,53864,185976,32253,29427,Winter,258571,122549,83291,False
2018,02/18,Detroit,1.11,70416,33890,18889,177738,48953,12077,Winter,248154,82843,30966,False
2018,02/11,Detroit,0.92,123642,73381,26265,156008,42872,13214,Winter,279650,116253,39479,False
2018,02/04,Detroit,0.67,167512,287359,60027,266930,89516,9192,Winter,434442,376875,69219,False
2018,01/28,Detroit,1.14,80917,70055,14554,177720,23023,1185,Winter,258637,93078,15739,False
2018,01/21,Detroit,0.96,87365,220100,46163,146574,65171,4786,Winter,233939,285271,50949,False
2018,01/14,Detroit,1.18,94963,60826,13812,162745,36032,1248,Winter,257708,96858,15060,False
2018,01/07,Detroit,0.92,164665,81248,23315,195595,45090,2226,Winter,360260,126338,25541,False
2018,03/25,GrandRapids,1.47,2946,85213,63349,29054,7662,18801,Spring,32000,92875,82150,False
2018,03/18,GrandRapids,1.4,3261,64300,35087,55491,6112,11715,Spring,58752,70412,46802,False
2018,03/11,GrandRapids,1.43,3195,75173,55327,32676,8368,16544,Spring,35871,83541,71871,False
2018,03/04,GrandRapids,1.74,2687,54299,29572,33939,7138,9781,Spring,36626,61437,39353,False
2018,02/25,GrandRapids,1.27,2534,86121,63728,27041,11484,17368,Winter,29575,97605,81096,False
2018,02/18,GrandRapids,1.52,1921,46210,26232,55370,5586,8550,Winter,57291,51796,34782,False
2018,02/11,GrandRapids,1.4,3619,80530,42489,25201,2735,13028,Winter,28820,83265,55517,False
2018,02/04,GrandRapids,0.88,4371,193222,143538,22315,1765,43708,Winter,26686,194987,187246,False
2018,01/28,GrandRapids,1.55,2937,86845,30069,31880,1661,9278,Winter,34817,88506,39347,False
2018,01/21,GrandRapids,1.01,2991,143928,137321,23516,1183,40623,Winter,26507,145111,177944,False
2018,01/14,GrandRapids,1.63,2444,60928,30487,27912,1824,9119,Winter,30356,62752,39606,False
2018,01/07,GrandRapids,1.35,2865,75494,45133,29085,3455,13441,Winter,31950,78949,58574,False
2018,03/25,HarrisburgScranton,1.21,87782,137599,131,95210,7089,2557,Spring,182992,144688,2688,False
2018,03/18,HarrisburgScranton,1.18,75911,121945,200,98656,725,2300,Spring,174567,122670,2500,False
2018,03/11,HarrisburgScranton,1.22,65731,115236,174,87461,9219,1822,Spring,153192,124455,1996,False
2018,03/04,HarrisburgScranton,1.21,65788,130046,150,82676,8658,1770,Spring,148464,138704,1920,False
2018,02/25,HarrisburgScranton,1.24,63582,127685,166,78774,9426,2020,Winter,142356,137111,2186,False
2018,02/18,HarrisburgScranton,1.25,67138,129856,111,71649,6605,1661,Winter,138787,136461,1772,False
2018,02/11,HarrisburgScranton,1.09,77585,165153,116,72248,4766,1497,Winter,149833,169919,1613,False
2018,02/04,HarrisburgScranton,1.16,92062,211176,157,89502,1977,796,Winter,181564,213153,953,False
2018,01/28,HarrisburgScranton,1.15,101247,112796,129,84111,447,336,Winter,185358,113243,465,False
2018,01/21,HarrisburgScranton,1.14,125847,136876,168,79398,3142,3,Winter,205245,140018,171,False
2018,01/14,HarrisburgScranton,1.25,80067,121405,189,62453,13500,0,Winter,142520,134905,189,False
2018,01/07,HarrisburgScranton,1.33,57546,128633,70,57822,13207,0,Winter,115368,141840,70,False
2018,03/25,HartfordSpringfield,1.44,17715,243023,242,82409,1066,1506,Spring,100124,244089,1748,False
2018,03/18,HartfordSpringfield,1.43,16506,218357,217,68741,3282,1611,Spring,85247,221639,1828,False
2018,03/11,HartfordSpringfield,1.42,17765,215834,183,66170,13298,1595,Spring,83935,229132,1778,False
2018,03/04,HartfordSpringfield,1.17,15615,347650,272,64366,3032,1157,Spring,79981,350682,1429,False
2018,02/25,HartfordSpringfield,1.45,13661,196776,314,68300,9368,1185,Winter,81961,206144,1499,False
2018,02/18,HartfordSpringfield,1.42,11150,209791,212,60822,386,901,Winter,71972,210177,1113,False
2018,02/11,HartfordSpringfield,1.48,14675,270215,208,65856,744,1031,Winter,80531,270959,1239,False
2018,02/04,HartfordSpringfield,1.38,11605,345582,1100,67967,1438,256,Winter,79572,347020,1356,False
2018,01/28,HartfordSpringfield,1.18,7854,360244,237,60495,3601,166,Winter,68349,363845,403,False
2018,01/21,HartfordSpringfield,1.18,8065,407711,175,56135,2459,6,Winter,64200,410170,181,False
2018,01/14,HartfordSpringfield,1.53,6006,215891,128,60219,6878,0,Winter,66225,222769,128,False
2018,01/07,HartfordSpringfield,1.52,5732,214934,136,49441,13434,0,Winter,55173,228368,136,False
2018,03/25,Houston,0.56,837700,162473,4190,952254,161188,2703,Spring,1789954,323661,6893,False
2018,03/18,Houston,0.79,630826,184825,4011,322054,99304,2904,Spring,952880,284129,6915,False
2018,03/11,Houston,0.83,614152,162269,4184,432316,110079,1473,Spring,1046468,272348,5657,False
2018,03/04,Houston,0.71,701418,176206,3827,528247,91441,557,Spring,1229665,267647,4384,False
2018,02/25,Houston,0.67,855570,147837,3976,544537,105365,237,Winter,1400107,253202,4213,False
2018,02/18,Houston,0.68,931553,160780,4045,372117,103276,291,Winter,1303670,264056,4336,False
2018,02/11,Houston,0.58,801390,156458,4407,747968,160355,294,Winter,1549358,316813,4701,False
2018,02/04,Houston,0.56,952746,300383,7990,1010539,109978,104,Winter,1963285,410361,8094,False
2018,01/28,Houston,0.71,832418,103716,17666,609576,84377,103,Winter,1441994,188093,17769,False
2018,01/21,Houston,0.78,651432,153445,10598,683790,85149,0,Winter,1335222,238594,10598,False
2018,01/14,Houston,0.95,548774,292561,6066,355573,113294,76,Winter,904347,405855,6142,False
2018,01/07,Houston,0.8,658828,171364,3656,446637,110130,0,Winter,1105465,281494,3656,False
2018,03/25,Indianapolis,1.05,53795,53103,7008,96343,15834,2751,Spring,150138,68937,9759,False
2018,03/18,Indianapolis,1.01,51782,34392,8471,98947,12343,3232,Spring,150729,46735,11703,False
2018,03/11,Indianapolis,1.0,56419,46098,6226,104102,13239,1909,Spring,160521,59337,8135,False
2018,03/04,Indianapolis,1.09,52161,35083,5581,99830,11245,3564,Spring,151991,46328,9145,False
2018,02/25,Indianapolis,1.06,37683,50954,6621,74496,21698,5161,Winter,112179,72652,11782,False
2018,02/18,Indianapolis,0.91,48716,27782,4155,86145,17865,1857,Winter,134861,45647,6012,False
2018,02/11,Indianapolis,0.81,86439,52397,5258,90091,21306,2514,Winter,176530,73703,7772,False
2018,02/04,Indianapolis,0.79,90305,110035,12010,95765,25974,1351,Winter,186070,136009,13361,False
2018,01/28,Indianapolis,0.92,64276,83870,8592,93966,14884,10,Winter,158242,98754,8602,False
2018,01/21,Indianapolis,1.03,62385,66055,11433,84064,9782,9,Winter,146449,75837,11442,False
2018,01/14,Indianapolis,1.2,42103,39886,14213,87576,4431,19,Winter,129679,44317,14232,False
2018,01/07,Indianapolis,0.95,77536,52880,15323,88828,6694,32,Winter,166364,59574,15355,False
2018,03/25,Jacksonville,1.3,97376,9226,569,41255,34987,73,Spring,138631,44213,642,False
2018,03/18,Jacksonville,1.12,125894,13198,449,38854,55768,70,Spring,164748,68966,519,False
2018,03/11,Jacksonville,1.16,126052,12557,439,37739,50845,80,Spring,163791,63402,519,False
2018,03/04,Jacksonville,1.12,129813,12471,516,35609,51397,96,Spring,165422,63868,612,False
2018,02/25,Jacksonville,1.27,103082,11763,428,43722,35617,113,Winter,146804,47380,541,False
2018,02/18,Jacksonville,1.31,103477,10571,409,34243,36218,83,Winter,137720,46789,492,False
2018,02/11,Jacksonville,0.99,134245,14759,521,34342,50597,90,Winter,168587,65356,611,False
2018,02/04,Jacksonville,0.96,206007,24133,480,79274,55614,126,Winter,285281,79747,606,False
2018,01/28,Jacksonville,1.33,103226,11072,397,40095,33517,246,Winter,143321,44589,643,False
2018,01/21,Jacksonville,1.14,137389,14033,444,34372,44668,375,Winter,171761,58701,819,False
2018,01/14,Jacksonville,1.41,105265,11039,332,30382,34981,387,Winter,135647,46020,719,False
2018,01/07,Jacksonville,1.2,116008,13934,395,26811,40448,321,Winter,142819,54382,716,False
2018,03/25,LasVegas,1.01,76054,122475,6496,75499,101806,414,Spring,151553,224281,6910,False
2018,03/18,LasVegas,1.17,76056,92588,7007,80016,55393,463,Spring,156072,147981,7470,False
2018,03/11,LasVegas,1.18,61233,91407,8059,83945,53527,632,Spring,145178,144934,8691,False
2018,03/04,LasVegas,1.05,83041,107504,6520,93651,80100,450,Spring,176692,187604,6970,False
2018,02/25,LasVegas,1.05,76253,109855,6642,76321,82977,483,Winter,152574,192832,7125,False
2018,02/18,LasVegas,1.13,60956,107433,6230,74636,75331,453,Winter,135592,182764,6683,False
2018,02/11,LasVegas,0.9,89138,145487,5018,71692,122026,446,Winter,160830,267513,5464,False
2018,02/04,LasVegas,0.88,80027,212174,6000,82603,131899,276,Winter,162630,344073,6276,False
2018,01/28,LasVegas,1.04,70883,109999,5322,82587,78955,404,Winter,153470,188954,5726,False
2018,01/21,LasVegas,1.05,78984,100813,6256,69513,108140,446,Winter,148497,208953,6702,False
2018,01/14,LasVegas,1.16,79986,96281,7841,71330,67126,366,Winter,151316,163407,8207,False
2018,01/07,LasVegas,1.05,78921,113033,7515,60836,85049,453,Winter,139757,198082,7968,False
2018,03/25,LosAngeles,1.02,1007972,439940,63511,1248694,26861,56560,Spring,2256666,466801,120071,False
2018,03/18,LosAngeles,0.91,1116865,700177,62395,1435807,25385,54632,Spring,2552672,725562,117027,False
2018,03/11,LosAngeles,1.03,1152656,373411,72380,1373991,29875,56719,Spring,2526647,403286,129099,False
2018,03/04,LosAngeles,1.1,985767,371412,77531,1144956,33430,54005,Spring,2130723,404842,131536,False
2018,02/25,LosAngeles,1.0,1191842,462947,74821,1220997,30525,48821,Winter,2412839,493472,123642,False
2018,02/18,LosAngeles,1.08,1148398,357520,74811,1089251,33031,46705,Winter,2237649,390551,121516,False
2018,02/11,LosAngeles,0.85,1497227,412653,79663,1271672,20164,42501,Winter,2768899,432817,122164,False
2018,02/04,LosAngeles,0.73,2532500,965716,93806,1414064,21441,43050,Winter,3946564,987157,136856,False
2018,01/28,LosAngeles,1.08,1134192,707838,81296,911703,16595,42090,Winter,2045895,724433,123386,False
2018,01/21,LosAngeles,1.15,1230413,364552,82843,918833,16789,39590,Winter,2149246,381341,122433,False
2018,01/14,LosAngeles,1.28,1104367,403918,101443,739977,16783,42670,Winter,1844344,420701,144113,False
2018,01/07,LosAngeles,1.04,1275098,354221,91230,940327,18317,46662,Winter,2215425,372538,137892,False
2018,03/25,Louisville,1.04,31512,24342,306,49898,19277,1324,Spring,81410,43619,1630,False
2018,03/18,Louisville,1.02,32100,23976,204,53034,15925,970,Spring,85134,39901,1174,False
2018,03/11,Louisville,1.08,26859,26636,263,46121,16452,774,Spring,72980,43088,1037,False
2018,03/04,Louisville,1.15,22840,23137,219,32351,17796,828,Spring,55191,40933,1047,False
2018,02/25,Louisville,1.13,18466,25327,351,32907,22038,488,Winter,51373,47365,839,False
2018,02/18,Louisville,1.06,21211,21287,197,33930,24059,835,Winter,55141,45346,1032,False
2018,02/11,Louisville,0.87,37508,30307,307,42692,19050,700,Winter,80200,49357,1007,False
2018,02/04,Louisville,0.84,37164,52978,805,51038,27458,384,Winter,88202,80436,1189,False
2018,01/28,Louisville,1.18,9754,34513,262,31382,20628,5,Winter,41136,55141,267,False
2018,01/21,Louisville,1.07,9137,48370,699,34517,26442,0,Winter,43654,74812,699,False
2018,01/14,Louisville,1.15,12826,44061,168,32059,32693,2,Winter,44885,76754,170,False
2018,01/07,Louisville,1.0,29241,37772,170,32655,19115,2,Winter,61896,56887,172,False
2018,03/25,MiamiFtLauderdale,1.37,474642,53923,2049,106478,61776,90,Spring,581120,115699,2139,False
2018,03/18,MiamiFtLauderdale,1.17,575923,70118,2101,102331,78219,143,Spring,678254,148337,2244,False
2018,03/11,MiamiFtLauderdale,1.19,603091,74717,2009,97893,110561,340,Spring,700984,185278,2349,False
2018,03/04,MiamiFtLauderdale,1.14,639495,77645,1780,112719,48965,781,Spring,752214,126610,2561,False
2018,02/25,MiamiFtLauderdale,1.36,420401,51048,1505,120093,54105,80,Winter,540494,105153,1585,False
2018,02/18,MiamiFtLauderdale,1.34,451052,52028,2264,95511,68415,73,Winter,546563,120443,2337,False
2018,02/11,MiamiFtLauderdale,1.0,580099,76468,2153,106427,90813,60,Winter,686526,167281,2213,False
2018,02/04,MiamiFtLauderdale,0.98,897435,118495,2277,111637,180761,63,Winter,1009072,299256,2340,False
2018,01/28,MiamiFtLauderdale,1.4,440406,54463,2465,95377,68491,6,Winter,535783,122954,2471,False
2018,01/21,MiamiFtLauderdale,1.19,592863,79364,1920,84785,66902,0,Winter,677648,146266,1920,False
2018,01/14,MiamiFtLauderdale,1.46,416705,53783,2713,81480,63228,0,Winter,498185,117011,2713,False
2018,01/07,MiamiFtLauderdale,1.22,513398,68558,1946,75200,87798,0,Winter,588598,156356,1946,False
2018,03/25,Nashville,0.95,125788,10713,334,136737,30406,2300,Spring,262525,41119,2634,False
2018,03/18,Nashville,0.89,141265,11914,387,131128,29834,1671,Spring,272393,41748,2058,False
2018,03/11,Nashville,0.94,136420,11461,366,129994,24769,1688,Spring,266414,36230,2054,False
2018,03/04,Nashville,1.03,117403,10736,403,82516,30595,2211,Spring,199919,41331,2614,False
2018,02/25,Nashville,1.08,105794,10432,350,83854,27860,1937,Winter,189648,38292,2287,False
2018,02/18,Nashville,1.05,96889,9241,323,84042,37977,1608,Winter,180931,47218,1931,False
2018,02/11,Nashville,0.8,149429,10869,363,107936,33522,1707,Winter,257365,44391,2070,False
2018,02/04,Nashville,0.8,186689,15471,466,141976,45308,1866,Winter,328665,60779,2332,False
2018,01/28,Nashville,1.08,103525,11727,500,79909,24040,1570,Winter,183434,35767,2070,False
2018,01/21,Nashville,1.0,118667,20388,309,95967,36876,1264,Winter,214634,57264,1573,False
2018,01/14,Nashville,1.04,131981,22212,355,97153,38004,1613,Winter,229134,60216,1968,False
2018,01/07,Nashville,0.85,167628,10026,409,108075,16240,1581,Winter,275703,26266,1990,False
2018,03/25,NewOrleansMobile,1.04,171335,20076,2425,94895,15963,410,Spring,266230,36039,2835,False
2018,03/18,NewOrleansMobile,1.02,181011,19002,2515,95470,18533,436,Spring,276481,37535,2951,False
2018,03/11,NewOrleansMobile,1.05,177320,22478,2158,93807,20352,346,Spring,271127,42830,2504,False
2018,03/04,NewOrleansMobile,1.03,190521,24646,2564,97910,16489,246,Spring,288431,41135,2810,False
2018,02/25,NewOrleansMobile,0.98,221362,38254,2432,97659,13202,256,Winter,319021,51456,2688,False
2018,02/18,NewOrleansMobile,1.02,173296,24837,1962,94229,12303,336,Winter,267525,37140,2298,False
2018,02/11,NewOrleansMobile,0.97,174271,18425,1971,82271,12267,320,Winter,256542,30692,2291,False
2018,02/04,NewOrleansMobile,0.76,352425,40674,2373,114300,11056,353,Winter,466725,51730,2726,False
2018,01/28,NewOrleansMobile,1.08,198062,21726,2409,81430,10352,933,Winter,279492,32078,3342,False
2018,01/21,NewOrleansMobile,1.04,192632,23240,2212,79583,11776,1142,Winter,272215,35016,3354,False
2018,01/14,NewOrleansMobile,1.15,170097,22912,2542,76659,17342,1017,Winter,246756,40254,3559,False
2018,01/07,NewOrleansMobile,1.15,183343,30856,2514,64892,13346,987,Winter,248235,44202,3501,False
2018,03/25,NewYork,1.34,63905,908653,843,774634,23833,2905,Spring,838539,932486,3748,False
2018,03/18,NewYork,1.43,73760,911098,612,552433,24302,2652,Spring,626193,935400,3264,False
2018,03/11,NewYork,1.35,64008,883441,828,730150,74224,2397,Spring,794158,957665,3225,False
2018,03/04,NewYork,1.23,62328,1324579,754,511679,29854,2298,Spring,574007,1354433,3052,False
2018,02/25,NewYork,1.3,76602,841320,852,632625,61658,2266,Winter,709227,902978,3118,False
2018,02/18,NewYork,1.24,87283,909950,885,392965,20809,1792,Winter,480248,930759,2677,False
2018,02/11,NewYork,1.27,169218,1319012,1222,539237,21409,1289,Winter,708455,1340421,2511,False
2018,02/04,NewYork,1.28,96084,2250967,3253,569361,38734,1140,Winter,665445,2289701,4393,False
2018,01/28,NewYork,1.2,82652,1501055,745,675215,18491,567,Winter,757867,1519546,1312,False
2018,01/21,NewYork,1.27,46444,1642533,1165,423570,21523,6,Winter,470014,1664056,1171,False
2018,01/14,NewYork,1.67,39681,818051,1338,415694,19384,0,Winter,455375,837435,1338,False
2018,01/07,NewYork,1.67,39884,866953,573,348249,31820,0,Winter,388133,898773,573,False
2018,03/25,NorthernNewEngland,1.46,43595,365913,1529,34546,36509,1031,Spring,78141,402422,2560,False
2018,03/18,NorthernNewEngland,1.4,45178,315349,1354,30679,34470,996,Spring,75857,349819,2350,False
2018,03/11,NorthernNewEngland,1.08,50349,662866,1245,27070,23244,968,Spring,77419,686110,2213,False
2018,03/04,NorthernNewEngland,1.35,34173,343496,1176,29431,49209,713,Spring,63604,392705,1889,False
2018,02/25,NorthernNewEngland,1.38,22334,293596,1398,37405,43809,763,Winter,59739,337405,2161,False
2018,02/18,NorthernNewEngland,1.35,16084,297489,1168,39537,40374,643,Winter,55621,337863,1811,False
2018,02/11,NorthernNewEngland,1.11,19640,512849,3564,35046,45221,1154,Winter,54686,558070,4718,False
2018,02/04,NorthernNewEngland,1.06,22674,754096,2247,34218,33787,236,Winter,56892,787883,2483,False
2018,01/28,NorthernNewEngland,1.44,11731,360982,1920,31388,35837,116,Winter,43119,396819,2036,False
2018,01/21,NorthernNewEngland,1.33,11506,492832,3776,27451,41550,0,Winter,38957,534382,3776,False
2018,01/14,NorthernNewEngland,1.42,11067,322712,2011,29827,53758,0,Winter,40894,376470,2011,False
2018,01/07,NorthernNewEngland,1.17,10284,394541,4357,23938,69729,0,Winter,34222,464270,4357,False
2018,03/25,Orlando,1.32,258217,25970,1426,90870,52357,290,Spring,349087,78327,1716,False
2018,03/18,Orlando,1.11,333194,32206,1543,82165,59626,243,Spring,415359,91832,1786,False
2018,03/11,Orlando,1.13,333909,33091,1477,91546,68931,243,Spring,425455,102022,1720,False
2018,03/04,Orlando,1.13,331886,35297,1526,86462,78304,223,Spring,418348,113601,1749,False
2018,02/25,Orlando,1.3,255777,26833,1404,93328,39425,180,Winter,349105,66258,1584,False
2018,02/18,Orlando,1.31,246434,23807,1357,83331,41450,186,Winter,329765,65257,1543,False
2018,02/11,Orlando,1.0,346562,36818,1200,74552,57051,220,Winter,421114,93869,1420,False
2018,02/04,Orlando,0.99,511953,60712,1345,88148,97195,176,Winter,600101,157907,1521,False
2018,01/28,Orlando,1.35,262391,28265,1290,75243,47547,43,Winter,337634,75812,1333,False
2018,01/21,Orlando,1.16,312991,36478,1521,72049,59856,7,Winter,385040,96334,1528,False
2018,01/14,Orlando,1.4,258150,26672,1199,68412,33152,0,Winter,326562,59824,1199,False
2018,01/07,Orlando,1.19,288886,34311,997,65277,41293,0,Winter,354163,75604,997,False
2018,03/25,Philadelphia,1.31,43421,252219,248,187566,17687,2134,Spring,230987,269906,2382,False
2018,03/18,Philadelphia,1.33,44696,241775,334,169602,12962,1804,Spring,214298,254737,2138,False
2018,03/11,Philadelphia,1.32,45869,237689,297,177287,23394,1953,Spring,223156,261083,2250,False
2018,03/04,Philadelphia,1.36,37703,231605,335,151599,20573,1835,Spring,189302,252178,2170,False
2018,02/25,Philadelphia,1.26,55979,235447,314,173945,22558,2046,Winter,229924,258005,2360,False
2018,02/18,Philadelphia,1.24,67616,233345,236,117913,22366,1833,Winter,185529,255711,2069,False
2018,02/11,Philadelphia,1.02,130162,320845,213,136379,22296,1371,Winter,266541,343141,1584,False
2018,02/04,Philadelphia,1.12,62044,467927,645,254149,33540,916,Winter,316193,501467,1561,False
2018,01/28,Philadelphia,1.23,90381,256525,390,183977,6289,320,Winter,274358,262814,710,False
2018,01/21,Philadelphia,1.32,69862,303263,383,144550,9797,2,Winter,214412,313060,385,False
2018,01/14,Philadelphia,1.5,36351,232190,443,126685,23512,5,Winter,163036,255702,448,False
2018,01/07,Philadelphia,1.56,22384,239185,407,114764,31460,0,Winter,137148,270645,407,False
2018,03/25,PhoenixTucson,0.59,932956,296968,14886,216076,218329,5318,Spring,1149032,515297,20204,False
2018,03/18,PhoenixTucson,0.71,626645,243424,14272,204096,205346,5404,Spring,830741,448770,19676,False
2018,03/11,PhoenixTucson,0.58,941189,269078,14057,227505,161870,5848,Spring,1168694,430948,19905,False
2018,03/04,PhoenixTucson,0.61,962967,268082,12934,266658,156802,5453,Spring,1229625,424884,18387,False
2018,02/25,PhoenixTucson,0.72,621383,216588,13517,218471,148190,6103,Winter,839854,364778,19620,False
2018,02/18,PhoenixTucson,0.59,923293,242108,12876,228817,131177,6709,Winter,1152110,373285,19585,False
2018,02/11,PhoenixTucson,0.64,793896,256987,12607,241681,179607,5932,Winter,1035577,436594,18539,False
2018,02/04,PhoenixTucson,0.59,1029017,511201,13917,236056,202720,5346,Winter,1265073,713921,19263,False
2018,01/28,PhoenixTucson,0.68,902410,288508,12312,235248,147958,5698,Winter,1137658,436466,18010,False
2018,01/21,PhoenixTucson,0.78,613600,246703,13332,210780,226079,4833,Winter,824380,472782,18165,False
2018,01/14,PhoenixTucson,0.81,628591,284087,15249,200603,221593,4786,Winter,829194,505680,20035,False
2018,01/07,PhoenixTucson,0.89,470698,222151,14761,178186,134615,4900,Winter,648884,356766,19661,False
2018,03/25,Pittsburgh,1.28,44126,13225,1385,39142,34191,26,Spring,83268,47416,1411,False
2018,03/18,Pittsburgh,0.98,73389,22422,2599,36169,63248,416,Spring,109558,85670,3015,False
2018,03/11,Pittsburgh,1.23,40798,15527,1089,48023,29181,6,Spring,88821,44708,1095,False
2018,03/04,Pittsburgh,1.23,35950,14351,954,43202,26151,3,Spring,79152,40502,957,False
2018,02/25,Pittsburgh,0.98,67240,21907,2122,33977,58972,6,Winter,101217,80879,2128,False
2018,02/18,Pittsburgh,1.21,32928,18278,1037,40103,28647,6,Winter,73031,46925,1043,False
2018,02/11,Pittsburgh,1.22,33543,21090,1094,37660,23490,3,Winter,71203,44580,1097,False
2018,02/04,Pittsburgh,0.98,78189,30466,2684,38743,52514,6,Winter,116932,82980,2690,False
2018,01/28,Pittsburgh,1.23,37562,19312,1415,42492,18822,0,Winter,80054,38134,1415,False
2018,01/21,Pittsburgh,1.01,83017,32323,2721,36503,28781,0,Winter,119520,61104,2721,False
2018,01/14,Pittsburgh,1.3,40292,22648,1560,42859,10122,0,Winter,83151,32770,1560,False
2018,01/07,Pittsburgh,1.3,40579,24117,1241,36998,7993,0,Winter,77577,32110,1241,False
2018,03/25,Portland,1.06,75837,304991,14300,166273,96427,338,Spring,242110,401418,14638,False
2018,03/18,Portland,1.04,66714,222709,18614,144978,305017,1123,Spring,211692,527726,19737,False
2018,03/11,Portland,1.11,78454,308559,17485,172296,99071,439,Spring,250750,407630,17924,False
2018,03/04,Portland,1.16,75141,252079,16464,163839,84108,647,Spring,238980,336187,17111,False
2018,02/25,Portland,1.01,62880,259931,16312,101200,328765,3757,Winter,164080,588696,20069,False
2018,02/18,Portland,1.06,81789,278393,16614,160051,99595,481,Winter,241840,377988,17095,False
2018,02/11,Portland,1.25,87666,146006,17712,156038,99378,530,Winter,243704,245384,18242,False
2018,02/04,Portland,0.88,78861,452243,15405,111755,391141,1630,Winter,190616,843384,17035,False
2018,01/28,Portland,1.34,80881,152913,16678,142712,92874,621,Winter,223593,245787,17299,False
2018,01/21,Portland,1.17,76804,271528,18147,150749,90544,384,Winter,227553,362072,18531,False
2018,01/14,Portland,1.06,76227,252457,17693,99618,300591,1274,Winter,175845,553048,18967,False
2018,01/07,Portland,1.22,107127,220686,14535,156850,67977,310,Winter,263977,288663,14845,False
2018,03/25,RaleighGreensboro,1.24,91484,120803,5307,139121,6242,0,Spring,230605,127045,5307,False
2018,03/18,RaleighGreensboro,0.92,96399,130874,4769,312969,7886,1,Spring,409368,138760,4770,False
2018,03/11,RaleighGreensboro,1.2,106062,132338,5654,135823,4716,0,Spring,241885,137054,5654,False
2018,03/04,RaleighGreensboro,1.28,88012,101227,5793,128111,7055,0,Spring,216123,108282,5793,False
2018,02/25,RaleighGreensboro,1.28,91255,120240,5425,119370,7291,0,Winter,210625,127531,5425,False
2018,02/18,RaleighGreensboro,1.29,78221,101748,5439,108698,7969,0,Winter,186919,109717,5439,False
2018,02/11,RaleighGreensboro,1.1,106372,91013,5010,156789,8718,0,Winter,263161,99731,5010,False
2018,02/04,RaleighGreensboro,0.97,119688,132891,5891,254234,12368,0,Winter,373922,145259,5891,False
2018,01/28,RaleighGreensboro,1.34,93956,105608,5131,112705,4946,0,Winter,206661,110554,5131,False
2018,01/21,RaleighGreensboro,1.12,101929,102790,4632,191459,7012,0,Winter,293388,109802,4632,False
2018,01/14,RaleighGreensboro,1.29,88430,138123,6178,119713,8326,0,Winter,208143,146449,6178,False
2018,01/07,RaleighGreensboro,1.3,113445,103827,5071,90848,4017,0,Winter,204293,107844,5071,False
2018,03/25,RichmondNorfolk,1.1,77628,88215,1928,135644,11246,1553,Spring,213272,99461,3481,False
2018,03/18,RichmondNorfolk,0.98,82914,97133,1515,169506,12586,1382,Spring,252420,109719,2897,False
2018,03/11,RichmondNorfolk,1.0,95991,94894,1776,139363,13327,291,Spring,235354,108221,2067,False
2018,03/04,RichmondNorfolk,1.14,69170,83513,1792,115639,18714,288,Spring,184809,102227,2080,False
2018,02/25,RichmondNorfolk,1.13,75032,85267,1914,98624,15568,700,Winter,173656,100835,2614,False
2018,02/18,RichmondNorfolk,1.18,52314,78322,1685,85472,18198,1773,Winter,137786,96520,3458,False
2018,02/11,RichmondNorfolk,1.01,73304,95360,1648,107274,14805,348,Winter,180578,110165,1996,False
2018,02/04,RichmondNorfolk,0.86,124229,128208,2217,187621,26710,106,Winter,311850,154918,2323,False
2018,01/28,RichmondNorfolk,1.21,63753,104053,1743,87331,10414,10,Winter,151084,114467,1753,False
2018,01/21,RichmondNorfolk,1.12,72502,112843,1772,112298,22855,0,Winter,184800,135698,1772,False
2018,01/14,RichmondNorfolk,1.19,76364,126208,1844,84944,21823,0,Winter,161308,148031,1844,False
2018,01/07,RichmondNorfolk,1.03,96040,94172,1657,99730,8633,0,Winter,195770,102805,1657,False
2018,03/25,Roanoke,0.99,62126,39027,219,97377,18342,964,Spring,159503,57369,1183,False
2018,03/18,Roanoke,0.97,55659,43568,225,86740,22179,680,Spring,142399,65747,905,False
2018,03/11,Roanoke,0.93,68597,43277,205,100506,15642,433,Spring,169103,58919,638,False
2018,03/04,Roanoke,1.07,43252,37048,245,73252,24594,493,Spring,116504,61642,738,False
2018,02/25,Roanoke,1.06,41912,37321,206,66920,27310,723,Winter,108832,64631,929,False
2018,02/18,Roanoke,1.06,34945,34511,261,58311,27101,771,Winter,93256,61612,1032,False
2018,02/11,Roanoke,0.85,54069,44325,286,87195,21390,390,Winter,141264,65715,676,False
2018,02/04,Roanoke,0.82,82020,55243,294,116918,32938,313,Winter,198938,88181,607,False
2018,01/28,Roanoke,1.14,31259,49375,283,61701,16669,0,Winter,92960,66044,283,False
2018,01/21,Roanoke,1.11,32866,52406,271,61172,29271,13,Winter,94038,81677,284,False
2018,01/14,Roanoke,1.09,35632,58767,184,62260,32827,0,Winter,97892,91594,184,False
2018,01/07,Roanoke,0.93,57981,48543,161,80678,16101,15,Winter,138659,64644,176,False
2018,03/25,Sacramento,1.13,135652,361227,812,67652,624,4478,Spring,203304,361851,5290,False
2018,03/18,Sacramento,1.14,154151,270169,840,84669,734,6897,Spring,238820,270903,7737,False
2018,03/11,Sacramento,1.18,151094,271726,862,115769,1627,5354,Spring,266863,273353,6216,False
2018,03/04,Sacramento,1.18,181586,241036,1031,128164,2453,5672,Spring,309750,243489,6703,False
2018,02/25,Sacramento,0.99,199926,308881,1158,72189,1982,5422,Winter,272115,310863,6580,False
2018,02/18,Sacramento,1.19,131656,330556,700,57058,3145,7129,Winter,188714,333701,7829,False
2018,02/11,Sacramento,1.07,193066,282308,1180,70403,1800,5838,Winter,263469,284108,7018,False
2018,02/04,Sacramento,0.86,262795,518775,1051,71669,1595,6449,Winter,334464,520370,7500,False
2018,01/28,Sacramento,1.32,158788,233834,1129,67847,1197,6117,Winter,226635,235031,7246,False
2018,01/21,Sacramento,1.15,160917,362263,1136,60172,1674,5046,Winter,221089,363937,6182,False
2018,01/14,Sacramento,1.31,144109,299605,1249,52486,754,6063,Winter,196595,300359,7312,False
2018,01/07,Sacramento,1.35,159862,247999,1045,49386,522,6291,Winter,209248,248521,7336,False
2018,03/25,SanDiego,1.1,140383,156203,13940,168263,7442,2088,Spring,308646,163645,16028,False
2018,03/18,SanDiego,0.92,159346,256098,13404,201973,9993,2673,Spring,361319,266091,16077,False
2018,03/11,SanDiego,1.14,165801,124279,16482,197838,6495,1257,Spring,363639,130774,17739,False
2018,03/04,SanDiego,1.24,144401,122241,18028,165182,6458,2812,Spring,309583,128699,20840,False
2018,02/25,SanDiego,1.07,175663,163499,15737,174528,6291,2640,Winter,350191,169790,18377,False
2018,02/18,SanDiego,1.23,152250,119244,18614,147616,7409,2826,Winter,299866,126653,21440,False
2018,02/11,SanDiego,0.93,222366,136214,16577,175708,5873,2185,Winter,398074,142087,18762,False
2018,02/04,SanDiego,0.88,311038,318396,23719,193681,8547,2717,Winter,504719,326943,26436,False
2018,01/28,SanDiego,1.07,168171,256042,16669,118366,4446,2436,Winter,286537,260488,19105,False
2018,01/21,SanDiego,1.26,192219,122174,17624,121675,4729,2285,Winter,313894,126903,19909,False
2018,01/14,SanDiego,1.41,160896,136499,21680,113513,4689,2372,Winter,274409,141188,24052,False
2018,01/07,SanDiego,1.18,192510,118483,19625,125040,6169,2892,Winter,317550,124652,22517,False
2018,03/25,SanFrancisco,1.01,198289,895797,2202,103033,186,3764,Spring,301322,895983,5966,False
2018,03/18,SanFrancisco,1.38,215279,435108,2698,119694,92,4427,Spring,334973,435200,7125,False
2018,03/11,SanFrancisco,1.29,270255,434279,2517,193813,196,3271,Spring,464068,434475,5788,False
2018,03/04,SanFrancisco,1.16,386100,426277,2512,231913,1286,3218,Spring,618013,427563,5730,False
2018,02/25,SanFrancisco,1.17,383689,431346,2127,162913,609,3313,Winter,546602,431955,5440,False
2018,02/18,SanFrancisco,1.06,193705,835774,2425,113216,316,3636,Winter,306921,836090,6061,False
2018,02/11,SanFrancisco,1.32,267695,405148,3199,144064,120,2857,Winter,411759,405268,6056,False
2018,02/04,SanFrancisco,0.84,459981,1113987,2886,126171,282,2942,Winter,586152,1114269,5828,False
2018,01/28,SanFrancisco,1.38,246496,418612,2588,150232,402,3019,Winter,396728,419014,5607,False
2018,01/21,SanFrancisco,1.01,259497,919666,2578,117863,80,2247,Winter,377360,919746,4825,False
2018,01/14,SanFrancisco,1.21,193892,785766,2860,130904,944,3008,Winter,324796,786710,5868,False
2018,01/07,SanFrancisco,1.46,209267,466935,2525,136440,104,2813,Winter,345707,467039,5338,False
2018,03/25,Seattle,1.4,103573,149867,998,155866,113666,292,Spring,259439,263533,1290,False
2018,03/18,Seattle,1.21,91648,191972,1244,180451,219003,1185,Spring,272099,410975,2429,False
2018,03/11,Seattle,1.42,96728,134993,920,165320,116481,297,Spring,262048,251474,1217,False
2018,03/04,Seattle,1.43,93608,135422,571,143222,83237,257,Spring,236830,218659,828,False
2018,02/25,Seattle,1.22,86796,173328,710,113771,260807,1048,Winter,200567,434135,1758,False
2018,02/18,Seattle,1.46,92450,135317,639,148877,90182,608,Winter,241327,225499,1247,False
2018,02/11,Seattle,1.4,98161,129399,631,136973,103420,348,Winter,235134,232819,979,False
2018,02/04,Seattle,1.04,189717,289707,853,115360,312387,1100,Winter,305077,602094,1953,False
2018,01/28,Seattle,1.34,125676,178484,599,136634,106746,445,Winter,262310,285230,1044,False
2018,01/21,Seattle,1.31,125236,202783,754,138209,133100,584,Winter,263445,335883,1338,False
2018,01/14,Seattle,1.26,109322,214002,1034,136005,248487,1052,Winter,245327,462489,2086,False
2018,01/07,Seattle,1.43,116665,133127,1132,164408,58738,232,Winter,281073,191865,1364,False
2018,03/25,SouthCarolina,1.19,205952,73267,4313,132488,31527,3109,Spring,338440,104794,7422,False
2018,03/18,SouthCarolina,1.06,230046,78736,3687,185198,41852,3325,Spring,415244,120588,7012,False
2018,03/11,SouthCarolina,1.13,217013,79944,4374,141288,36165,3278,Spring,358301,116109,7652,False
2018,03/04,SouthCarolina,1.16,213096,71897,3953,119609,45130,3710,Spring,332705,117027,7663,False
2018,02/25,SouthCarolina,1.25,178666,70216,3960,119270,30146,3428,Winter,297936,100362,7388,False
2018,02/18,SouthCarolina,1.2,173173,65055,3355,115741,35864,3780,Winter,288914,100919,7135,False
2018,02/11,SouthCarolina,1.05,213633,65654,3577,126052,40667,3220,Winter,339685,106321,6797,False
2018,02/04,SouthCarolina,0.96,304189,97949,4065,200563,68207,3258,Winter,504752,166156,7323,False
2018,01/28,SouthCarolina,1.22,209197,72212,3511,109267,38526,2774,Winter,318464,110738,6285,False
2018,01/21,SouthCarolina,1.1,234534,77898,3486,138219,49325,2788,Winter,372753,127223,6274,False
2018,01/14,SouthCarolina,1.24,190128,82399,3424,105934,39865,2167,Winter,296062,122264,5591,False
2018,01/07,SouthCarolina,1.19,201490,64214,3089,104998,26809,2316,Winter,306488,91023,5405,False
2018,03/25,Spokane,1.15,23281,29539,544,22506,23986,125,Spring,45787,53525,669,False
2018,03/18,Spokane,1.17,21145,26680,594,30325,19483,100,Spring,51470,46163,694,False
2018,03/11,Spokane,1.3,20810,22874,509,25921,12329,41,Spring,46731,35203,550,False
2018,03/04,Spokane,1.19,21571,26446,559,20795,25368,63,Spring,42366,51814,622,False
2018,02/25,Spokane,1.16,21800,24410,555,21906,28350,97,Winter,43706,52760,652,False
2018,02/18,Spokane,1.28,21659,22242,495,24328,10453,43,Winter,45987,32695,538,False
2018,02/11,Spokane,1.16,25569,24035,453,21460,23406,87,Winter,47029,47441,540,False
2018,02/04,Spokane,0.98,36203,49563,560,21807,33030,197,Winter,58010,82593,757,False
2018,01/28,Spokane,1.16,25211,28636,406,23389,10519,33,Winter,48600,39155,439,False
2018,01/21,Spokane,1.07,24435,33395,517,22478,24044,133,Winter,46913,57439,650,False
2018,01/14,Spokane,1.2,25067,30621,483,22425,23850,88,Winter,47492,54471,571,False
2018,01/07,Spokane,1.18,27224,21852,487,27270,8169,23,Winter,54494,30021,510,False
2018,03/25,StLouis,1.25,80921,7515,518,65742,10499,11,Spring,146663,18014,529,False
2018,03/18,StLouis,1.07,90217,6557,418,85441,8175,450,Spring,175658,14732,868,False
2018,03/11,StLouis,1.02,119801,6013,404,99130,19950,4144,Spring,218931,25963,4548,False
2018,03/04,StLouis,1.32,67717,9189,437,69210,16517,8978,Spring,136927,25706,9415,False
2018,02/25,StLouis,1.29,91834,12327,470,70052,14017,125,Winter,161886,26344,595,False
2018,02/18,StLouis,1.22,100935,7745,388,46000,17776,0,Winter,146935,25521,388,False
2018,02/11,StLouis,1.15,80260,6205,372,67859,19908,0,Winter,148119,26113,372,False
2018,02/04,StLouis,0.9,174119,7272,456,114234,26591,0,Winter,288353,33863,456,False
2018,01/28,StLouis,1.24,97083,7111,464,81101,22724,0,Winter,178184,29835,464,False
2018,01/21,StLouis,1.05,98471,7427,582,123950,26817,0,Winter,222421,34244,582,False
2018,01/14,StLouis,1.36,76981,12192,419,65370,16227,0,Winter,142351,28419,419,False
2018,01/07,StLouis,1.34,93054,13758,541,53120,11395,0,Winter,146174,25153,541,False
2018,03/25,Syracuse,1.38,10004,57087,102,11836,14931,0,Spring,21840,72018,102,False
2018,03/18,Syracuse,1.2,8952,33509,83,9185,20001,0,Spring,18137,53510,83,False
2018,03/11,Syracuse,1.12,9823,45835,107,20163,14891,1,Spring,29986,60726,108,False
2018,03/04,Syracuse,1.1,7365,50900,81,9960,21393,0,Spring,17325,72293,81,False
2018,02/25,Syracuse,1.24,7676,31987,94,20766,8363,0,Winter,28442,40350,94,False
2018,02/18,Syracuse,1.3,5423,33613,74,16019,10625,0,Winter,21442,44238,74,False
2018,02/11,Syracuse,1.3,8860,46499,87,12967,9807,0,Winter,21827,56306,87,False
2018,02/04,Syracuse,1.15,5795,77127,87,7708,22305,0,Winter,13503,99432,87,False
2018,01/28,Syracuse,1.34,3345,42297,62,5723,21890,0,Winter,9068,64187,62,False
2018,01/21,Syracuse,1.45,3424,55184,81,11894,14409,0,Winter,15318,69593,81,False
2018,01/14,Syracuse,1.31,3452,45825,72,14827,15188,0,Winter,18279,61013,72,False
2018,01/07,Syracuse,1.21,3687,46420,60,5075,13694,0,Winter,8762,60114,60,False
2018,03/25,Tampa,1.33,289527,33226,1342,87355,57643,206,Spring,376882,90869,1548,False
2018,03/18,Tampa,1.13,372785,43017,1301,93201,63924,150,Spring,465986,106941,1451,False
2018,03/11,Tampa,1.16,372746,45277,1442,92677,68493,133,Spring,465423,113770,1575,False
2018,03/04,Tampa,1.14,372631,48784,1465,88569,85746,153,Spring,461200,134530,1618,False
2018,02/25,Tampa,1.3,308452,39379,1251,96039,39654,100,Winter,404491,79033,1351,False
2018,02/18,Tampa,1.33,274990,33938,1121,82223,49809,123,Winter,357213,83747,1244,False
2018,02/11,Tampa,1.0,364195,46814,1035,82780,74593,123,Winter,446975,121407,1158,False
2018,02/04,Tampa,0.98,564685,79267,1096,91618,116804,170,Winter,656303,196071,1266,False
2018,01/28,Tampa,1.36,294233,36783,958,77554,51622,26,Winter,371787,88405,984,False
2018,01/21,Tampa,1.17,375284,50138,1076,76281,74392,0,Winter,451565,124530,1076,False
2018,01/14,Tampa,1.41,286535,36727,1153,76263,45949,0,Winter,362798,82676,1153,False
2018,01/07,Tampa,1.2,317536,44226,1046,68969,52215,13,Winter,386505,96441,1059,False
2018,03/25,WestTexNewMexico,0.84,438526,199585,11017,153009,160999,2046,Spring,591535,360584,13063,False
2018,03/18,WestTexNewMexico,0.88,457635,137597,8422,151191,98535,1868,Spring,608826,236132,10290,False
2018,03/11,WestTexNewMexico,0.94,467501,154130,11380,152380,110322,1891,Spring,619881,264452,13271,False
2018,03/04,WestTexNewMexico,0.88,454269,164856,9907,164965,138399,3535,Spring,619234,303255,13442,False
2018,02/25,WestTexNewMexico,0.88,431217,171532,10590,125973,147040,9317,Winter,557190,318572,19907,False
2018,02/18,WestTexNewMexico,0.89,421321,191798,10065,130348,140202,3072,Winter,551669,332000,13137,False
2018,02/11,WestTexNewMexico,0.75,544075,189862,7194,113338,215753,1727,Winter,657413,405615,8921,False
2018,02/04,WestTexNewMexico,0.76,531469,368948,13078,127833,229786,925,Winter,659302,598734,14003,False
2018,01/28,WestTexNewMexico,0.85,479147,179489,7314,143430,147376,326,Winter,622577,326865,7640,False
2018,01/21,WestTexNewMexico,0.84,505263,177911,9468,118978,209131,160,Winter,624241,387042,9628,False
2018,01/14,WestTexNewMexico,0.9,463945,188126,11227,125408,162040,206,Winter,589353,350166,11433,False
2018,01/07,WestTexNewMexico,0.88,436282,178669,9467,99686,155870,290,Winter,535968,334539,9757,False
2015,12/27,Albany,1.83,8,88,0,892,0,0,Winter,900,88,0,True
2015,12/20,Albany,1.89,30,172,0,960,0,0,Winter,990,172,0,True
2015,12/13,Albany,1.85,10,178,0,806,0,0,Winter,816,178,0,True
2015,12/06,Albany,1.84,90,104,0,948,15,0,Winter,1038,119,0,True
2015,11/29,Albany,1.94,0,94,0,736,0,0,Fall,736,94,0,True
2015,11/22,Albany,1.94,13,84,0,755,5,0,Fall,768,89,0,True
2015,11/15,Albany,1.89,20,238,0,949,0,0,Fall,969,238,0,True
2015,11/08,Albany,1.88,20,351,0,960,0,0,Fall,980,351,0,True
2015,11/01,Albany,1.88,11,137,0,872,0,0,Fall,883,137,0,True
2015,10/25,Albany,1.83,49,148,0,963,0,0,Fall,1012,148,0,True
2015,10/18,Albany,1.97,10,158,0,800,0,0,Fall,810,158,0,True
2015,10/11,Albany,1.9,28,88,0,1035,17,0,Fall,1063,105,0,True
2015,10/04,Albany,1.98,5,165,0,964,10,0,Fall,969,175,0,True
2015,09/27,Albany,1.98,13,140,0,660,0,0,Fall,673,140,0,True
2015,09/20,Albany,1.98,42,228,0,503,0,0,Fall,545,228,0,True
2015,09/13,Albany,1.99,13,105,0,783,0,0,Fall,796,105,0,True
2015,09/06,Albany,1.86,30,96,0,1042,0,0,Fall,1072,96,0,True
2015,08/30,Albany,1.88,17,65,0,1156,0,0,Summer,1173,65,0,True
2015,08/23,Albany,1.87,24,97,0,1153,0,0,Summer,1177,97,0,True
2015,08/16,Albany,2.0,24,168,0,1274,0,0,Summer,1298,168,0,True
2015,08/09,Albany,1.88,79,106,0,1234,0,0,Summer,1313,106,0,True
2015,08/02,Albany,2.0,17,103,0,1102,0,0,Summer,1119,103,0,True
2015,07/26,Albany,2.01,99,165,0,1184,0,0,Summer,1283,165,0,True
2015,07/19,Albany,2.08,50,112,0,913,0,0,Summer,963,112,0,True
2015,07/12,Albany,2.01,34,92,0,1048,0,0,Summer,1082,92,0,True
2015,07/05,Albany,2.04,50,183,0,1338,0,0,Summer,1388,183,0,True
2015,06/28,Albany,2.02,22,124,0,1053,0,0,Summer,1075,124,0,True
2015,06/21,Albany,2.09,17,107,0,928,0,0,Summer,945,107,0,True
2015,06/14,Albany,2.03,79,211,0,1251,0,0,Summer,1330,211,0,True
2015,06/07,Albany,1.93,25,125,0,1395,0,0,Summer,1420,125,0,True
2015,05/31,Albany,1.9,82,105,0,1564,0,0,Spring,1646,105,0,True
2015,05/24,Albany,1.93,24,183,0,1421,0,0,Spring,1445,183,0,True
2015,05/17,Albany,1.87,19,213,0,1648,0,0,Spring,1667,213,0,True
2015,05/10,Albany,1.98,46,523,0,1546,0,0,Spring,1592,523,0,True
2015,05/03,Albany,2.03,57,130,0,1610,0,0,Spring,1667,130,0,True
2015,04/26,Albany,1.9,27,30,0,872,0,0,Spring,899,30,0,True
2015,04/19,Albany,1.96,18,102,0,1395,0,0,Spring,1413,102,0,True
2015,04/12,Albany,1.76,51,93,0,1489,0,0,Spring,1540,93,0,True
2015,04/05,Albany,1.93,15,202,0,1307,0,0,Spring,1322,202,0,True
2015,03/29,Albany,1.93,24,173,0,884,0,0,Spring,908,173,0,True
2015,03/22,Albany,1.86,40,326,0,1007,0,0,Spring,1047,326,0,True
2015,03/15,Albany,1.79,19,164,0,1289,0,0,Spring,1308,164,0,True
2015,03/08,Albany,1.79,49,331,0,1245,0,0,Spring,1294,331,0,True
2015,03/01,Albany,1.76,32,105,0,1525,0,0,Spring,1557,105,0,True
2015,02/22,Albany,1.82,11,31,0,1109,0,0,Winter,1120,31,0,True
2015,02/15,Albany,1.81,22,83,0,1076,0,0,Winter,1098,83,0,True
2015,02/08,Albany,1.59,27,152,0,1590,0,0,Winter,1617,152,0,True
2015,02/01,Albany,1.83,33,99,0,1096,0,0,Winter,1129,99,0,True
2015,01/25,Albany,1.89,14,148,0,952,0,0,Winter,966,148,0,True
2015,01/18,Albany,1.93,8,178,0,931,0,0,Winter,939,178,0,True
2015,01/11,Albany,1.77,39,305,0,838,0,0,Winter,877,305,0,True
2015,01/04,Albany,1.79,57,153,0,1162,0,0,Winter,1219,153,0,True
2015,12/27,Atlanta,1.84,1366,1652,0,103,72,0,Winter,1469,1724,0,True
2015,12/20,Atlanta,1.89,2000,1925,0,36,10,0,Winter,2036,1935,0,True
2015,12/13,Atlanta,1.78,1589,1581,0,208,231,0,Winter,1797,1812,0,True
2015,12/06,Atlanta,1.48,1358,1735,0,130,1175,0,Winter,1488,2910,0,True
2015,11/29,Atlanta,1.37,1340,2104,0,103,1657,0,Fall,1443,3761,0,True
2015,11/22,Atlanta,1.88,1766,2096,0,70,83,0,Fall,1836,2179,0,True
2015,11/15,Atlanta,1.85,1643,1661,0,470,113,0,Fall,2113,1774,0,True
2015,11/08,Atlanta,1.74,1904,2047,0,843,521,0,Fall,2747,2568,0,True
2015,11/01,Atlanta,1.79,2074,2536,0,290,544,0,Fall,2364,3080,0,True
2015,10/25,Atlanta,1.87,2441,2684,0,180,170,0,Fall,2621,2854,0,True
2015,10/18,Atlanta,1.94,2169,2870,0,63,555,0,Fall,2232,3425,0,True
2015,10/11,Atlanta,1.75,2387,3377,0,0,1514,0,Fall,2387,4891,0,True
2015,10/04,Atlanta,1.79,2743,3550,0,0,1129,0,Fall,2743,4679,0,True
2015,09/27,Atlanta,2.01,2232,3021,0,0,139,0,Fall,2232,3160,0,True
2015,09/20,Atlanta,2.04,2378,3304,0,0,22,0,Fall,2378,3326,0,True
2015,09/13,Atlanta,2.0,2340,3395,0,11,144,0,Fall,2351,3539,0,True
2015,09/06,Atlanta,1.98,2522,3851,0,147,214,0,Fall,2669,4065,0,True
2015,08/30,Atlanta,1.53,2349,3534,0,1577,1836,0,Summer,3926,5370,0,True
2015,08/23,Atlanta,1.52,2493,3862,0,1841,2144,0,Summer,4334,6006,0,True
2015,08/16,Atlanta,1.83,1953,3335,0,1087,250,0,Summer,3040,3585,0,True
2015,08/09,Atlanta,2.01,2291,2855,0,49,383,0,Summer,2340,3238,0,True
2015,08/02,Atlanta,1.8,1981,2627,0,277,905,0,Summer,2258,3532,0,True
2015,07/26,Atlanta,1.56,2286,2468,0,1537,1595,0,Summer,3823,4063,0,True
2015,07/19,Atlanta,1.29,1571,2221,0,1001,2846,0,Summer,2572,5067,0,True
2015,07/12,Atlanta,1.6,1501,2208,0,608,1627,0,Summer,2109,3835,0,True
2015,07/05,Atlanta,1.5,1577,2748,0,0,1418,0,Summer,1577,4166,0,True
2015,06/28,Atlanta,1.39,1896,2306,0,0,2109,0,Summer,1896,4415,0,True
2015,06/21,Atlanta,1.83,1804,2660,0,0,537,0,Summer,1804,3197,0,True
2015,06/14,Atlanta,1.85,1646,2236,0,2,599,0,Summer,1648,2835,0,True
2015,06/07,Atlanta,1.74,1467,1864,0,147,616,0,Summer,1614,2480,0,True
2015,05/31,Atlanta,1.84,1744,2484,0,97,475,0,Spring,1841,2959,0,True
2015,05/24,Atlanta,1.74,1705,2707,0,119,932,0,Spring,1824,3639,0,True
2015,05/17,Atlanta,1.78,2076,2105,0,122,853,0,Spring,2198,2958,0,True
2015,05/10,Atlanta,1.82,1878,2479,0,0,710,0,Spring,1878,3189,0,True
2015,05/03,Atlanta,2.03,1325,2650,0,0,0,0,Spring,1325,2650,0,True
2015,04/26,Atlanta,2.01,1627,2751,0,0,67,0,Spring,1627,2818,0,True
2015,04/19,Atlanta,1.63,1820,4094,0,772,17,0,Spring,2592,4111,0,True
2015,04/12,Atlanta,1.79,1899,4739,0,40,8,0,Spring,1939,4747,0,True
2015,04/05,Atlanta,1.74,1595,3073,0,40,849,0,Spring,1635,3922,0,True
2015,03/29,Atlanta,1.88,2016,2847,0,40,172,0,Spring,2056,3019,0,True
2015,03/22,Atlanta,1.62,1891,4197,0,0,395,0,Spring,1891,4592,0,True
2015,03/15,Atlanta,1.19,2004,9249,0,0,2731,0,Spring,2004,11980,0,True
2015,03/08,Atlanta,1.22,1579,11705,0,0,2742,0,Spring,1579,14447,0,True
2015,03/01,Atlanta,1.22,1683,12002,0,0,2541,0,Spring,1683,14543,0,True
2015,02/22,Atlanta,1.38,1780,7973,0,83,1132,0,Winter,1863,9105,0,True
2015,02/15,Atlanta,1.46,1449,5216,0,700,417,0,Winter,2149,5633,0,True
2015,02/08,Atlanta,1.29,1716,8656,0,1316,1599,0,Winter,3032,10255,0,True
2015,02/01,Atlanta,1.44,1565,4210,0,1133,756,0,Winter,2698,4966,0,True
2015,01/25,Atlanta,1.87,1578,735,0,533,200,0,Winter,2111,935,0,True
2015,01/18,Atlanta,1.86,2138,989,0,1019,146,0,Winter,3157,1135,0,True
2015,01/11,Atlanta,1.84,1613,1207,0,865,57,0,Winter,2478,1264,0,True
2015,01/04,Atlanta,1.76,1500,938,0,1071,336,0,Winter,2571,1274,0,True
2015,12/27,BaltimoreWashington,1.51,363,5263,318,2247,6008,0,Winter,2610,11271,318,True
2015,12/20,BaltimoreWashington,1.67,504,4702,419,1424,2246,0,Winter,1928,6948,419,True
2015,12/13,BaltimoreWashington,1.72,550,4510,337,2920,4084,0,Winter,3470,8594,337,True
2015,12/06,BaltimoreWashington,1.46,432,4364,444,715,3760,0,Winter,1147,8124,444,True
2015,11/29,BaltimoreWashington,1.32,536,5920,432,327,3744,0,Fall,863,9664,432,True
2015,11/22,BaltimoreWashington,1.39,587,6336,460,602,1590,0,Fall,1189,7926,460,True
2015,11/15,BaltimoreWashington,1.64,1133,4772,458,480,38,0,Fall,1613,4810,458,True
2015,11/08,BaltimoreWashington,1.65,2700,2975,566,846,69,0,Fall,3546,3044,566,True
2015,11/01,BaltimoreWashington,1.6,3323,4105,687,935,368,0,Fall,4258,4473,687,True
2015,10/25,BaltimoreWashington,1.59,998,6750,768,926,1778,0,Fall,1924,8528,768,True
2015,10/18,BaltimoreWashington,1.54,772,6014,685,913,1830,0,Fall,1685,7844,685,True
2015,10/11,BaltimoreWashington,1.53,459,5639,597,1033,1722,0,Fall,1492,7361,597,True
2015,10/04,BaltimoreWashington,1.63,451,6092,667,1646,0,0,Fall,2097,6092,667,True
2015,09/27,BaltimoreWashington,1.7,429,4774,616,1720,11,0,Fall,2149,4785,616,True
2015,09/20,BaltimoreWashington,1.35,1462,6346,519,2818,2,0,Fall,4280,6348,519,True
2015,09/13,BaltimoreWashington,1.6,1450,5418,698,4202,2,0,Fall,5652,5420,698,True
2015,09/06,BaltimoreWashington,1.58,2634,5041,717,5977,8,0,Fall,8611,5049,717,True
2015,08/30,BaltimoreWashington,1.6,2524,5164,715,4219,2,0,Summer,6743,5166,715,True
2015,08/23,BaltimoreWashington,1.72,4288,3541,635,3087,2,0,Summer,7375,3543,635,True
2015,08/16,BaltimoreWashington,1.75,4472,3521,864,1404,16,0,Summer,5876,3537,864,True
2015,08/09,BaltimoreWashington,1.66,3946,4109,836,4225,13,0,Summer,8171,4122,836,True
2015,08/02,BaltimoreWashington,1.72,3887,3335,719,3983,10,0,Summer,7870,3345,719,True
2015,07/26,BaltimoreWashington,1.72,3682,3166,599,1050,2,0,Summer,4732,3168,599,True
2015,07/19,BaltimoreWashington,1.81,2230,2168,649,3620,0,0,Summer,5850,2168,649,True
2015,07/12,BaltimoreWashington,1.7,4829,2707,759,607,0,0,Summer,5436,2707,759,True
2015,07/05,BaltimoreWashington,1.69,6639,3113,902,1824,0,0,Summer,8463,3113,902,True
2015,06/28,BaltimoreWashington,1.7,5562,2728,882,2545,0,0,Summer,8107,2728,882,True
2015,06/21,BaltimoreWashington,1.69,5224,2873,713,2122,5,0,Summer,7346,2878,713,True
2015,06/14,BaltimoreWashington,1.61,5819,2943,956,4199,5,0,Summer,10018,2948,956,True
2015,06/07,BaltimoreWashington,1.71,5560,3115,1042,4076,13,0,Summer,9636,3128,1042,True
2015,05/31,BaltimoreWashington,1.69,5802,3268,1060,2505,2,0,Spring,8307,3270,1060,True
2015,05/24,BaltimoreWashington,1.69,6716,3800,993,5531,0,0,Spring,12247,3800,993,True
2015,05/17,BaltimoreWashington,1.42,6094,7358,3915,5101,0,0,Spring,11195,7358,3915,True
2015,05/10,BaltimoreWashington,1.7,6023,2924,1128,4414,7,0,Spring,10437,2931,1128,True
2015,05/03,BaltimoreWashington,1.66,6666,3755,1163,4806,3,0,Spring,11472,3758,1163,True
2015,04/26,BaltimoreWashington,1.7,6339,3106,815,3202,3,0,Spring,9541,3109,815,True
2015,04/19,BaltimoreWashington,1.64,8223,3998,865,2765,0,0,Spring,10988,3998,865,True
2015,04/12,BaltimoreWashington,1.66,7671,3634,864,3822,7,0,Spring,11493,3641,864,True
2015,04/05,BaltimoreWashington,1.63,8144,3199,708,2499,0,0,Spring,10643,3199,708,True
2015,03/29,BaltimoreWashington,1.63,7578,3597,786,3884,0,0,Spring,11462,3597,786,True
2015,03/22,BaltimoreWashington,1.25,10883,4512,758,352,0,0,Spring,11235,4512,758,True
2015,03/15,BaltimoreWashington,1.59,6527,3390,745,923,0,0,Spring,7450,3390,745,True
2015,03/08,BaltimoreWashington,1.56,6590,3908,745,7809,0,0,Spring,14399,3908,745,True
2015,03/01,BaltimoreWashington,1.58,7386,4112,732,3659,31,0,Spring,11045,4143,732,True
2015,02/22,BaltimoreWashington,1.19,12844,5815,667,4593,0,0,Winter,17437,5815,667,True
2015,02/15,BaltimoreWashington,1.56,5709,3782,777,6065,0,0,Winter,11774,3782,777,True
2015,02/08,BaltimoreWashington,1.43,6050,4361,745,3739,2,0,Winter,9789,4363,745,True
2015,02/01,BaltimoreWashington,1.15,14635,8013,667,4613,0,0,Winter,19248,8013,667,True
2015,01/25,BaltimoreWashington,1.41,8097,5023,528,1738,0,0,Winter,9835,5023,528,True
2015,01/18,BaltimoreWashington,1.41,8148,4725,659,461,61,0,Winter,8609,4786,659,True
2015,01/11,BaltimoreWashington,1.22,12258,7094,490,6165,0,0,Winter,18423,7094,490,True
2015,01/04,BaltimoreWashington,1.29,8040,6557,657,3881,0,0,Winter,11921,6557,657,True
2015,12/27,Boise,0.91,15,508,0,1008,740,0,Winter,1023,1248,0,True
2015,12/20,Boise,1.17,10,409,0,689,698,0,Winter,699,1107,0,True
2015,12/13,Boise,0.87,26,738,2,1147,2139,0,Winter,1173,2877,2,True
2015,12/06,Boise,1.36,11,533,0,73,668,0,Winter,84,1201,0,True
2015,11/29,Boise,1.34,2,418,0,20,606,0,Fall,22,1024,0,True
2015,11/22,Boise,1.54,7,724,2,13,252,0,Fall,20,976,2,True
2015,11/15,Boise,1.78,17,538,0,140,185,0,Fall,157,723,0,True
2015,11/08,Boise,1.5,12,732,0,43,270,0,Fall,55,1002,0,True
2015,11/01,Boise,1.16,2,1411,3,257,1092,0,Fall,259,2503,3,True
2015,10/25,Boise,1.95,14,690,3,220,177,0,Fall,234,867,3,True
2015,10/18,Boise,2.05,10,836,0,116,205,0,Fall,126,1041,0,True
2015,10/11,Boise,1.95,9,1160,0,0,227,0,Fall,9,1387,0,True
2015,10/04,Boise,1.83,11,1456,0,0,334,0,Fall,11,1790,0,True
2015,09/27,Boise,2.02,17,822,0,16,280,0,Fall,33,1102,0,True
2015,09/20,Boise,1.93,19,723,0,16,197,0,Fall,35,920,0,True
2015,09/13,Boise,2.28,10,856,0,123,6,0,Fall,133,862,0,True
2015,09/06,Boise,2.35,9,813,0,3,82,0,Fall,12,895,0,True
2015,08/30,Boise,1.47,8,2789,0,76,228,0,Summer,84,3017,0,True
2015,08/23,Boise,2.29,7,794,0,33,102,0,Summer,40,896,0,True
2015,08/16,Boise,1.69,5,1894,0,86,663,0,Summer,91,2557,0,True
2015,08/09,Boise,1.91,21,1098,0,353,183,0,Summer,374,1281,0,True
2015,08/02,Boise,2.15,12,972,0,136,74,0,Summer,148,1046,0,True
2015,07/26,Boise,2.08,26,1201,0,203,124,0,Summer,229,1325,0,True
2015,07/19,Boise,1.45,37,2527,0,203,335,0,Summer,240,2862,0,True
2015,07/12,Boise,2.05,7,1091,0,230,125,0,Summer,237,1216,0,True
2015,07/05,Boise,2.18,11,1359,0,203,20,0,Summer,214,1379,0,True
2015,06/28,Boise,1.58,15,2464,0,70,0,0,Summer,85,2464,0,True
2015,06/21,Boise,1.49,6,1657,0,123,134,0,Summer,129,1791,0,True
2015,06/14,Boise,2.18,19,1161,0,206,14,0,Summer,225,1175,0,True
2015,06/07,Boise,2.24,2,1262,0,116,0,0,Summer,118,1262,0,True
2015,05/31,Boise,1.54,19,2374,0,300,0,0,Spring,319,2374,0,True
2015,05/24,Boise,1.97,45,1108,0,100,21,0,Spring,145,1129,0,True
2015,05/17,Boise,1.92,22,1010,0,86,58,0,Spring,108,1068,0,True
2015,05/10,Boise,1.71,25,959,0,123,296,0,Spring,148,1255,0,True
2015,05/03,Boise,1.55,22,737,0,210,433,0,Spring,232,1170,0,True
2015,04/26,Boise,1.36,9,1579,0,203,362,0,Spring,212,1941,0,True
2015,04/19,Boise,1.69,5,1138,0,156,153,0,Spring,161,1291,0,True
2015,04/12,Boise,1.41,5,3290,0,43,468,0,Spring,48,3758,0,True
2015,04/05,Boise,1.83,6,1216,0,296,182,0,Spring,302,1398,0,True
2015,03/29,Boise,1.52,8,3776,0,116,31,0,Spring,124,3807,0,True
2015,03/22,Boise,1.51,1,3429,0,50,90,0,Spring,51,3519,0,True
2015,03/15,Boise,1.63,0,1209,0,366,200,0,Spring,366,1409,0,True
2015,03/08,Boise,1.5,9,3799,0,253,251,0,Spring,262,4050,0,True
2015,03/01,Boise,1.68,2,945,0,393,55,0,Spring,395,1000,0,True
2015,02/22,Boise,1.75,1,813,0,260,6,0,Winter,261,819,0,True
2015,02/15,Boise,1.62,11,891,0,166,239,0,Winter,177,1130,0,True
2015,02/08,Boise,1.35,13,2832,0,323,701,0,Winter,336,3533,0,True
2015,02/01,Boise,1.43,0,999,0,283,498,0,Winter,283,1497,0,True
2015,01/25,Boise,1.82,1,858,0,133,181,0,Winter,134,1039,0,True
2015,01/18,Boise,1.44,8,2513,0,143,308,0,Winter,151,2821,0,True
2015,01/11,Boise,1.44,0,1923,0,170,285,0,Winter,170,2208,0,True
2015,01/04,Boise,1.64,1,1129,0,186,187,0,Winter,187,1316,0,True
2015,12/27,Boston,1.48,9,775,39,7149,10,0,Winter,7158,785,39,True
2015,12/20,Boston,1.41,26,511,61,7340,0,0,Winter,7366,511,61,True
2015,12/13,Boston,1.55,18,434,251,7848,10,0,Winter,7866,444,251,True
2015,12/06,Boston,1.29,37,466,0,7781,0,0,Winter,7818,466,0,True
2015,11/29,Boston,1.28,11,388,0,6470,0,0,Fall,6481,388,0,True
2015,11/22,Boston,1.27,71,394,0,7202,0,0,Fall,7273,394,0,True
2015,11/15,Boston,1.15,6,534,0,8232,5,0,Fall,8238,539,0,True
2015,11/08,Boston,1.22,13,486,0,6990,16,0,Fall,7003,502,0,True
2015,11/01,Boston,1.3,14,574,0,6093,482,0,Fall,6107,1056,0,True
2015,10/25,Boston,1.27,11,407,0,6608,1444,0,Fall,6619,1851,0,True
2015,10/18,Boston,1.26,19,488,0,6387,90,0,Fall,6406,578,0,True
2015,10/11,Boston,1.26,12,386,0,7299,0,0,Fall,7311,386,0,True
2015,10/04,Boston,1.28,14,647,0,7524,0,0,Fall,7538,647,0,True
2015,09/27,Boston,2.0,15,758,0,1249,0,0,Fall,1264,758,0,True
2015,09/20,Boston,2.01,16,1123,0,1483,0,0,Fall,1499,1123,0,True
2015,09/13,Boston,2.0,13,1299,0,1970,0,0,Fall,1983,1299,0,True
2015,09/06,Boston,1.97,57,1242,0,2043,0,0,Fall,2100,1242,0,True
2015,08/30,Boston,2.03,20,1081,0,1531,0,0,Summer,1551,1081,0,True
2015,08/23,Boston,2.0,41,1201,0,1837,0,0,Summer,1878,1201,0,True
2015,08/16,Boston,2.09,297,1041,0,1356,0,0,Summer,1653,1041,0,True
2015,08/09,Boston,2.02,185,1066,0,1703,0,0,Summer,1888,1066,0,True
2015,08/02,Boston,2.12,116,1353,0,1887,0,0,Summer,2003,1353,0,True
2015,07/26,Boston,2.02,99,1956,0,1304,6,0,Summer,1403,1962,0,True
2015,07/19,Boston,2.05,18,2152,0,1217,0,0,Summer,1235,2152,0,True
2015,07/12,Boston,2.19,19,1646,0,1097,0,0,Summer,1116,1646,0,True
2015,07/05,Boston,2.13,2,1530,0,1603,0,0,Summer,1605,1530,0,True
2015,06/28,Boston,2.03,13,1625,0,1406,0,0,Summer,1419,1625,0,True
2015,06/21,Boston,2.06,82,1124,0,1455,0,0,Summer,1537,1124,0,True
2015,06/14,Boston,2.03,71,1018,0,1852,0,0,Summer,1923,1018,0,True
2015,06/07,Boston,2.0,67,1199,0,2373,0,0,Summer,2440,1199,0,True
2015,05/31,Boston,1.94,45,1123,0,3066,0,0,Spring,3111,1123,0,True
2015,05/24,Boston,1.94,28,1052,0,2427,0,0,Spring,2455,1052,0,True
2015,05/17,Boston,1.91,54,1651,0,2661,0,0,Spring,2715,1651,0,True
2015,05/10,Boston,2.02,76,1275,0,2077,0,0,Spring,2153,1275,0,True
2015,05/03,Boston,1.82,20,1934,0,2167,0,0,Spring,2187,1934,0,True
2015,04/26,Boston,1.86,4,956,0,2556,0,0,Spring,2560,956,0,True
2015,04/19,Boston,1.94,13,912,0,1770,0,0,Spring,1783,912,0,True
2015,04/12,Boston,1.86,44,915,0,2658,0,0,Spring,2702,915,0,True
2015,04/05,Boston,1.91,75,932,0,2194,0,0,Spring,2269,932,0,True
2015,03/29,Boston,1.98,22,745,0,1314,40,0,Spring,1336,785,0,True
2015,03/22,Boston,1.94,6,1119,0,1627,10,0,Spring,1633,1129,0,True
2015,03/15,Boston,1.99,19,904,0,1042,0,0,Spring,1061,904,0,True
2015,03/08,Boston,1.91,29,945,0,1592,0,0,Spring,1621,945,0,True
2015,03/01,Boston,1.85,8,932,0,2083,0,0,Spring,2091,932,0,True
2015,02/22,Boston,1.74,75,1062,0,2187,0,0,Winter,2262,1062,0,True
2015,02/15,Boston,1.91,18,678,0,1574,0,0,Winter,1592,678,0,True
2015,02/08,Boston,1.91,15,948,0,2134,0,0,Winter,2149,948,0,True
2015,02/01,Boston,1.78,12,1308,0,1622,0,0,Winter,1634,1308,0,True
2015,01/25,Boston,2.01,3,760,0,1184,0,0,Winter,1187,760,0,True
2015,01/18,Boston,2.0,4,834,0,1370,0,0,Winter,1374,834,0,True
2015,01/11,Boston,1.94,12,956,0,1248,0,0,Winter,1260,956,0,True
2015,01/04,Boston,1.83,8,939,0,1244,0,0,Winter,1252,939,0,True
2015,12/27,BuffaloRochester,1.47,0,166,0,2751,2124,0,Winter,2751,2290,0,True
2015,12/20,BuffaloRochester,1.5,2,151,0,3672,1488,0,Winter,3674,1639,0,True
2015,12/13,BuffaloRochester,1.45,0,130,0,1502,2684,0,Winter,1502,2814,0,True
2015,12/06,BuffaloRochester,1.57,17,102,0,2298,126,0,Winter,2315,228,0,True
2015,11/29,BuffaloRochester,1.6,16,129,0,2096,18,0,Fall,2112,147,0,True
2015,11/22,BuffaloRochester,1.57,13,119,0,2493,0,0,Fall,2506,119,0,True
2015,11/15,BuffaloRochester,1.59,2,117,0,1731,0,0,Fall,1733,117,0,True
2015,11/08,BuffaloRochester,1.55,2,141,0,3888,0,0,Fall,3890,141,0,True
2015,11/01,BuffaloRochester,1.55,14,92,0,2631,0,0,Fall,2645,92,0,True
2015,10/25,BuffaloRochester,1.55,20,123,0,2871,6,0,Fall,2891,129,0,True
2015,10/18,BuffaloRochester,1.57,14,159,0,3160,0,0,Fall,3174,159,0,True
2015,10/11,BuffaloRochester,1.52,16,47,0,4109,2,0,Fall,4125,49,0,True
2015,10/04,BuffaloRochester,1.55,29,177,0,3240,0,0,Fall,3269,177,0,True
2015,09/27,BuffaloRochester,1.58,10,71,0,1395,0,0,Fall,1405,71,0,True
2015,09/20,BuffaloRochester,1.56,33,127,0,3130,0,0,Fall,3163,127,0,True
2015,09/13,BuffaloRochester,1.55,19,139,0,4107,0,0,Fall,4126,139,0,True
2015,09/06,BuffaloRochester,1.53,14,92,0,5176,0,0,Fall,5190,92,0,True
2015,08/30,BuffaloRochester,1.62,21,124,0,1620,5,0,Summer,1641,129,0,True
2015,08/23,BuffaloRochester,1.57,19,181,0,3478,2,0,Summer,3497,183,0,True
2015,08/16,BuffaloRochester,1.89,46,154,0,516,0,0,Summer,562,154,0,True
2015,08/09,BuffaloRochester,1.6,30,188,0,2510,13,0,Summer,2540,201,0,True
2015,08/02,BuffaloRochester,1.86,78,154,0,3115,0,0,Summer,3193,154,0,True
2015,07/26,BuffaloRochester,1.87,80,154,0,3176,2,0,Summer,3256,156,0,True
2015,07/19,BuffaloRochester,1.91,56,123,0,1549,0,0,Summer,1605,123,0,True
2015,07/12,BuffaloRochester,2.02,90,103,0,417,2,0,Summer,507,105,0,True
2015,07/05,BuffaloRochester,1.91,70,149,0,1216,2,0,Summer,1286,151,0,True
2015,06/28,BuffaloRochester,1.83,49,125,0,3388,3,0,Summer,3437,128,0,True
2015,06/21,BuffaloRochester,1.9,56,126,0,953,51,0,Summer,1009,177,0,True
2015,06/14,BuffaloRochester,1.83,71,137,0,3227,0,0,Summer,3298,137,0,True
2015,06/07,BuffaloRochester,1.8,45,167,0,4563,0,0,Summer,4608,167,0,True
2015,05/31,BuffaloRochester,1.79,42,173,0,4802,0,0,Spring,4844,173,0,True
2015,05/24,BuffaloRochester,1.8,33,169,0,4814,0,0,Spring,4847,169,0,True
2015,05/17,BuffaloRochester,1.79,30,196,0,4884,0,0,Spring,4914,196,0,True
2015,05/10,BuffaloRochester,1.85,32,183,0,1944,0,0,Spring,1976,183,0,True
2015,05/03,BuffaloRochester,1.81,63,168,0,3416,0,0,Spring,3479,168,0,True
2015,04/26,BuffaloRochester,1.84,29,204,0,2327,0,0,Spring,2356,204,0,True
2015,04/19,BuffaloRochester,1.83,38,156,0,2537,0,0,Spring,2575,156,0,True
2015,04/12,BuffaloRochester,1.79,30,145,0,3298,0,0,Spring,3328,145,0,True
2015,04/05,BuffaloRochester,1.8,16,131,0,2437,0,0,Spring,2453,131,0,True
2015,03/29,BuffaloRochester,1.83,13,128,0,1500,0,0,Spring,1513,128,0,True
2015,03/22,BuffaloRochester,1.93,0,147,0,383,0,0,Spring,383,147,0,True
2015,03/15,BuffaloRochester,1.79,4,130,0,577,0,0,Spring,581,130,0,True
2015,03/08,BuffaloRochester,1.56,9,94,0,2059,0,0,Spring,2068,94,0,True
2015,03/01,BuffaloRochester,1.55,17,126,0,3376,0,0,Spring,3393,126,0,True
2015,02/22,BuffaloRochester,1.53,32,92,0,5696,0,0,Winter,5728,92,0,True
2015,02/15,BuffaloRochester,1.65,12,123,0,1132,0,0,Winter,1144,123,0,True
2015,02/08,BuffaloRochester,1.54,24,115,0,3274,0,0,Winter,3298,115,0,True
2015,02/01,BuffaloRochester,1.55,18,102,0,2687,0,0,Winter,2705,102,0,True
2015,01/25,BuffaloRochester,1.6,16,90,0,1373,0,0,Winter,1389,90,0,True
2015,01/18,BuffaloRochester,1.64,91,137,0,1197,0,0,Winter,1288,137,0,True
2015,01/11,BuffaloRochester,1.59,0,143,0,1934,0,0,Winter,1934,143,0,True
2015,01/04,BuffaloRochester,1.73,0,59,0,320,0,0,Winter,320,59,0,True
2015,12/27,Charlotte,1.9,389,1416,682,460,0,0,Winter,849,1416,682,True
2015,12/20,Charlotte,1.9,326,1462,604,546,0,0,Winter,872,1462,604,True
2015,12/13,Charlotte,1.9,321,1353,527,473,44,0,Winter,794,1397,527,True
2015,12/06,Charlotte,1.95,162,1278,577,470,0,0,Winter,632,1278,577,True
2015,11/29,Charlotte,1.96,142,1404,638,425,6,0,Fall,567,1410,638,True
2015,11/22,Charlotte,1.97,234,1454,728,377,3,0,Fall,611,1457,728,True
2015,11/15,Charlotte,1.94,244,1295,828,633,0,0,Fall,877,1295,828,True
2015,11/08,Charlotte,1.91,332,1195,751,820,3,0,Fall,1152,1198,751,True
2015,11/01,Charlotte,1.92,317,1300,1100,789,0,0,Fall,1106,1300,1100,True
2015,10/25,Charlotte,1.93,342,1551,1123,833,0,0,Fall,1175,1551,1123,True
2015,10/18,Charlotte,1.97,336,1394,1143,807,0,0,Fall,1143,1394,1143,True
2015,10/11,Charlotte,1.94,253,1370,1016,974,0,0,Fall,1227,1370,1016,True
2015,10/04,Charlotte,2.06,337,1218,808,1115,0,0,Fall,1452,1218,808,True
2015,09/27,Charlotte,2.16,291,1201,867,605,0,0,Fall,896,1201,867,True
2015,09/20,Charlotte,1.97,307,1181,842,1772,0,0,Fall,2079,1181,842,True
2015,09/13,Charlotte,2.02,327,1255,928,1481,0,0,Fall,1808,1255,928,True
2015,09/06,Charlotte,2.01,250,1331,1018,1659,0,0,Fall,1909,1331,1018,True
2015,08/30,Charlotte,2.01,274,1401,1025,1501,0,0,Summer,1775,1401,1025,True
2015,08/23,Charlotte,2.06,272,1766,1193,1370,0,0,Summer,1642,1766,1193,True
2015,08/16,Charlotte,2.04,150,1496,1269,1363,0,0,Summer,1513,1496,1269,True
2015,08/09,Charlotte,1.98,374,2116,1410,1018,0,0,Summer,1392,2116,1410,True
2015,08/02,Charlotte,2.11,358,1441,1083,1093,0,0,Summer,1451,1441,1083,True
2015,07/26,Charlotte,2.08,228,1265,861,835,16,0,Summer,1063,1281,861,True
2015,07/19,Charlotte,2.05,199,1516,1018,1150,0,0,Summer,1349,1516,1018,True
2015,07/12,Charlotte,2.13,287,1458,1144,1071,0,0,Summer,1358,1458,1144,True
2015,07/05,Charlotte,2.16,278,1514,1196,679,0,0,Summer,957,1514,1196,True
2015,06/28,Charlotte,2.15,414,1740,1016,652,0,0,Summer,1066,1740,1016,True
2015,06/21,Charlotte,2.19,336,1506,1081,501,0,0,Summer,837,1506,1081,True
2015,06/14,Charlotte,2.06,325,1432,1059,1222,0,0,Summer,1547,1432,1059,True
2015,06/07,Charlotte,2.02,278,1378,1159,1553,0,0,Summer,1831,1378,1159,True
2015,05/31,Charlotte,2.14,335,1524,1348,883,0,0,Spring,1218,1524,1348,True
2015,05/24,Charlotte,2.07,405,1601,1473,1294,0,0,Spring,1699,1601,1473,True
2015,05/17,Charlotte,1.26,476,4780,4975,855,0,0,Spring,1331,4780,4975,True
2015,05/10,Charlotte,2.05,465,1282,1191,1305,0,0,Spring,1770,1282,1191,True
2015,05/03,Charlotte,1.8,265,1499,1856,1014,0,0,Spring,1279,1499,1856,True
2015,04/26,Charlotte,2.18,295,1054,1150,970,0,0,Spring,1265,1054,1150,True
2015,04/19,Charlotte,2.06,234,1311,1400,1217,0,0,Spring,1451,1311,1400,True
2015,04/12,Charlotte,2.12,255,1460,1256,898,0,0,Spring,1153,1460,1256,True
2015,04/05,Charlotte,2.08,303,1235,1127,976,0,0,Spring,1279,1235,1127,True
2015,03/29,Charlotte,1.96,267,1467,1227,530,0,0,Spring,797,1467,1227,True
2015,03/22,Charlotte,1.9,329,1603,1221,1133,0,0,Spring,1462,1603,1221,True
2015,03/15,Charlotte,1.87,205,1300,1102,1282,0,0,Spring,1487,1300,1102,True
2015,03/08,Charlotte,1.84,215,1312,1163,1451,0,0,Spring,1666,1312,1163,True
2015,03/01,Charlotte,1.9,189,1371,1099,884,0,0,Spring,1073,1371,1099,True
2015,02/22,Charlotte,1.9,198,1119,992,870,0,0,Winter,1068,1119,992,True
2015,02/15,Charlotte,1.92,219,1098,1056,751,0,0,Winter,970,1098,1056,True
2015,02/08,Charlotte,1.87,188,1382,1092,1347,0,0,Winter,1535,1382,1092,True
2015,02/01,Charlotte,1.93,210,1244,1457,644,0,0,Winter,854,1244,1457,True
2015,01/25,Charlotte,2.29,347,956,920,469,0,0,Winter,816,956,920,True
2015,01/18,Charlotte,2.15,346,744,766,840,0,0,Winter,1186,744,766,True
2015,01/11,Charlotte,2.29,155,969,832,431,0,0,Winter,586,969,832,True
2015,01/04,Charlotte,2.13,151,882,905,1025,0,0,Winter,1176,882,905,True
2015,12/27,Chicago,1.58,1064,19320,0,610,0,0,Winter,1674,19320,0,True
2015,12/20,Chicago,1.58,730,21574,0,143,3,0,Winter,873,21577,0,True
2015,12/13,Chicago,1.59,876,23109,0,73,0,0,Winter,949,23109,0,True
2015,12/06,Chicago,1.59,819,26104,0,156,0,0,Winter,975,26104,0,True
2015,11/29,Chicago,1.59,457,21677,0,33,0,0,Fall,490,21677,0,True
2015,11/22,Chicago,1.57,716,23255,0,120,3,0,Fall,836,23258,0,True
2015,11/15,Chicago,1.58,609,24890,0,260,0,0,Fall,869,24890,0,True
2015,11/08,Chicago,1.59,643,24713,0,890,0,0,Fall,1533,24713,0,True
2015,11/01,Chicago,1.6,936,23373,0,140,0,0,Fall,1076,23373,0,True
2015,10/25,Chicago,1.61,1033,21495,0,120,0,0,Fall,1153,21495,0,True
2015,10/18,Chicago,1.79,1237,18374,0,206,0,0,Fall,1443,18374,0,True
2015,10/11,Chicago,1.69,933,18480,0,106,0,0,Fall,1039,18480,0,True
2015,10/04,Chicago,1.78,787,19394,0,216,0,0,Fall,1003,19394,0,True
2015,09/27,Chicago,1.67,1213,23051,0,46,0,0,Fall,1259,23051,0,True
2015,09/20,Chicago,1.6,1188,25203,0,543,0,0,Fall,1731,25203,0,True
2015,09/13,Chicago,1.61,985,26008,0,323,9,0,Fall,1308,26017,0,True
2015,09/06,Chicago,1.61,1283,26272,0,703,9,0,Fall,1986,26281,0,True
2015,08/30,Chicago,1.6,1065,29017,0,580,0,0,Summer,1645,29017,0,True
2015,08/23,Chicago,1.61,1517,29613,0,493,0,0,Summer,2010,29613,0,True
2015,08/16,Chicago,1.62,1142,27912,0,403,0,0,Summer,1545,27912,0,True
2015,08/09,Chicago,1.62,1173,26743,0,333,3,0,Summer,1506,26746,0,True
2015,08/02,Chicago,1.59,614,26526,0,350,0,0,Summer,964,26526,0,True
2015,07/26,Chicago,1.62,401,25320,0,346,29,0,Summer,747,25349,0,True
2015,07/19,Chicago,1.65,562,18741,0,263,110,0,Summer,825,18851,0,True
2015,07/12,Chicago,1.66,253,18087,0,566,38,0,Summer,819,18125,0,True
2015,07/05,Chicago,1.67,186,18998,0,520,0,0,Summer,706,18998,0,True
2015,06/28,Chicago,1.68,576,18163,0,136,0,0,Summer,712,18163,0,True
2015,06/21,Chicago,1.82,655,15171,0,310,0,0,Summer,965,15171,0,True
2015,06/14,Chicago,1.87,502,17175,0,696,0,0,Summer,1198,17175,0,True
2015,06/07,Chicago,1.85,857,18325,0,453,0,0,Summer,1310,18325,0,True
2015,05/31,Chicago,1.85,599,17156,0,870,0,0,Spring,1469,17156,0,True
2015,05/24,Chicago,1.86,552,19632,0,680,6,0,Spring,1232,19638,0,True
2015,05/17,Chicago,1.57,201,24405,0,30,90,0,Spring,231,24495,0,True
2015,05/10,Chicago,1.47,455,23858,0,903,1928,0,Spring,1358,25786,0,True
2015,05/03,Chicago,1.51,672,26198,0,340,0,0,Spring,1012,26198,0,True
2015,04/26,Chicago,1.51,920,30398,0,613,0,0,Spring,1533,30398,0,True
2015,04/19,Chicago,1.55,614,25888,0,986,0,0,Spring,1600,25888,0,True
2015,04/12,Chicago,1.3,722,86707,0,916,0,0,Spring,1638,86707,0,True
2015,04/05,Chicago,1.65,112,20035,0,916,0,0,Spring,1028,20035,0,True
2015,03/29,Chicago,1.66,119,14605,0,820,0,0,Spring,939,14605,0,True
2015,03/22,Chicago,1.67,436,15367,0,273,0,0,Spring,709,15367,0,True
2015,03/15,Chicago,1.64,990,12767,0,1243,0,0,Spring,2233,12767,0,True
2015,03/08,Chicago,1.62,818,13266,0,2459,0,0,Spring,3277,13266,0,True
2015,03/01,Chicago,1.82,637,9823,0,1381,0,0,Spring,2018,9823,0,True
2015,02/22,Chicago,1.83,511,8648,0,1074,0,0,Winter,1585,8648,0,True
2015,02/15,Chicago,1.81,948,8233,0,1393,0,0,Winter,2341,8233,0,True
2015,02/08,Chicago,1.78,1224,6971,0,1715,0,0,Winter,2939,6971,0,True
2015,02/01,Chicago,1.52,1363,11835,0,1192,0,0,Winter,2555,11835,0,True
2015,01/25,Chicago,1.83,711,9515,0,724,0,0,Winter,1435,9515,0,True
2015,01/18,Chicago,1.81,1154,10830,0,514,0,0,Winter,1668,10830,0,True
2015,01/11,Chicago,1.79,1426,10900,0,588,0,0,Winter,2014,10900,0,True
2015,01/04,Chicago,1.49,1189,15628,0,905,0,0,Winter,2094,15628,0,True
2015,12/27,CincinnatiDayton,1.43,249,5919,0,266,652,0,Winter,515,6571,0,True
2015,12/20,CincinnatiDayton,1.47,303,6449,0,173,187,0,Winter,476,6636,0,True
2015,12/13,CincinnatiDayton,1.32,307,6153,0,440,1798,0,Winter,747,7951,0,True
2015,12/06,CincinnatiDayton,1.48,234,7004,0,663,754,0,Winter,897,7758,0,True
2015,11/29,CincinnatiDayton,1.5,284,6272,0,263,370,0,Fall,547,6642,0,True
2015,11/22,CincinnatiDayton,1.36,336,7558,0,193,573,0,Fall,529,8131,0,True
2015,11/15,CincinnatiDayton,1.2,338,7249,0,286,1021,0,Fall,624,8270,0,True
2015,11/08,CincinnatiDayton,1.3,339,7705,0,420,1942,0,Fall,759,9647,0,True
2015,11/01,CincinnatiDayton,1.61,287,7556,0,326,1328,0,Fall,613,8884,0,True
2015,10/25,CincinnatiDayton,1.56,416,8846,0,463,800,0,Fall,879,9646,0,True
2015,10/18,CincinnatiDayton,1.5,259,9299,0,293,2170,0,Fall,552,11469,0,True
2015,10/11,CincinnatiDayton,1.66,304,8500,0,443,611,0,Fall,747,9111,0,True
2015,10/04,CincinnatiDayton,1.54,341,8519,0,303,1067,0,Fall,644,9586,0,True
2015,09/27,CincinnatiDayton,1.46,329,9461,0,96,621,0,Fall,425,10082,0,True
2015,09/20,CincinnatiDayton,1.58,379,12416,0,43,75,0,Fall,422,12491,0,True
2015,09/13,CincinnatiDayton,1.59,458,12290,0,460,1239,0,Fall,918,13529,0,True
2015,09/06,CincinnatiDayton,1.62,517,13286,0,550,656,0,Fall,1067,13942,0,True
2015,08/30,CincinnatiDayton,1.56,459,11740,0,190,1611,0,Summer,649,13351,0,True
2015,08/23,CincinnatiDayton,1.58,433,13036,0,220,1273,0,Summer,653,14309,0,True
2015,08/16,CincinnatiDayton,1.66,252,13919,0,260,663,0,Summer,512,14582,0,True
2015,08/09,CincinnatiDayton,1.59,289,12902,0,346,1235,0,Summer,635,14137,0,True
2015,08/02,CincinnatiDayton,1.62,198,14035,0,123,928,0,Summer,321,14963,0,True
2015,07/26,CincinnatiDayton,1.63,253,12357,0,70,2368,0,Summer,323,14725,0,True
2015,07/19,CincinnatiDayton,1.66,230,11663,0,96,2751,0,Summer,326,14414,0,True
2015,07/12,CincinnatiDayton,1.56,241,11177,0,226,2861,0,Summer,467,14038,0,True
2015,07/05,CincinnatiDayton,1.59,250,12154,0,640,2032,0,Summer,890,14186,0,True
2015,06/28,CincinnatiDayton,1.49,313,11312,0,303,594,0,Summer,616,11906,0,True
2015,06/21,CincinnatiDayton,1.39,318,11779,0,548,1144,0,Summer,866,12923,0,True
2015,06/14,CincinnatiDayton,1.34,225,12225,0,1030,1964,0,Summer,1255,14189,0,True
2015,06/07,CincinnatiDayton,1.46,209,11403,0,985,294,0,Summer,1194,11697,0,True
2015,05/31,CincinnatiDayton,1.47,247,12167,0,1176,648,0,Spring,1423,12815,0,True
2015,05/24,CincinnatiDayton,1.48,303,13023,0,818,442,0,Spring,1121,13465,0,True
2015,05/17,CincinnatiDayton,1.27,283,10504,0,1797,3804,0,Spring,2080,14308,0,True
2015,05/10,CincinnatiDayton,1.43,285,11539,0,663,3501,0,Spring,948,15040,0,True
2015,05/03,CincinnatiDayton,1.42,248,11260,0,680,1956,0,Spring,928,13216,0,True
2015,04/26,CincinnatiDayton,1.36,256,13336,0,563,2133,0,Spring,819,15469,0,True
2015,04/19,CincinnatiDayton,1.46,374,13907,0,510,593,0,Spring,884,14500,0,True
2015,04/12,CincinnatiDayton,1.49,272,12556,0,688,90,0,Spring,960,12646,0,True
2015,04/05,CincinnatiDayton,1.22,279,12842,0,547,2341,0,Spring,826,15183,0,True
2015,03/29,CincinnatiDayton,1.27,344,12693,0,690,81,0,Spring,1034,12774,0,True
2015,03/22,CincinnatiDayton,1.25,376,13270,0,106,27,0,Spring,482,13297,0,True
2015,03/15,CincinnatiDayton,1.22,237,11231,0,96,744,0,Spring,333,11975,0,True
2015,03/08,CincinnatiDayton,1.17,251,9304,0,1373,2141,0,Spring,1624,11445,0,True
2015,03/01,CincinnatiDayton,1.24,271,9758,0,696,237,0,Spring,967,9995,0,True
2015,02/22,CincinnatiDayton,1.23,258,9998,0,403,594,0,Winter,661,10592,0,True
2015,02/15,CincinnatiDayton,1.22,264,9452,0,780,245,0,Winter,1044,9697,0,True
2015,02/08,CincinnatiDayton,1.24,225,8949,0,963,213,0,Winter,1188,9162,0,True
2015,02/01,CincinnatiDayton,1.19,218,9140,0,371,977,0,Winter,589,10117,0,True
2015,01/25,CincinnatiDayton,1.26,220,8150,0,377,1443,0,Winter,597,9593,0,True
2015,01/18,CincinnatiDayton,1.37,282,9374,0,351,43,0,Winter,633,9417,0,True
2015,01/11,CincinnatiDayton,1.32,209,10352,0,310,441,0,Winter,519,10793,0,True
2015,01/04,CincinnatiDayton,1.34,144,6921,0,585,1112,0,Winter,729,8033,0,True
2015,12/27,Columbus,1.53,289,1781,0,189,710,0,Winter,478,2491,0,True
2015,12/20,Columbus,1.67,242,1474,0,222,64,0,Winter,464,1538,0,True
2015,12/13,Columbus,1.59,330,1469,0,169,284,0,Winter,499,1753,0,True
2015,12/06,Columbus,1.52,469,2218,2,549,295,0,Winter,1018,2513,2,True
2015,11/29,Columbus,1.48,452,2326,0,371,154,0,Fall,823,2480,0,True
2015,11/22,Columbus,1.48,522,2789,0,129,196,0,Fall,651,2985,0,True
2015,11/15,Columbus,1.48,570,2671,0,126,227,0,Fall,696,2898,0,True
2015,11/08,Columbus,1.4,443,2827,0,413,460,0,Fall,856,3287,0,True
2015,11/01,Columbus,1.47,393,2899,0,257,283,0,Fall,650,3182,0,True
2015,10/25,Columbus,1.44,577,2725,0,468,238,0,Fall,1045,2963,0,True
2015,10/18,Columbus,1.36,502,2726,0,227,678,0,Fall,729,3404,0,True
2015,10/11,Columbus,1.27,463,2759,0,349,831,0,Fall,812,3590,0,True
2015,10/04,Columbus,1.49,505,2497,0,311,277,0,Fall,816,2774,0,True
2015,09/27,Columbus,1.67,486,1465,0,100,351,0,Fall,586,1816,0,True
2015,09/20,Columbus,1.82,511,1610,0,53,258,0,Fall,564,1868,0,True
2015,09/13,Columbus,1.74,639,2289,0,472,498,0,Fall,1111,2787,0,True
2015,09/06,Columbus,1.64,549,3387,0,582,930,0,Fall,1131,4317,0,True
2015,08/30,Columbus,1.48,773,2548,0,99,1649,0,Summer,872,4197,0,True
2015,08/23,Columbus,1.66,593,2740,3,305,1162,0,Summer,898,3902,3,True
2015,08/16,Columbus,2.08,378,2654,0,236,284,0,Summer,614,2938,0,True
2015,08/09,Columbus,1.98,303,2218,0,370,292,0,Summer,673,2510,0,True
2015,08/02,Columbus,1.8,337,1947,3,53,407,0,Summer,390,2354,3,True
2015,07/26,Columbus,1.31,397,2337,0,0,1553,0,Summer,397,3890,0,True
2015,07/19,Columbus,1.46,432,2342,0,26,1547,0,Summer,458,3889,0,True
2015,07/12,Columbus,1.01,409,2453,0,80,3326,0,Summer,489,5779,0,True
2015,07/05,Columbus,1.31,536,4088,0,290,989,0,Summer,826,5077,0,True
2015,06/28,Columbus,1.35,461,3362,2,219,770,0,Summer,680,4132,2,True
2015,06/21,Columbus,1.35,493,3524,1,381,946,0,Summer,874,4470,1,True
2015,06/14,Columbus,1.5,431,2970,0,837,280,0,Summer,1268,3250,0,True
2015,06/07,Columbus,1.21,322,2720,0,687,2298,0,Summer,1009,5018,0,True
2015,05/31,Columbus,1.49,410,3627,0,1138,773,0,Spring,1548,4400,0,True
2015,05/24,Columbus,1.51,463,3593,0,746,557,0,Spring,1209,4150,0,True
2015,05/17,Columbus,1.21,560,2085,0,605,1502,0,Spring,1165,3587,0,True
2015,05/10,Columbus,0.81,967,17214,1,433,11078,0,Spring,1400,28292,1,True
2015,05/03,Columbus,0.89,961,18774,2,503,7779,0,Spring,1464,26553,2,True
2015,04/26,Columbus,1.57,408,3284,0,572,618,0,Spring,980,3902,0,True
2015,04/19,Columbus,1.47,287,3203,0,740,612,0,Spring,1027,3815,0,True
2015,04/12,Columbus,1.66,383,3479,0,450,315,0,Spring,833,3794,0,True
2015,04/05,Columbus,1.38,403,2859,0,645,1381,0,Spring,1048,4240,0,True
2015,03/29,Columbus,1.79,369,2347,0,719,28,0,Spring,1088,2375,0,True
2015,03/22,Columbus,1.91,343,1775,0,137,38,0,Spring,480,1813,0,True
2015,03/15,Columbus,1.65,406,2060,0,291,626,0,Spring,697,2686,0,True
2015,03/08,Columbus,1.84,317,2943,7,1130,120,0,Spring,1447,3063,7,True
2015,03/01,Columbus,1.86,397,2681,0,664,311,0,Spring,1061,2992,0,True
2015,02/22,Columbus,1.79,589,2581,0,238,524,0,Winter,827,3105,0,True
2015,02/15,Columbus,1.64,374,2597,0,706,604,0,Winter,1080,3201,0,True
2015,02/08,Columbus,1.78,285,2071,0,856,270,0,Winter,1141,2341,0,True
2015,02/01,Columbus,1.63,432,2985,0,223,575,0,Winter,655,3560,0,True
2015,01/25,Columbus,1.67,350,3650,0,293,553,0,Winter,643,4203,0,True
2015,01/18,Columbus,1.84,279,2959,0,213,575,0,Winter,492,3534,0,True
2015,01/11,Columbus,1.68,349,3226,0,416,201,0,Winter,765,3427,0,True
2015,01/04,Columbus,1.44,358,2432,0,444,695,0,Winter,802,3127,0,True
2015,12/27,DallasFtWorth,1.33,5921,421,0,3584,933,0,Winter,9505,1354,0,True
2015,12/20,DallasFtWorth,1.38,5742,384,0,4594,406,0,Winter,10336,790,0,True
2015,12/13,DallasFtWorth,1.43,6036,389,0,5798,0,0,Winter,11834,389,0,True
2015,12/06,DallasFtWorth,1.48,5582,401,0,4474,0,0,Winter,10056,401,0,True
2015,11/29,DallasFtWorth,1.46,5706,278,0,3427,0,0,Fall,9133,278,0,True
2015,11/22,DallasFtWorth,1.46,6189,271,0,4350,0,0,Fall,10539,271,0,True
2015,11/15,DallasFtWorth,1.36,7099,416,0,4123,0,0,Fall,11222,416,0,True
2015,11/08,DallasFtWorth,1.46,6807,441,0,3899,0,0,Fall,10706,441,0,True
2015,11/01,DallasFtWorth,1.41,6449,268,0,5533,0,0,Fall,11982,268,0,True
2015,10/25,DallasFtWorth,1.48,7509,329,0,5410,10,0,Fall,12919,339,0,True
2015,10/18,DallasFtWorth,1.39,7657,253,0,3070,30,0,Fall,10727,283,0,True
2015,10/11,DallasFtWorth,1.48,6628,378,0,3636,3,0,Fall,10264,381,0,True
2015,10/04,DallasFtWorth,1.49,5675,446,0,4626,3,0,Fall,10301,449,0,True
2015,09/27,DallasFtWorth,1.48,8224,303,0,3696,0,0,Fall,11920,303,0,True
2015,09/20,DallasFtWorth,1.47,8023,240,0,4250,0,0,Fall,12273,240,0,True
2015,09/13,DallasFtWorth,1.48,7561,362,0,4776,3,0,Fall,12337,365,0,True
2015,09/06,DallasFtWorth,1.46,7399,347,0,5195,0,0,Fall,12594,347,0,True
2015,08/30,DallasFtWorth,1.36,9720,348,0,4081,166,0,Summer,13801,514,0,True
2015,08/23,DallasFtWorth,1.36,11090,565,0,5238,534,0,Summer,16328,1099,0,True
2015,08/16,DallasFtWorth,1.45,8229,694,0,4334,10,0,Summer,12563,704,0,True
2015,08/09,DallasFtWorth,1.4,8961,999,0,6741,0,0,Summer,15702,999,0,True
2015,08/02,DallasFtWorth,1.31,10686,522,36,1733,13,0,Summer,12419,535,36,True
2015,07/26,DallasFtWorth,1.14,11536,337,0,927,0,0,Summer,12463,337,0,True
2015,07/19,DallasFtWorth,1.29,10492,499,0,889,0,0,Summer,11381,499,0,True
2015,07/12,DallasFtWorth,1.27,9757,444,0,874,0,0,Summer,10631,444,0,True
2015,07/05,DallasFtWorth,1.3,10979,459,0,1795,0,0,Summer,12774,459,0,True
2015,06/28,DallasFtWorth,1.33,9252,434,0,2106,0,0,Summer,11358,434,0,True
2015,06/21,DallasFtWorth,1.37,7968,486,0,1480,0,0,Summer,9448,486,0,True
2015,06/14,DallasFtWorth,1.35,7806,512,0,1562,0,0,Summer,9368,512,0,True
2015,06/07,DallasFtWorth,1.35,6952,356,0,1710,0,0,Summer,8662,356,0,True
2015,05/31,DallasFtWorth,1.38,7376,398,0,2107,0,0,Spring,9483,398,0,True
2015,05/24,DallasFtWorth,1.36,10061,430,0,2318,0,0,Spring,12379,430,0,True
2015,05/17,DallasFtWorth,1.35,8380,445,0,2266,0,0,Spring,10646,445,0,True
2015,05/10,DallasFtWorth,1.39,7874,351,0,2013,3,0,Spring,9887,354,0,True
2015,05/03,DallasFtWorth,1.37,5350,207,0,1010,0,0,Spring,6360,207,0,True
2015,04/26,DallasFtWorth,1.34,7679,379,0,1796,0,0,Spring,9475,379,0,True
2015,04/19,DallasFtWorth,1.35,9552,525,0,1976,0,0,Spring,11528,525,0,True
2015,04/12,DallasFtWorth,1.39,8189,526,0,2403,0,0,Spring,10592,526,0,True
2015,04/05,DallasFtWorth,1.36,8239,486,0,2993,0,0,Spring,11232,486,0,True
2015,03/29,DallasFtWorth,1.36,6160,467,0,2533,0,0,Spring,8693,467,0,True
2015,03/22,DallasFtWorth,1.29,9505,765,0,2906,0,0,Spring,12411,765,0,True
2015,03/15,DallasFtWorth,1.34,7889,659,0,3373,0,0,Spring,11262,659,0,True
2015,03/08,DallasFtWorth,1.39,5946,498,0,2113,0,0,Spring,8059,498,0,True
2015,03/01,DallasFtWorth,1.29,9540,850,0,6876,0,0,Spring,16416,850,0,True
2015,02/22,DallasFtWorth,1.38,9117,851,0,5516,0,0,Winter,14633,851,0,True
2015,02/15,DallasFtWorth,1.41,7081,827,0,3050,0,0,Winter,10131,827,0,True
2015,02/08,DallasFtWorth,1.35,6135,826,0,3353,0,0,Winter,9488,826,0,True
2015,02/01,DallasFtWorth,1.24,6669,1653,0,3953,0,0,Winter,10622,1653,0,True
2015,01/25,DallasFtWorth,1.34,7244,1390,0,2613,0,0,Winter,9857,1390,0,True
2015,01/18,DallasFtWorth,1.28,7556,871,0,4206,0,0,Winter,11762,871,0,True
2015,01/11,DallasFtWorth,1.35,7136,1353,0,3636,0,0,Winter,10772,1353,0,True
2015,01/04,DallasFtWorth,1.35,4634,1647,0,3613,0,0,Winter,8247,1647,0,True
2015,12/27,Denver,1.43,9299,2853,12,330,11232,0,Winter,9629,14085,12,True
2015,12/20,Denver,1.35,9203,3262,4,276,14426,0,Winter,9479,17688,4,True
2015,12/13,Denver,1.36,7419,3155,3,444,13263,0,Winter,7863,16418,3,True
2015,12/06,Denver,0.92,3841,8059,33,430,28960,0,Winter,4271,37019,33,True
2015,11/29,Denver,0.88,5178,11715,15,385,39427,0,Fall,5563,51142,15,True
2015,11/22,Denver,1.39,6643,5729,30,523,10167,0,Fall,7166,15896,30,True
2015,11/15,Denver,1.33,11293,3356,29,1068,8041,0,Fall,12361,11397,29,True
2015,11/08,Denver,1.14,37447,9325,36,500,8041,0,Fall,37947,17366,36,True
2015,11/01,Denver,1.26,5850,6277,29,506,17139,0,Fall,6356,23416,29,True
2015,10/25,Denver,1.27,1813,6320,36,447,21413,0,Fall,2260,27733,36,True
2015,10/18,Denver,1.3,2156,5707,26,434,17503,0,Fall,2590,23210,26,True
2015,10/11,Denver,1.28,2269,4720,26,397,17325,0,Fall,2666,22045,26,True
2015,10/04,Denver,1.25,1368,5986,30,739,20566,0,Fall,2107,26552,30,True
2015,09/27,Denver,1.35,5917,5527,30,643,20805,0,Fall,6560,26332,30,True
2015,09/20,Denver,1.36,6109,3509,13,356,15819,0,Fall,6465,19328,13,True
2015,09/13,Denver,1.36,5076,3584,28,203,17389,0,Fall,5279,20973,28,True
2015,09/06,Denver,1.43,3820,5153,11,185,18100,0,Fall,4005,23253,11,True
2015,08/30,Denver,1.45,5988,4070,24,676,14363,0,Summer,6664,18433,24,True
2015,08/23,Denver,1.46,12000,6027,32,833,19055,0,Summer,12833,25082,32,True
2015,08/16,Denver,1.45,10281,5062,10,661,16236,0,Summer,10942,21298,10,True
2015,08/09,Denver,1.44,12490,3930,21,748,17696,0,Summer,13238,21626,21,True
2015,08/02,Denver,1.43,10555,2962,23,603,17279,0,Summer,11158,20241,23,True
2015,07/26,Denver,1.43,9085,2619,21,248,16308,0,Summer,9333,18927,21,True
2015,07/19,Denver,1.45,9846,2604,23,90,12811,0,Summer,9936,15415,23,True
2015,07/12,Denver,1.44,9772,3066,32,85,14144,0,Summer,9857,17210,32,True
2015,07/05,Denver,1.42,9786,3058,11,86,20716,0,Summer,9872,23774,11,True
2015,06/28,Denver,1.44,10715,2929,33,290,16657,0,Summer,11005,19586,33,True
2015,06/21,Denver,1.43,9953,2917,21,740,18321,0,Summer,10693,21238,21,True
2015,06/14,Denver,1.44,11488,4348,49,720,17386,0,Summer,12208,21734,49,True
2015,06/07,Denver,1.44,11955,4701,48,692,13492,0,Summer,12647,18193,48,True
2015,05/31,Denver,1.43,11232,4800,21,902,16899,0,Spring,12134,21699,21,True
2015,05/24,Denver,1.43,13288,5497,18,1041,16235,0,Spring,14329,21732,18,True
2015,05/17,Denver,1.22,19911,8929,18,4177,12477,0,Spring,24088,21406,18,True
2015,05/10,Denver,1.23,19400,8573,45,3274,15656,0,Spring,22674,24229,45,True
2015,05/03,Denver,1.03,88780,36428,143,2957,10902,0,Spring,91737,47330,143,True
2015,04/26,Denver,1.03,75842,37729,268,1966,9701,0,Spring,77808,47430,268,True
2015,04/19,Denver,1.44,6897,4706,65,683,11210,0,Spring,7580,15916,65,True
2015,04/12,Denver,1.42,6189,4728,20,450,12312,0,Spring,6639,17040,20,True
2015,04/05,Denver,1.42,8696,6633,19,560,18523,0,Spring,9256,25156,19,True
2015,03/29,Denver,1.44,5455,8344,8,1693,13603,0,Spring,7148,21947,8,True
2015,03/22,Denver,1.39,9365,8034,16,543,11661,0,Spring,9908,19695,16,True
2015,03/15,Denver,1.12,27916,27507,27,1813,11268,0,Spring,29729,38775,27,True
2015,03/08,Denver,1.09,34792,26156,45,2923,6940,0,Spring,37715,33096,45,True
2015,03/01,Denver,1.27,15769,11650,14,1970,6682,0,Spring,17739,18332,14,True
2015,02/22,Denver,1.4,4987,6082,28,1180,12516,0,Winter,6167,18598,28,True
2015,02/15,Denver,1.44,2347,7061,12,953,9285,0,Winter,3300,16346,12,True
2015,02/08,Denver,1.4,3017,7175,9,2293,10302,0,Winter,5310,17477,9,True
2015,02/01,Denver,1.29,4823,10709,104,1323,10566,0,Winter,6146,21275,104,True
2015,01/25,Denver,1.33,4271,8412,584,1202,8031,0,Winter,5473,16443,584,True
2015,01/18,Denver,1.1,5475,32538,42,992,3186,0,Winter,6467,35724,42,True
2015,01/11,Denver,1.28,8855,15070,24,1699,5031,0,Winter,10554,20101,24,True
2015,01/04,Denver,1.42,3199,6916,7,1076,11279,0,Winter,4275,18195,7,True
2015,12/27,Detroit,1.61,1276,3370,0,366,1820,0,Winter,1642,5190,0,True
2015,12/20,Detroit,1.8,1421,3078,0,376,97,0,Winter,1797,3175,0,True
2015,12/13,Detroit,1.53,1494,2748,0,196,1237,0,Winter,1690,3985,0,True
2015,12/06,Detroit,1.8,1289,4788,0,300,681,0,Winter,1589,5469,0,True
2015,11/29,Detroit,1.81,1437,3895,0,163,341,0,Fall,1600,4236,0,True
2015,11/22,Detroit,1.84,1822,4568,0,83,397,0,Fall,1905,4965,0,True
2015,11/15,Detroit,1.84,1658,4577,0,140,188,0,Fall,1798,4765,0,True
2015,11/08,Detroit,1.74,1657,4296,0,216,737,0,Fall,1873,5033,0,True
2015,11/01,Detroit,1.85,1553,5744,0,190,621,0,Fall,1743,6365,0,True
2015,10/25,Detroit,1.8,1520,5456,0,383,535,0,Fall,1903,5991,0,True
2015,10/18,Detroit,1.65,1652,4374,0,393,1371,0,Fall,2045,5745,0,True
2015,10/11,Detroit,1.61,1111,4593,0,480,1324,0,Fall,1591,5917,0,True
2015,10/04,Detroit,1.81,1373,5026,0,533,338,0,Fall,1906,5364,0,True
2015,09/27,Detroit,1.71,1434,4977,0,456,1022,0,Fall,1890,5999,0,True
2015,09/20,Detroit,1.86,1647,5145,0,486,30,0,Fall,2133,5175,0,True
2015,09/13,Detroit,1.81,1800,5478,0,366,658,0,Fall,2166,6136,0,True
2015,09/06,Detroit,1.47,1810,6972,0,413,1761,0,Fall,2223,8733,0,True
2015,08/30,Detroit,1.32,2544,5844,0,383,2811,0,Summer,2927,8655,0,True
2015,08/23,Detroit,1.43,2425,7778,0,289,2738,0,Summer,2714,10516,0,True
2015,08/16,Detroit,1.74,615,8951,0,332,730,0,Summer,947,9681,0,True
2015,08/09,Detroit,1.85,556,4367,0,636,351,0,Summer,1192,4718,0,True
2015,08/02,Detroit,1.66,443,5477,0,580,772,0,Summer,1023,6249,0,True
2015,07/26,Detroit,1.28,562,7155,0,476,3992,0,Summer,1038,11147,0,True
2015,07/19,Detroit,1.24,447,6816,0,270,4404,0,Summer,717,11220,0,True
2015,07/12,Detroit,1.01,481,5955,0,436,7257,0,Summer,917,13212,0,True
2015,07/05,Detroit,1.47,498,7509,0,576,2091,0,Summer,1074,9600,0,True
2015,06/28,Detroit,1.56,521,6130,0,306,1474,0,Summer,827,7604,0,True
2015,06/21,Detroit,1.64,636,7546,0,422,1386,0,Summer,1058,8932,0,True
2015,06/14,Detroit,1.37,623,7968,0,1271,892,0,Summer,1894,8860,0,True
2015,06/07,Detroit,1.28,750,8290,0,1359,1965,0,Summer,2109,10255,0,True
2015,05/31,Detroit,1.55,616,7097,0,1165,1029,0,Spring,1781,8126,0,True
2015,05/24,Detroit,1.61,506,5960,0,776,656,0,Spring,1282,6616,0,True
2015,05/17,Detroit,1.34,428,3469,0,433,1883,0,Spring,861,5352,0,True
2015,05/10,Detroit,1.09,573,6949,0,716,8565,0,Spring,1289,15514,0,True
2015,05/03,Detroit,1.37,518,7336,0,580,2260,0,Spring,1098,9596,0,True
2015,04/26,Detroit,1.63,430,6139,0,616,960,0,Spring,1046,7099,0,True
2015,04/19,Detroit,1.59,391,5966,0,1058,705,0,Spring,1449,6671,0,True
2015,04/12,Detroit,1.72,460,6496,0,357,421,0,Spring,817,6917,0,True
2015,04/05,Detroit,1.51,460,6496,0,436,1584,0,Spring,896,8080,0,True
2015,03/29,Detroit,1.74,410,5582,0,471,185,0,Spring,881,5767,0,True
2015,03/22,Detroit,1.78,392,5184,0,13,58,0,Spring,405,5242,0,True
2015,03/15,Detroit,1.49,514,6238,0,515,1894,0,Spring,1029,8132,0,True
2015,03/08,Detroit,1.83,517,6512,0,1140,264,0,Spring,1657,6776,0,True
2015,03/01,Detroit,1.92,386,5898,0,516,372,0,Spring,902,6270,0,True
2015,02/22,Detroit,1.85,651,5368,0,340,817,0,Winter,991,6185,0,True
2015,02/15,Detroit,1.82,434,5742,0,293,567,0,Winter,727,6309,0,True
2015,02/08,Detroit,1.86,509,4643,0,913,433,0,Winter,1422,5076,0,True
2015,02/01,Detroit,1.55,449,6955,0,253,1049,0,Winter,702,8004,0,True
2015,01/25,Detroit,1.62,580,7210,0,60,852,0,Winter,640,8062,0,True
2015,01/18,Detroit,1.9,376,6430,0,446,403,0,Winter,822,6833,0,True
2015,01/11,Detroit,1.87,417,5637,0,329,541,0,Winter,746,6178,0,True
2015,01/04,Detroit,1.7,361,5025,0,746,1312,0,Winter,1107,6337,0,True
2015,12/27,GrandRapids,1.67,822,941,0,246,0,0,Winter,1068,941,0,True
2015,12/20,GrandRapids,1.66,1015,816,0,160,0,0,Winter,1175,816,0,True
2015,12/13,GrandRapids,1.55,1024,891,0,176,0,0,Winter,1200,891,0,True
2015,12/06,GrandRapids,1.64,944,492,0,206,0,0,Winter,1150,492,0,True
2015,11/29,GrandRapids,1.66,808,568,0,120,0,0,Fall,928,568,0,True
2015,11/22,GrandRapids,1.66,870,595,0,130,6,0,Fall,1000,601,0,True
2015,11/15,GrandRapids,1.65,958,531,0,173,0,0,Fall,1131,531,0,True
2015,11/08,GrandRapids,1.64,981,485,0,163,0,0,Fall,1144,485,0,True
2015,11/01,GrandRapids,1.6,984,506,0,103,46,0,Fall,1087,552,0,True
2015,10/25,GrandRapids,1.57,946,692,0,193,147,0,Fall,1139,839,0,True
2015,10/18,GrandRapids,1.61,1156,650,0,283,55,0,Fall,1439,705,0,True
2015,10/11,GrandRapids,1.74,517,835,0,300,0,0,Fall,817,835,0,True
2015,10/04,GrandRapids,1.69,613,695,0,400,0,0,Fall,1013,695,0,True
2015,09/27,GrandRapids,1.68,849,835,0,453,0,0,Fall,1302,835,0,True
2015,09/20,GrandRapids,1.69,787,762,0,286,0,0,Fall,1073,762,0,True
2015,09/13,GrandRapids,1.68,906,762,0,263,0,0,Fall,1169,762,0,True
2015,09/06,GrandRapids,1.68,1050,866,0,403,0,0,Fall,1453,866,0,True
2015,08/30,GrandRapids,1.68,1246,1015,0,306,15,0,Summer,1552,1030,0,True
2015,08/23,GrandRapids,1.49,2674,1500,0,243,0,0,Summer,2917,1500,0,True
2015,08/16,GrandRapids,1.64,1152,1438,0,196,0,0,Summer,1348,1438,0,True
2015,08/09,GrandRapids,1.76,1224,1107,0,550,0,0,Summer,1774,1107,0,True
2015,08/02,GrandRapids,1.63,14,2366,0,420,6,0,Summer,434,2372,0,True
2015,07/26,GrandRapids,1.86,9,793,0,266,0,0,Summer,275,793,0,True
2015,07/19,GrandRapids,1.9,7,885,0,126,9,0,Summer,133,894,0,True
2015,07/12,GrandRapids,1.86,5,999,0,313,9,0,Summer,318,1008,0,True
2015,07/05,GrandRapids,1.84,7,923,0,356,9,0,Summer,363,932,0,True
2015,06/28,GrandRapids,1.92,63,873,0,270,0,0,Summer,333,873,0,True
2015,06/21,GrandRapids,1.93,47,954,0,230,3,0,Summer,277,957,0,True
2015,06/14,GrandRapids,1.8,7,1128,0,436,0,0,Summer,443,1128,0,True
2015,06/07,GrandRapids,1.7,37,518,0,460,67,0,Summer,497,585,0,True
2015,05/31,GrandRapids,1.85,22,722,0,336,0,0,Spring,358,722,0,True
2015,05/24,GrandRapids,1.83,10,983,0,418,6,0,Spring,428,989,0,True
2015,05/17,GrandRapids,1.85,0,969,0,356,12,0,Spring,356,981,0,True
2015,05/10,GrandRapids,1.22,36,1045,0,346,3122,0,Spring,382,4167,0,True
2015,05/03,GrandRapids,1.61,7,1053,0,316,0,0,Spring,323,1053,0,True
2015,04/26,GrandRapids,1.79,2,1040,0,326,0,0,Spring,328,1040,0,True
2015,04/19,GrandRapids,1.59,0,963,0,413,0,0,Spring,413,963,0,True
2015,04/12,GrandRapids,1.86,0,606,0,216,0,0,Spring,216,606,0,True
2015,04/05,GrandRapids,1.83,11,617,0,306,0,0,Spring,317,617,0,True
2015,03/29,GrandRapids,1.87,46,631,0,326,0,0,Spring,372,631,0,True
2015,03/22,GrandRapids,2.01,20,659,0,3,0,0,Spring,23,659,0,True
2015,03/15,GrandRapids,1.87,94,813,0,385,36,0,Spring,479,849,0,True
2015,03/08,GrandRapids,1.78,69,493,0,613,0,0,Spring,682,493,0,True
2015,03/01,GrandRapids,1.84,32,506,0,310,0,0,Spring,342,506,0,True
2015,02/22,GrandRapids,1.89,46,643,0,260,0,0,Winter,306,643,0,True
2015,02/15,GrandRapids,1.88,17,566,0,203,0,0,Winter,220,566,0,True
2015,02/08,GrandRapids,1.79,84,402,0,596,0,0,Winter,680,402,0,True
2015,02/01,GrandRapids,1.98,52,620,0,96,0,0,Winter,148,620,0,True
2015,01/25,GrandRapids,2.01,59,572,0,80,0,0,Winter,139,572,0,True
2015,01/18,GrandRapids,1.88,20,488,0,196,0,0,Winter,216,488,0,True
2015,01/11,GrandRapids,1.87,29,539,0,190,3,0,Winter,219,542,0,True
2015,01/04,GrandRapids,1.6,23,772,0,210,6,0,Winter,233,778,0,True
2015,12/27,HarrisburgScranton,1.45,79,186,16,959,4587,0,Winter,1038,4773,16,True
2015,12/20,HarrisburgScranton,2.09,116,171,17,1452,1029,0,Winter,1568,1200,17,True
2015,12/13,HarrisburgScranton,2.0,68,235,19,1597,2409,0,Winter,1665,2644,19,True
2015,12/06,HarrisburgScranton,1.3,137,185,3,415,4111,0,Winter,552,4296,3,True
2015,11/29,HarrisburgScranton,1.4,78,199,11,314,2503,0,Fall,392,2702,11,True
2015,11/22,HarrisburgScranton,1.47,118,176,10,449,1480,0,Fall,567,1656,10,True
2015,11/15,HarrisburgScranton,1.92,117,290,6,723,62,0,Fall,840,352,6,True
2015,11/08,HarrisburgScranton,1.99,165,263,11,648,72,0,Fall,813,335,11,True
2015,11/01,HarrisburgScranton,2.02,148,142,20,427,231,0,Fall,575,373,20,True
2015,10/25,HarrisburgScranton,1.79,82,166,19,490,687,0,Fall,572,853,19,True
2015,10/18,HarrisburgScranton,1.48,67,221,16,481,2351,0,Fall,548,2572,16,True
2015,10/11,HarrisburgScranton,1.49,70,136,21,676,1544,0,Fall,746,1680,21,True
2015,10/04,HarrisburgScranton,2.02,82,186,9,910,0,0,Fall,992,186,9,True
2015,09/27,HarrisburgScranton,2.24,106,222,8,803,0,0,Fall,909,222,8,True
2015,09/20,HarrisburgScranton,1.94,136,215,15,1191,0,0,Fall,1327,215,15,True
2015,09/13,HarrisburgScranton,1.84,83,177,8,1787,0,0,Fall,1870,177,8,True
2015,09/06,HarrisburgScranton,1.68,155,173,3,3210,16,0,Fall,3365,189,3,True
2015,08/30,HarrisburgScranton,1.73,94,134,12,2153,26,0,Summer,2247,160,12,True
2015,08/23,HarrisburgScranton,1.7,63,149,17,2585,9,0,Summer,2648,158,17,True
2015,08/16,HarrisburgScranton,1.88,101,156,7,1456,0,0,Summer,1557,156,7,True
2015,08/09,HarrisburgScranton,1.69,99,160,33,2786,0,0,Summer,2885,160,33,True
2015,08/02,HarrisburgScranton,1.96,69,198,11,2448,0,0,Summer,2517,198,11,True
2015,07/26,HarrisburgScranton,2.06,145,176,17,1057,0,0,Summer,1202,176,17,True
2015,07/19,HarrisburgScranton,1.92,79,222,15,2833,0,0,Summer,2912,222,15,True
2015,07/12,HarrisburgScranton,1.92,124,166,6,970,0,0,Summer,1094,166,6,True
2015,07/05,HarrisburgScranton,2.01,65,91,11,1673,0,0,Summer,1738,91,11,True
2015,06/28,HarrisburgScranton,1.85,119,155,12,3100,0,0,Summer,3219,155,12,True
2015,06/21,HarrisburgScranton,1.9,62,243,4,2761,0,0,Summer,2823,243,4,True
2015,06/14,HarrisburgScranton,1.83,87,165,10,3231,0,0,Summer,3318,165,10,True
2015,06/07,HarrisburgScranton,1.84,35,122,0,3327,0,0,Summer,3362,122,0,True
2015,05/31,HarrisburgScranton,1.83,91,173,0,2781,0,0,Spring,2872,173,0,True
2015,05/24,HarrisburgScranton,1.84,75,178,15,4171,0,0,Spring,4246,178,15,True
2015,05/17,HarrisburgScranton,1.88,39,251,8,3550,0,0,Spring,3589,251,8,True
2015,05/10,HarrisburgScranton,1.78,68,228,6,4694,0,0,Spring,4762,228,6,True
2015,05/03,HarrisburgScranton,1.84,38,132,0,3375,0,0,Spring,3413,132,0,True
2015,04/26,HarrisburgScranton,1.81,23,97,0,3217,0,0,Spring,3240,97,0,True
2015,04/19,HarrisburgScranton,1.88,96,86,6,2712,0,0,Spring,2808,86,6,True
2015,04/12,HarrisburgScranton,1.79,86,151,0,3889,0,0,Spring,3975,151,0,True
2015,04/05,HarrisburgScranton,1.75,28,155,7,3123,0,0,Spring,3151,155,7,True
2015,03/29,HarrisburgScranton,1.79,48,204,0,3452,0,0,Spring,3500,204,0,True
2015,03/22,HarrisburgScranton,2.09,45,391,0,732,0,0,Spring,777,391,0,True
2015,03/15,HarrisburgScranton,1.72,52,270,0,2080,0,0,Spring,2132,270,0,True
2015,03/08,HarrisburgScranton,1.6,18,353,0,5723,0,0,Spring,5741,353,0,True
2015,03/01,HarrisburgScranton,1.74,44,266,7,2744,0,0,Spring,2788,266,7,True
2015,02/22,HarrisburgScranton,1.68,22,152,11,3213,0,0,Winter,3235,152,11,True
2015,02/15,HarrisburgScranton,1.65,49,261,16,4375,0,0,Winter,4424,261,16,True
2015,02/08,HarrisburgScranton,1.67,35,136,0,3236,0,0,Winter,3271,136,0,True
2015,02/01,HarrisburgScranton,1.65,39,151,0,3605,0,0,Winter,3644,151,0,True
2015,01/25,HarrisburgScranton,1.8,97,171,0,1902,0,0,Winter,1999,171,0,True
2015,01/18,HarrisburgScranton,1.94,50,127,8,1168,0,0,Winter,1218,127,8,True
2015,01/11,HarrisburgScranton,1.65,90,288,0,3504,0,0,Winter,3594,288,0,True
2015,01/04,HarrisburgScranton,1.68,161,206,0,2528,0,0,Winter,2689,206,0,True
2015,12/27,HartfordSpringfield,2.32,88,3733,6,1619,78,0,Winter,1707,3811,6,True
2015,12/20,HartfordSpringfield,2.24,222,1874,230,1670,0,0,Winter,1892,1874,230,True
2015,12/13,HartfordSpringfield,2.34,75,2154,2410,2284,0,0,Winter,2359,2154,2410,True
2015,12/06,HartfordSpringfield,2.16,192,2179,15,349,3,0,Winter,541,2182,15,True
2015,11/29,HartfordSpringfield,2.33,30,1476,0,89,36,0,Fall,119,1512,0,True
2015,11/22,HartfordSpringfield,2.31,138,2079,1,83,15,0,Fall,221,2094,1,True
2015,11/15,HartfordSpringfield,2.23,135,2079,0,201,12,0,Fall,336,2091,0,True
2015,11/08,HartfordSpringfield,2.14,113,2199,0,553,12,0,Fall,666,2211,0,True
2015,11/01,HartfordSpringfield,1.96,88,2399,9,1390,289,0,Fall,1478,2688,9,True
2015,10/25,HartfordSpringfield,1.98,54,2232,9,339,1249,0,Fall,393,3481,9,True
2015,10/18,HartfordSpringfield,2.18,32,1785,0,398,203,0,Fall,430,1988,0,True
2015,10/11,HartfordSpringfield,2.27,97,2144,0,386,190,0,Fall,483,2334,0,True
2015,10/04,HartfordSpringfield,2.3,64,2269,5,396,119,0,Fall,460,2388,5,True
2015,09/27,HartfordSpringfield,2.41,53,4317,4,159,24,0,Fall,212,4341,4,True
2015,09/20,HartfordSpringfield,2.31,179,2459,2,58,0,0,Fall,237,2459,2,True
2015,09/13,HartfordSpringfield,2.36,49,2509,2,306,0,0,Fall,355,2509,2,True
2015,09/06,HartfordSpringfield,2.37,172,3667,2,209,6,0,Fall,381,3673,2,True
2015,08/30,HartfordSpringfield,2.33,88,2172,0,373,6,0,Summer,461,2178,0,True
2015,08/23,HartfordSpringfield,2.31,117,2302,0,509,0,0,Summer,626,2302,0,True
2015,08/16,HartfordSpringfield,2.39,1360,2053,2,336,0,0,Summer,1696,2053,2,True
2015,08/09,HartfordSpringfield,2.31,1941,2656,1,479,0,0,Summer,2420,2656,1,True
2015,08/02,HartfordSpringfield,2.42,82,2503,1,89,0,0,Summer,171,2503,1,True
2015,07/26,HartfordSpringfield,2.39,67,2487,0,47,3,0,Summer,114,2490,0,True
2015,07/19,HartfordSpringfield,2.45,80,2832,4,43,0,0,Summer,123,2832,4,True
2015,07/12,HartfordSpringfield,2.38,122,2585,0,136,0,0,Summer,258,2585,0,True
2015,07/05,HartfordSpringfield,2.4,160,3786,0,348,0,0,Summer,508,3786,0,True
2015,06/28,HartfordSpringfield,2.31,133,2522,0,135,0,0,Summer,268,2522,0,True
2015,06/21,HartfordSpringfield,2.4,74,3375,0,299,26,0,Summer,373,3401,0,True
2015,06/14,HartfordSpringfield,2.25,123,2957,7,462,0,0,Summer,585,2957,7,True
2015,06/07,HartfordSpringfield,2.34,276,2787,1,413,0,0,Summer,689,2787,1,True
2015,05/31,HartfordSpringfield,2.24,274,2489,18,411,0,0,Spring,685,2489,18,True
2015,05/24,HartfordSpringfield,2.36,84,3012,18,434,0,0,Spring,518,3012,18,True
2015,05/17,HartfordSpringfield,2.3,46,2854,2,581,0,0,Spring,627,2854,2,True
2015,05/10,HartfordSpringfield,2.31,79,3796,3,605,0,0,Spring,684,3796,3,True
2015,05/03,HartfordSpringfield,1.55,45,5832,20,474,0,0,Spring,519,5832,20,True
2015,04/26,HartfordSpringfield,2.24,52,2160,5,625,0,0,Spring,677,2160,5,True
2015,04/19,HartfordSpringfield,2.27,82,2636,1,532,0,0,Spring,614,2636,1,True
2015,04/12,HartfordSpringfield,2.16,183,2892,0,752,0,0,Spring,935,2892,0,True
2015,04/05,HartfordSpringfield,2.18,99,1927,2,759,0,0,Spring,858,1927,2,True
2015,03/29,HartfordSpringfield,2.27,88,1846,0,286,0,0,Spring,374,1846,0,True
2015,03/22,HartfordSpringfield,2.18,148,2276,0,423,0,0,Spring,571,2276,0,True
2015,03/15,HartfordSpringfield,2.26,83,2234,0,409,0,0,Spring,492,2234,0,True
2015,03/08,HartfordSpringfield,2.18,152,2524,0,608,0,0,Spring,760,2524,0,True
2015,03/01,HartfordSpringfield,2.17,59,2158,2,829,0,0,Spring,888,2158,2,True
2015,02/22,HartfordSpringfield,2.38,670,3747,2,413,0,0,Winter,1083,3747,2,True
2015,02/15,HartfordSpringfield,2.13,304,1797,0,652,0,0,Winter,956,1797,0,True
2015,02/08,HartfordSpringfield,2.37,49,4531,15,626,0,0,Winter,675,4531,15,True
2015,02/01,HartfordSpringfield,1.54,88,5406,2,587,0,0,Winter,675,5406,2,True
2015,01/25,HartfordSpringfield,2.21,73,1602,9,234,0,0,Winter,307,1602,9,True
2015,01/18,HartfordSpringfield,2.35,39,2233,12,266,0,0,Winter,305,2233,12,True
2015,01/11,HartfordSpringfield,2.28,79,3190,0,193,0,0,Winter,272,3190,0,True
2015,01/04,HartfordSpringfield,2.32,87,4364,0,349,0,0,Winter,436,4364,0,True
2015,12/27,Houston,1.31,4797,57,0,4815,927,0,Winter,9612,984,0,True
2015,12/20,Houston,1.27,4463,88,0,3278,1423,0,Winter,7741,1511,0,True
2015,12/13,Houston,1.35,4757,93,0,6636,7,0,Winter,11393,100,0,True
2015,12/06,Houston,1.49,4787,85,0,3344,0,0,Winter,8131,85,0,True
2015,11/29,Houston,1.51,4092,69,0,3280,0,0,Fall,7372,69,0,True
2015,11/22,Houston,1.5,4552,58,0,3546,0,0,Fall,8098,58,0,True
2015,11/15,Houston,1.5,5342,45,0,4469,0,0,Fall,9811,45,0,True
2015,11/08,Houston,1.44,6028,83,0,3914,0,0,Fall,9942,83,0,True
2015,11/01,Houston,1.49,5544,62,0,3769,0,0,Fall,9313,62,0,True
2015,10/25,Houston,1.48,7202,65,0,4177,0,0,Fall,11379,65,0,True
2015,10/18,Houston,1.48,6905,39,0,3706,0,0,Fall,10611,39,0,True
2015,10/11,Houston,1.48,6510,106,0,4056,0,0,Fall,10566,106,0,True
2015,10/04,Houston,1.48,6511,101,0,4188,0,0,Fall,10699,101,0,True
2015,09/27,Houston,1.47,8647,58,0,3711,0,0,Fall,12358,58,0,True
2015,09/20,Houston,1.47,8733,46,0,3001,0,0,Fall,11734,46,0,True
2015,09/13,Houston,1.41,7965,33,0,5546,16,0,Fall,13511,49,0,True
2015,09/06,Houston,1.36,7609,67,0,1790,156,0,Fall,9399,223,0,True
2015,08/30,Houston,1.22,11507,50,0,1906,579,0,Summer,13413,629,0,True
2015,08/23,Houston,1.26,8896,94,0,1466,59,0,Summer,10362,153,0,True
2015,08/16,Houston,1.35,7995,74,0,1550,79,0,Summer,9545,153,0,True
2015,08/09,Houston,1.29,13102,114,0,1773,6,0,Summer,14875,120,0,True
2015,08/02,Houston,1.17,9679,116,0,146,10,0,Summer,9825,126,0,True
2015,07/26,Houston,1.19,12236,105,0,716,0,0,Summer,12952,105,0,True
2015,07/19,Houston,1.21,10034,358,0,93,0,0,Summer,10127,358,0,True
2015,07/12,Houston,1.17,11397,277,0,66,0,0,Summer,11463,277,0,True
2015,07/05,Houston,1.17,11733,353,0,630,0,0,Summer,12363,353,0,True
2015,06/28,Houston,1.21,9271,320,0,940,0,0,Summer,10211,320,0,True
2015,06/21,Houston,1.22,9667,465,0,1296,0,0,Summer,10963,465,0,True
2015,06/14,Houston,1.21,9298,406,0,760,0,0,Summer,10058,406,0,True
2015,06/07,Houston,1.19,9794,312,0,666,0,0,Summer,10460,312,0,True
2015,05/31,Houston,1.23,8711,189,0,990,0,0,Spring,9701,189,0,True
2015,05/24,Houston,1.26,11145,366,0,846,0,0,Spring,11991,366,0,True
2015,05/17,Houston,1.25,10234,351,0,440,0,0,Spring,10674,351,0,True
2015,05/10,Houston,1.28,9355,449,0,920,0,0,Spring,10275,449,0,True
2015,05/03,Houston,1.26,7306,252,0,973,0,0,Spring,8279,252,0,True
2015,04/26,Houston,1.26,10739,480,0,846,0,0,Spring,11585,480,0,True
2015,04/19,Houston,1.26,12200,522,0,1133,0,0,Spring,13333,522,0,True
2015,04/12,Houston,1.26,11423,490,0,466,0,0,Spring,11889,490,0,True
2015,04/05,Houston,1.25,10220,469,0,986,0,0,Spring,11206,469,0,True
2015,03/29,Houston,1.24,7514,836,0,856,0,0,Spring,8370,836,0,True
2015,03/22,Houston,1.24,9802,1065,0,1130,0,0,Spring,10932,1065,0,True
2015,03/15,Houston,1.27,9740,688,0,1943,0,0,Spring,11683,688,0,True
2015,03/08,Houston,1.31,7483,622,0,1106,0,0,Spring,8589,622,0,True
2015,03/01,Houston,1.2,9766,580,0,1413,0,0,Spring,11179,580,0,True
2015,02/22,Houston,1.26,9480,595,0,716,0,0,Winter,10196,595,0,True
2015,02/15,Houston,1.29,8813,586,0,1170,0,0,Winter,9983,586,0,True
2015,02/08,Houston,1.25,7272,704,0,1100,0,0,Winter,8372,704,0,True
2015,02/01,Houston,1.15,9833,1505,0,946,0,0,Winter,10779,1505,0,True
2015,01/25,Houston,1.24,9698,893,0,806,0,0,Winter,10504,893,0,True
2015,01/18,Houston,1.2,8538,690,0,750,0,0,Winter,9288,690,0,True
2015,01/11,Houston,1.26,6142,818,0,600,0,0,Winter,6742,818,0,True
2015,01/04,Houston,1.22,7009,671,0,1256,0,0,Winter,8265,671,0,True
2015,12/27,Indianapolis,1.49,207,1052,0,394,71,0,Winter,601,1123,0,True
2015,12/20,Indianapolis,1.61,289,1082,0,169,59,0,Winter,458,1141,0,True
2015,12/13,Indianapolis,1.35,275,926,0,184,682,0,Winter,459,1608,0,True
2015,12/06,Indianapolis,1.31,301,898,0,320,586,0,Winter,621,1484,0,True
2015,11/29,Indianapolis,1.52,213,676,0,26,238,0,Fall,239,914,0,True
2015,11/22,Indianapolis,1.57,239,1157,0,193,177,0,Fall,432,1334,0,True
2015,11/15,Indianapolis,1.54,170,1266,0,183,275,0,Fall,353,1541,0,True
2015,11/08,Indianapolis,1.57,241,957,0,203,307,0,Fall,444,1264,0,True
2015,11/01,Indianapolis,1.55,179,1061,0,276,388,0,Fall,455,1449,0,True
2015,10/25,Indianapolis,1.62,227,1202,0,446,271,0,Fall,673,1473,0,True
2015,10/18,Indianapolis,1.46,239,1072,0,503,575,0,Fall,742,1647,0,True
2015,10/11,Indianapolis,1.4,215,1146,0,176,491,0,Fall,391,1637,0,True
2015,10/04,Indianapolis,1.53,128,1322,0,343,372,0,Fall,471,1694,0,True
2015,09/27,Indianapolis,1.66,169,1231,0,166,146,0,Fall,335,1377,0,True
2015,09/20,Indianapolis,1.7,221,1243,0,470,24,0,Fall,691,1267,0,True
2015,09/13,Indianapolis,1.64,311,1618,0,326,255,0,Fall,637,1873,0,True
2015,09/06,Indianapolis,1.62,321,1731,0,413,328,0,Fall,734,2059,0,True
2015,08/30,Indianapolis,1.66,493,1711,0,323,354,0,Summer,816,2065,0,True
2015,08/23,Indianapolis,1.69,482,1602,0,470,303,0,Summer,952,1905,0,True
2015,08/16,Indianapolis,1.79,70,1510,0,420,308,0,Summer,490,1818,0,True
2015,08/09,Indianapolis,1.77,67,1564,0,443,243,0,Summer,510,1807,0,True
2015,08/02,Indianapolis,1.65,106,1348,0,240,329,0,Summer,346,1677,0,True
2015,07/26,Indianapolis,1.11,70,1177,0,330,1421,0,Summer,400,2598,0,True
2015,07/19,Indianapolis,0.99,84,1023,0,333,1844,0,Summer,417,2867,0,True
2015,07/12,Indianapolis,1.19,43,1060,0,625,1375,0,Summer,668,2435,0,True
2015,07/05,Indianapolis,1.11,59,963,0,470,1443,0,Summer,529,2406,0,True
2015,06/28,Indianapolis,1.58,77,870,0,211,370,0,Summer,288,1240,0,True
2015,06/21,Indianapolis,1.8,74,1040,0,326,149,0,Summer,400,1189,0,True
2015,06/14,Indianapolis,1.57,74,917,0,780,370,0,Summer,854,1287,0,True
2015,06/07,Indianapolis,1.45,54,941,0,521,487,0,Summer,575,1428,0,True
2015,05/31,Indianapolis,1.56,78,953,0,952,320,0,Spring,1030,1273,0,True
2015,05/24,Indianapolis,1.65,81,1193,0,853,233,0,Spring,934,1426,0,True
2015,05/17,Indianapolis,1.19,111,870,0,258,1122,0,Spring,369,1992,0,True
2015,05/10,Indianapolis,1.08,110,845,0,820,2394,0,Spring,930,3239,0,True
2015,05/03,Indianapolis,1.3,90,895,0,420,851,0,Spring,510,1746,0,True
2015,04/26,Indianapolis,1.69,75,1092,0,316,314,0,Spring,391,1406,0,True
2015,04/19,Indianapolis,1.78,93,1164,0,698,54,0,Spring,791,1218,0,True
2015,04/12,Indianapolis,1.76,79,1201,0,486,144,0,Spring,565,1345,0,True
2015,04/05,Indianapolis,1.49,66,1068,0,420,473,0,Spring,486,1541,0,True
2015,03/29,Indianapolis,1.81,50,812,0,225,80,0,Spring,275,892,0,True
2015,03/22,Indianapolis,1.95,76,841,0,3,42,0,Spring,79,883,0,True
2015,03/15,Indianapolis,1.78,97,905,0,121,189,0,Spring,218,1094,0,True
2015,03/08,Indianapolis,1.69,70,949,0,1026,159,0,Spring,1096,1108,0,True
2015,03/01,Indianapolis,1.79,54,948,0,580,41,0,Spring,634,989,0,True
2015,02/22,Indianapolis,1.87,104,1018,0,360,80,0,Winter,464,1098,0,True
2015,02/15,Indianapolis,1.77,88,956,0,450,106,0,Winter,538,1062,0,True
2015,02/08,Indianapolis,1.68,41,778,0,1226,38,0,Winter,1267,816,0,True
2015,02/01,Indianapolis,1.69,45,805,0,496,218,0,Winter,541,1023,0,True
2015,01/25,Indianapolis,1.78,49,765,0,286,119,0,Winter,335,884,0,True
2015,01/18,Indianapolis,1.96,45,925,0,105,7,0,Winter,150,932,0,True
2015,01/11,Indianapolis,1.83,95,921,0,357,35,0,Winter,452,956,0,True
2015,01/04,Indianapolis,1.63,76,874,0,542,286,0,Winter,618,1160,0,True
2015,12/27,Jacksonville,1.82,1154,45,28,526,0,0,Winter,1680,45,28,True
2015,12/20,Jacksonville,1.83,1078,55,15,593,0,0,Winter,1671,55,15,True
2015,12/13,Jacksonville,1.9,1132,42,10,293,0,0,Winter,1425,42,10,True
2015,12/06,Jacksonville,1.76,1762,43,18,256,0,0,Winter,2018,43,18,True
2015,11/29,Jacksonville,1.87,925,32,11,333,0,0,Fall,1258,32,11,True
2015,11/22,Jacksonville,1.9,1257,41,24,316,0,0,Fall,1573,41,24,True
2015,11/15,Jacksonville,1.88,1446,48,16,436,6,0,Fall,1882,54,16,True
2015,11/08,Jacksonville,1.83,1112,34,9,590,0,0,Fall,1702,34,9,True
2015,11/01,Jacksonville,1.82,1331,21,12,743,0,0,Fall,2074,21,12,True
2015,10/25,Jacksonville,1.89,1616,27,9,436,0,0,Fall,2052,27,9,True
2015,10/18,Jacksonville,2.26,1601,44,14,506,0,0,Fall,2107,44,14,True
2015,10/11,Jacksonville,2.11,1536,43,26,1000,0,0,Fall,2536,43,26,True
2015,10/04,Jacksonville,2.14,1102,50,5,650,0,0,Fall,1752,50,5,True
2015,09/27,Jacksonville,2.31,1229,49,20,293,0,0,Fall,1522,49,20,True
2015,09/20,Jacksonville,2.11,940,19,8,590,0,0,Fall,1530,19,8,True
2015,09/13,Jacksonville,2.18,1104,60,6,550,0,0,Fall,1654,60,6,True
2015,09/06,Jacksonville,2.07,1096,55,8,856,0,0,Fall,1952,55,8,True
2015,08/30,Jacksonville,1.93,1209,51,20,1170,0,0,Summer,2379,51,20,True
2015,08/23,Jacksonville,1.82,1313,55,25,1662,0,0,Summer,2975,55,25,True
2015,08/16,Jacksonville,1.69,1275,49,9,2269,17,0,Summer,3544,66,9,True
2015,08/09,Jacksonville,2.19,1394,60,25,577,0,0,Summer,1971,60,25,True
2015,08/02,Jacksonville,2.21,1338,61,27,552,0,0,Summer,1890,61,27,True
2015,07/26,Jacksonville,1.83,1275,44,25,1496,0,0,Summer,2771,44,25,True
2015,07/19,Jacksonville,1.63,1209,23,34,2330,0,0,Summer,3539,23,34,True
2015,07/12,Jacksonville,1.91,1209,47,18,2478,0,0,Summer,3687,47,18,True
2015,07/05,Jacksonville,1.87,1263,65,9,450,0,0,Summer,1713,65,9,True
2015,06/28,Jacksonville,1.95,1515,85,16,150,7,0,Summer,1665,92,16,True
2015,06/21,Jacksonville,1.92,1551,114,10,310,2,0,Summer,1861,116,10,True
2015,06/14,Jacksonville,1.88,1621,60,16,480,30,0,Summer,2101,90,16,True
2015,06/07,Jacksonville,1.64,3240,118,12,743,0,0,Summer,3983,118,12,True
2015,05/31,Jacksonville,1.83,1343,17,22,670,0,0,Spring,2013,17,22,True
2015,05/24,Jacksonville,1.83,1521,68,14,846,0,0,Spring,2367,68,14,True
2015,05/17,Jacksonville,1.75,1550,186,248,485,0,0,Spring,2035,186,248,True
2015,05/10,Jacksonville,1.81,1296,45,33,906,0,0,Spring,2202,45,33,True
2015,05/03,Jacksonville,1.82,1314,26,30,708,0,0,Spring,2022,26,30,True
2015,04/26,Jacksonville,1.88,1426,36,30,510,0,0,Spring,1936,36,30,True
2015,04/19,Jacksonville,1.82,1375,35,13,652,0,0,Spring,2027,35,13,True
2015,04/12,Jacksonville,1.89,1407,56,20,406,0,0,Spring,1813,56,20,True
2015,04/05,Jacksonville,1.81,1209,64,48,557,5,0,Spring,1766,69,48,True
2015,03/29,Jacksonville,1.76,1346,65,17,777,8,0,Spring,2123,73,17,True
2015,03/22,Jacksonville,1.78,1175,58,29,923,0,0,Spring,2098,58,29,True
2015,03/15,Jacksonville,1.86,1284,60,32,513,0,0,Spring,1797,60,32,True
2015,03/08,Jacksonville,1.81,1300,53,18,850,0,0,Spring,2150,53,18,True
2015,03/01,Jacksonville,1.75,1007,30,25,1013,0,0,Spring,2020,30,25,True
2015,02/22,Jacksonville,1.77,955,49,4,853,0,0,Winter,1808,49,4,True
2015,02/15,Jacksonville,1.82,1079,45,16,616,0,0,Winter,1695,45,16,True
2015,02/08,Jacksonville,1.71,892,63,14,1273,0,0,Winter,2165,63,14,True
2015,02/01,Jacksonville,1.76,805,60,5,720,0,0,Winter,1525,60,5,True
2015,01/25,Jacksonville,1.88,853,22,1,263,0,0,Winter,1116,22,1,True
2015,01/18,Jacksonville,1.82,846,55,1,500,0,0,Winter,1346,55,1,True
2015,01/11,Jacksonville,1.91,978,24,5,240,0,0,Winter,1218,24,5,True
2015,01/04,Jacksonville,1.81,803,47,6,523,0,0,Winter,1326,47,6,True
2015,12/27,LasVegas,1.94,1188,2391,0,701,314,0,Winter,1889,2705,0,True
2015,12/20,LasVegas,1.99,1672,2841,0,258,149,0,Winter,1930,2990,0,True
2015,12/13,LasVegas,1.89,1979,3117,0,408,100,0,Winter,2387,3217,0,True
2015,12/06,LasVegas,1.97,2223,2159,0,76,0,0,Winter,2299,2159,0,True
2015,11/29,LasVegas,2.17,1460,2505,0,30,0,0,Fall,1490,2505,0,True
2015,11/22,LasVegas,2.03,2047,2644,0,40,0,0,Fall,2087,2644,0,True
2015,11/15,LasVegas,2.05,1845,2977,0,43,114,0,Fall,1888,3091,0,True
2015,11/08,LasVegas,1.96,2671,2753,0,123,50,0,Fall,2794,2803,0,True
2015,11/01,LasVegas,1.88,1735,3115,0,153,0,0,Fall,1888,3115,0,True
2015,10/25,LasVegas,2.16,1225,2724,0,256,16,0,Fall,1481,2740,0,True
2015,10/18,LasVegas,2.21,1353,2836,0,223,6,0,Fall,1576,2842,0,True
2015,10/11,LasVegas,2.22,1288,2770,0,296,0,0,Fall,1584,2770,0,True
2015,10/04,LasVegas,2.31,1209,3328,0,116,0,0,Fall,1325,3328,0,True
2015,09/27,LasVegas,1.85,1243,4399,0,103,10,0,Fall,1346,4409,0,True
2015,09/20,LasVegas,2.4,693,2696,0,23,0,0,Fall,716,2696,0,True
2015,09/13,LasVegas,2.34,847,2556,0,270,109,0,Fall,1117,2665,0,True
2015,09/06,LasVegas,2.14,3062,3222,0,0,438,0,Fall,3062,3660,0,True
2015,08/30,LasVegas,1.75,3905,3627,0,67,560,0,Summer,3972,4187,0,True
2015,08/23,LasVegas,1.62,4150,3628,0,361,535,0,Summer,4511,4163,0,True
2015,08/16,LasVegas,1.63,3299,4589,0,580,81,0,Summer,3879,4670,0,True
2015,08/09,LasVegas,1.82,4016,3256,0,413,87,0,Summer,4429,3343,0,True
2015,08/02,LasVegas,1.8,4950,3751,0,296,67,0,Summer,5246,3818,0,True
2015,07/26,LasVegas,1.85,3052,3504,0,16,201,0,Summer,3068,3705,0,True
2015,07/19,LasVegas,1.92,1717,3137,0,23,179,0,Summer,1740,3316,0,True
2015,07/12,LasVegas,2.09,1393,3460,0,103,41,0,Summer,1496,3501,0,True
2015,07/05,LasVegas,1.6,4751,5225,0,235,280,0,Summer,4986,5505,0,True
2015,06/28,LasVegas,1.54,5745,4602,0,110,640,0,Summer,5855,5242,0,True
2015,06/21,LasVegas,1.51,6354,4456,0,174,240,0,Summer,6528,4696,0,True
2015,06/14,LasVegas,1.44,4423,4826,0,305,796,0,Summer,4728,5622,0,True
2015,06/07,LasVegas,1.43,5155,4362,0,416,870,0,Summer,5571,5232,0,True
2015,05/31,LasVegas,1.35,5870,4092,0,486,1017,0,Spring,6356,5109,0,True
2015,05/24,LasVegas,1.33,6688,4328,0,343,939,0,Spring,7031,5267,0,True
2015,05/17,LasVegas,1.35,6463,4621,0,330,1055,0,Spring,6793,5676,0,True
2015,05/10,LasVegas,1.34,5433,3859,0,433,785,0,Spring,5866,4644,0,True
2015,05/03,LasVegas,1.41,4718,4211,0,451,787,0,Spring,5169,4998,0,True
2015,04/26,LasVegas,1.76,3751,7660,0,560,462,0,Spring,4311,8122,0,True
2015,04/19,LasVegas,1.43,5673,3973,0,233,646,0,Spring,5906,4619,0,True
2015,04/12,LasVegas,1.56,4396,3477,0,450,570,0,Spring,4846,4047,0,True
2015,04/05,LasVegas,1.67,4828,3641,0,545,340,0,Spring,5373,3981,0,True
2015,03/29,LasVegas,1.43,5071,3688,0,687,22,0,Spring,5758,3710,0,True
2015,03/22,LasVegas,1.46,4449,3881,0,690,0,0,Spring,5139,3881,0,True
2015,03/15,LasVegas,1.89,1974,2783,0,66,35,0,Spring,2040,2818,0,True
2015,03/08,LasVegas,1.78,2676,2766,0,453,14,0,Spring,3129,2780,0,True
2015,03/01,LasVegas,1.61,4161,2885,0,820,0,0,Spring,4981,2885,0,True
2015,02/22,LasVegas,1.79,3979,3109,0,86,3,0,Winter,4065,3112,0,True
2015,02/15,LasVegas,1.79,3336,2622,0,300,0,0,Winter,3636,2622,0,True
2015,02/08,LasVegas,1.68,3705,2718,0,713,0,0,Winter,4418,2718,0,True
2015,02/01,LasVegas,1.6,4366,2884,0,383,0,0,Winter,4749,2884,0,True
2015,01/25,LasVegas,1.66,2421,3050,0,273,13,0,Winter,2694,3063,0,True
2015,01/18,LasVegas,1.63,3449,1769,0,813,0,0,Winter,4262,1769,0,True
2015,01/11,LasVegas,1.54,4027,2083,0,33,0,0,Winter,4060,2083,0,True
2015,01/04,LasVegas,1.5,3730,2141,0,426,30,0,Winter,4156,2171,0,True
2015,12/27,LosAngeles,1.21,8914,15290,0,25485,2784,0,Winter,34399,18074,0,True
2015,12/20,LosAngeles,1.11,7660,13978,1,22728,8801,0,Winter,30388,22779,1,True
2015,12/13,LosAngeles,1.14,8067,13612,0,21066,9165,0,Winter,29133,22777,0,True
2015,12/06,LosAngeles,1.23,9738,11520,1,21632,165,0,Winter,31370,11685,1,True
2015,11/29,LosAngeles,1.33,8753,14877,0,19134,169,0,Fall,27887,15046,0,True
2015,11/22,LosAngeles,1.34,10035,15296,0,19978,377,0,Fall,30013,15673,0,True
2015,11/15,LosAngeles,1.31,10986,18709,0,18988,517,0,Fall,29974,19226,0,True
2015,11/08,LosAngeles,1.42,11093,19386,0,17164,1052,0,Fall,28257,20438,0,True
2015,11/01,LosAngeles,1.36,13987,20741,0,17485,602,0,Fall,31472,21343,0,True
2015,10/25,LosAngeles,1.41,13800,21060,0,12992,945,0,Fall,26792,22005,0,True
2015,10/18,LosAngeles,1.62,10370,16004,3,6393,966,0,Fall,16763,16970,3,True
2015,10/11,LosAngeles,1.72,8093,14759,3,5146,60,0,Fall,13239,14819,3,True
2015,10/04,LosAngeles,1.68,11737,17362,0,5303,40,0,Fall,17040,17402,0,True
2015,09/27,LosAngeles,1.51,13181,17468,0,7672,10,0,Fall,20853,17478,0,True
2015,09/20,LosAngeles,1.57,20900,18316,0,4216,16,0,Fall,25116,18332,0,True
2015,09/13,LosAngeles,1.66,26153,15358,0,3985,36,0,Fall,30138,15394,0,True
2015,09/06,LosAngeles,1.6,16410,16444,0,7686,0,0,Fall,24096,16444,0,True
2015,08/30,LosAngeles,1.58,15094,16296,0,9264,0,0,Summer,24358,16296,0,True
2015,08/23,LosAngeles,1.52,19022,20438,3,10769,0,0,Summer,29791,20438,3,True
2015,08/16,LosAngeles,1.55,15077,13358,0,11107,0,0,Summer,26184,13358,0,True
2015,08/09,LosAngeles,1.61,13861,13291,0,8477,0,0,Summer,22338,13291,0,True
2015,08/02,LosAngeles,1.63,16172,16827,0,7544,0,0,Summer,23716,16827,0,True
2015,07/26,LosAngeles,1.53,17779,18294,0,7729,0,0,Summer,25508,18294,0,True
2015,07/19,LosAngeles,1.56,17780,15390,0,8466,0,0,Summer,26246,15390,0,True
2015,07/12,LosAngeles,1.59,18271,13741,1,7147,8,0,Summer,25418,13749,1,True
2015,07/05,LosAngeles,1.46,17846,30121,4,8956,0,0,Summer,26802,30121,4,True
2015,06/28,LosAngeles,1.47,15429,25963,0,7027,0,0,Summer,22456,25963,0,True
2015,06/21,LosAngeles,1.46,16257,20593,0,8501,0,0,Summer,24758,20593,0,True
2015,06/14,LosAngeles,1.44,15847,18470,22,8029,0,0,Summer,23876,18470,22,True
2015,06/07,LosAngeles,1.42,14739,19066,6,10222,0,0,Summer,24961,19066,6,True
2015,05/31,LosAngeles,1.4,14419,19119,0,11066,0,0,Spring,25485,19119,0,True
2015,05/24,LosAngeles,1.42,15437,24124,0,9509,0,0,Spring,24946,24124,0,True
2015,05/17,LosAngeles,1.41,14135,20351,0,9420,0,0,Spring,23555,20351,0,True
2015,05/10,LosAngeles,1.39,12338,19929,0,9863,0,0,Spring,22201,19929,0,True
2015,05/03,LosAngeles,1.36,14801,17706,0,10607,0,0,Spring,25408,17706,0,True
2015,04/26,LosAngeles,1.4,15815,17652,0,10622,0,0,Spring,26437,17652,0,True
2015,04/19,LosAngeles,1.41,14352,21089,1,9244,0,0,Spring,23596,21089,1,True
2015,04/12,LosAngeles,1.39,17119,17886,0,8402,0,0,Spring,25521,17886,0,True
2015,04/05,LosAngeles,1.42,16980,17529,0,10474,0,0,Spring,27454,17529,0,True
2015,03/29,LosAngeles,1.42,13962,12697,0,8462,0,0,Spring,22424,12697,0,True
2015,03/22,LosAngeles,1.25,22334,12861,0,6243,0,0,Spring,28577,12861,0,True
2015,03/15,LosAngeles,1.42,25316,1120,0,6218,0,0,Spring,31534,1120,0,True
2015,03/08,LosAngeles,1.35,31604,769,0,9906,0,0,Spring,41510,769,0,True
2015,03/01,LosAngeles,1.14,49177,1680,0,9386,0,0,Spring,58563,1680,0,True
2015,02/22,LosAngeles,1.36,36585,905,0,7481,0,0,Winter,44066,905,0,True
2015,02/15,LosAngeles,1.43,33427,1026,0,7070,0,0,Winter,40497,1026,0,True
2015,02/08,LosAngeles,1.29,36957,2213,0,7820,0,0,Winter,44777,2213,0,True
2015,02/01,LosAngeles,1.12,39628,1721,0,8756,0,0,Winter,48384,1721,0,True
2015,01/25,LosAngeles,1.23,28037,1355,0,8684,0,0,Winter,36721,1355,0,True
2015,01/18,LosAngeles,1.29,33738,1368,0,8541,0,0,Winter,42279,1368,0,True
2015,01/11,LosAngeles,1.08,52087,2063,0,6081,0,0,Winter,58168,2063,0,True
2015,01/04,LosAngeles,1.25,47721,1723,0,5050,0,0,Winter,52771,1723,0,True
2015,12/27,Louisville,1.82,9,690,0,60,102,0,Winter,69,792,0,True
2015,12/20,Louisville,1.8,33,833,0,13,44,0,Winter,46,877,0,True
2015,12/13,Louisville,1.52,28,798,0,0,284,0,Winter,28,1082,0,True
2015,12/06,Louisville,1.19,15,868,0,0,507,0,Winter,15,1375,0,True
2015,11/29,Louisville,1.19,34,805,0,0,651,0,Fall,34,1456,0,True
2015,11/22,Louisville,1.87,7,1107,0,3,84,0,Fall,10,1191,0,True
2015,11/15,Louisville,1.83,2,1014,0,106,32,0,Fall,108,1046,0,True
2015,11/08,Louisville,1.68,43,894,0,153,181,0,Fall,196,1075,0,True
2015,11/01,Louisville,1.65,48,835,0,43,228,0,Fall,91,1063,0,True
2015,10/25,Louisville,1.64,69,1631,0,0,78,0,Fall,69,1709,0,True
2015,10/18,Louisville,1.52,20,1442,0,0,233,0,Fall,20,1675,0,True
2015,10/11,Louisville,1.65,11,988,0,0,243,0,Fall,11,1231,0,True
2015,10/04,Louisville,1.87,23,1114,0,0,17,0,Fall,23,1131,0,True
2015,09/27,Louisville,1.79,24,1309,0,206,62,0,Fall,230,1371,0,True
2015,09/20,Louisville,1.65,40,1268,0,423,241,0,Fall,463,1509,0,True
2015,09/13,Louisville,1.69,44,1311,0,286,214,0,Fall,330,1525,0,True
2015,09/06,Louisville,1.38,52,1262,0,440,696,0,Fall,492,1958,0,True
2015,08/30,Louisville,1.44,58,1634,0,273,681,0,Summer,331,2315,0,True
2015,08/23,Louisville,1.49,42,1625,0,256,801,0,Summer,298,2426,0,True
2015,08/16,Louisville,1.52,3,1866,0,243,381,0,Summer,246,2247,0,True
2015,08/09,Louisville,1.37,2,2116,0,400,484,0,Summer,402,2600,0,True
2015,08/02,Louisville,1.37,4,1786,0,36,649,0,Summer,40,2435,0,True
2015,07/26,Louisville,1.03,0,1295,0,40,1660,0,Summer,40,2955,0,True
2015,07/19,Louisville,1.18,0,1436,0,53,1190,0,Summer,53,2626,0,True
2015,07/12,Louisville,1.48,7,1486,0,70,726,0,Summer,77,2212,0,True
2015,07/05,Louisville,1.49,0,1260,0,246,610,0,Summer,246,1870,0,True
2015,06/28,Louisville,1.49,8,1260,0,233,242,0,Summer,241,1502,0,True
2015,06/21,Louisville,1.46,18,1652,0,224,447,0,Summer,242,2099,0,True
2015,06/14,Louisville,1.58,17,1174,0,415,485,0,Summer,432,1659,0,True
2015,06/07,Louisville,1.24,14,972,0,437,876,0,Summer,451,1848,0,True
2015,05/31,Louisville,1.34,8,1031,0,370,691,0,Spring,378,1722,0,True
2015,05/24,Louisville,1.51,3,1340,0,438,503,0,Spring,441,1843,0,True
2015,05/17,Louisville,1.44,2,1335,0,458,335,0,Spring,460,1670,0,True
2015,05/10,Louisville,1.04,12,1328,0,390,1624,0,Spring,402,2952,0,True
2015,05/03,Louisville,1.38,1,829,0,463,744,0,Spring,464,1573,0,True
2015,04/26,Louisville,1.67,1,1045,0,373,344,0,Spring,374,1389,0,True
2015,04/19,Louisville,1.37,0,914,0,246,525,0,Spring,246,1439,0,True
2015,04/12,Louisville,1.42,8,799,0,263,222,0,Spring,271,1021,0,True
2015,04/05,Louisville,1.59,4,896,0,330,286,0,Spring,334,1182,0,True
2015,03/29,Louisville,1.63,0,685,0,279,254,0,Spring,279,939,0,True
2015,03/22,Louisville,1.76,10,746,0,113,160,0,Spring,123,906,0,True
2015,03/15,Louisville,1.65,8,731,0,796,128,0,Spring,804,859,0,True
2015,03/08,Louisville,1.72,2,912,0,532,93,0,Spring,534,1005,0,True
2015,03/01,Louisville,1.65,0,1077,0,213,219,0,Spring,213,1296,0,True
2015,02/22,Louisville,1.67,14,658,0,443,231,0,Winter,457,889,0,True
2015,02/15,Louisville,1.75,12,745,0,326,116,0,Winter,338,861,0,True
2015,02/08,Louisville,1.61,13,823,0,393,207,0,Winter,406,1030,0,True
2015,02/01,Louisville,1.55,0,772,0,303,260,0,Winter,303,1032,0,True
2015,01/25,Louisville,1.68,3,740,0,216,240,0,Winter,219,980,0,True
2015,01/18,Louisville,1.79,5,676,0,420,5,0,Winter,425,681,0,True
2015,01/11,Louisville,1.79,0,1219,0,173,42,0,Winter,173,1261,0,True
2015,01/04,Louisville,1.48,12,824,0,478,80,0,Winter,490,904,0,True
2015,12/27,MiamiFtLauderdale,1.57,120,18,0,1016,0,0,Winter,1136,18,0,True
2015,12/20,MiamiFtLauderdale,1.5,34,1,0,1527,0,0,Winter,1561,1,0,True
2015,12/13,MiamiFtLauderdale,1.5,8,11,0,1345,0,0,Winter,1353,11,0,True
2015,12/06,MiamiFtLauderdale,1.49,2,1,0,1043,6,0,Winter,1045,7,0,True
2015,11/29,MiamiFtLauderdale,1.51,4,14,0,1184,0,0,Fall,1188,14,0,True
2015,11/22,MiamiFtLauderdale,1.11,4,7,0,642,3,0,Fall,646,10,0,True
2015,11/15,MiamiFtLauderdale,1.44,3,1,0,2696,6,0,Fall,2699,7,0,True
2015,11/08,MiamiFtLauderdale,1.59,3,3,0,73,3,0,Fall,76,6,0,True
2015,11/01,MiamiFtLauderdale,1.5,3,1,0,1946,3,0,Fall,1949,4,0,True
2015,10/25,MiamiFtLauderdale,1.5,6,5,0,1473,0,0,Fall,1479,5,0,True
2015,10/18,MiamiFtLauderdale,1.51,6,14,0,880,0,0,Fall,886,14,0,True
2015,10/11,MiamiFtLauderdale,1.51,12,3,0,1763,0,0,Fall,1775,3,0,True
2015,10/04,MiamiFtLauderdale,1.5,9,2,0,1571,0,0,Fall,1580,2,0,True
2015,09/27,MiamiFtLauderdale,1.5,11,2,0,808,0,0,Fall,819,2,0,True
2015,09/20,MiamiFtLauderdale,1.47,25,1,0,1817,0,0,Fall,1842,1,0,True
2015,09/13,MiamiFtLauderdale,1.43,10,5,0,989,0,0,Fall,999,5,0,True
2015,09/06,MiamiFtLauderdale,1.47,4,5,0,1952,0,0,Fall,1956,5,0,True
2015,08/30,MiamiFtLauderdale,1.47,6,11,0,1339,0,0,Summer,1345,11,0,True
2015,08/23,MiamiFtLauderdale,1.5,7,1,0,1050,0,0,Summer,1057,1,0,True
2015,08/16,MiamiFtLauderdale,1.51,6,22,0,1136,0,0,Summer,1142,22,0,True
2015,08/09,MiamiFtLauderdale,1.5,8,7,0,1343,0,0,Summer,1351,7,0,True
2015,08/02,MiamiFtLauderdale,1.51,5,16,0,993,0,0,Summer,998,16,0,True
2015,07/26,MiamiFtLauderdale,1.48,5,6,0,556,3,0,Summer,561,9,0,True
2015,07/19,MiamiFtLauderdale,1.45,5,1,0,786,0,0,Summer,791,1,0,True
2015,07/12,MiamiFtLauderdale,1.56,85,2,0,1663,0,0,Summer,1748,2,0,True
2015,07/05,MiamiFtLauderdale,1.88,921,5,0,840,0,0,Summer,1761,5,0,True
2015,06/28,MiamiFtLauderdale,1.86,1181,9,0,436,0,0,Summer,1617,9,0,True
2015,06/21,MiamiFtLauderdale,1.92,1247,6,0,161,0,0,Summer,1408,6,0,True
2015,06/14,MiamiFtLauderdale,1.81,1278,13,0,724,0,0,Summer,2002,13,0,True
2015,06/07,MiamiFtLauderdale,1.75,1085,19,0,988,0,0,Summer,2073,19,0,True
2015,05/31,MiamiFtLauderdale,1.72,1172,12,0,1393,0,0,Spring,2565,12,0,True
2015,05/24,MiamiFtLauderdale,1.77,1036,16,0,751,8,0,Spring,1787,24,0,True
2015,05/17,MiamiFtLauderdale,1.79,1251,48,0,827,13,0,Spring,2078,61,0,True
2015,05/10,MiamiFtLauderdale,1.77,1393,8,0,759,22,0,Spring,2152,30,0,True
2015,05/03,MiamiFtLauderdale,1.35,3106,154,0,1509,0,0,Spring,4615,154,0,True
2015,04/26,MiamiFtLauderdale,1.25,5848,488,0,294,0,0,Spring,6142,488,0,True
2015,04/19,MiamiFtLauderdale,1.61,1344,31,0,1498,5,0,Spring,2842,36,0,True
2015,04/12,MiamiFtLauderdale,1.81,1456,35,0,386,0,0,Spring,1842,35,0,True
2015,04/05,MiamiFtLauderdale,1.86,1231,22,0,447,0,0,Spring,1678,22,0,True
2015,03/29,MiamiFtLauderdale,1.83,1818,35,0,849,19,0,Spring,2667,54,0,True
2015,03/22,MiamiFtLauderdale,1.82,1129,24,0,590,11,0,Spring,1719,35,0,True
2015,03/15,MiamiFtLauderdale,1.73,1133,11,0,1333,0,0,Spring,2466,11,0,True
2015,03/08,MiamiFtLauderdale,1.69,1060,15,0,1633,0,0,Spring,2693,15,0,True
2015,03/01,MiamiFtLauderdale,1.75,1033,2,0,1000,0,0,Spring,2033,2,0,True
2015,02/22,MiamiFtLauderdale,1.92,1140,19,0,223,3,0,Winter,1363,22,0,True
2015,02/15,MiamiFtLauderdale,1.75,908,2,0,880,0,0,Winter,1788,2,0,True
2015,02/08,MiamiFtLauderdale,1.72,945,0,0,1173,0,0,Winter,2118,0,0,True
2015,02/01,MiamiFtLauderdale,1.73,827,16,0,923,0,0,Winter,1750,16,0,True
2015,01/25,MiamiFtLauderdale,1.84,1091,26,0,530,0,0,Winter,1621,26,0,True
2015,01/18,MiamiFtLauderdale,1.87,1054,17,0,386,0,0,Winter,1440,17,0,True
2015,01/11,MiamiFtLauderdale,1.85,1091,49,0,473,0,0,Winter,1564,49,0,True
2015,01/04,MiamiFtLauderdale,1.82,1438,53,0,796,0,0,Winter,2234,53,0,True
2015,12/27,Nashville,1.62,501,2284,0,840,269,0,Winter,1341,2553,0,True
2015,12/20,Nashville,1.66,479,2713,0,533,38,0,Winter,1012,2751,0,True
2015,12/13,Nashville,1.53,592,2602,0,696,702,0,Winter,1288,3304,0,True
2015,12/06,Nashville,1.49,394,2569,0,620,621,0,Winter,1014,3190,0,True
2015,11/29,Nashville,1.21,373,2589,0,436,1743,0,Fall,809,4332,0,True
2015,11/22,Nashville,1.66,329,3186,0,616,148,0,Fall,945,3334,0,True
2015,11/15,Nashville,1.65,453,3405,0,986,119,0,Fall,1439,3524,0,True
2015,11/08,Nashville,1.59,585,3241,0,1103,375,0,Fall,1688,3616,0,True
2015,11/01,Nashville,1.63,580,3237,0,883,264,0,Fall,1463,3501,0,True
2015,10/25,Nashville,1.69,668,3697,0,643,68,0,Fall,1311,3765,0,True
2015,10/18,Nashville,1.66,660,2930,0,930,158,0,Fall,1590,3088,0,True
2015,10/11,Nashville,1.55,609,3428,0,296,640,0,Fall,905,4068,0,True
2015,10/04,Nashville,1.75,533,3976,0,576,5,0,Fall,1109,3981,0,True
2015,09/27,Nashville,1.7,459,3564,0,126,201,0,Fall,585,3765,0,True
2015,09/20,Nashville,1.74,424,3661,0,13,82,0,Fall,437,3743,0,True
2015,09/13,Nashville,1.53,409,4994,0,638,700,0,Fall,1047,5694,0,True
2015,09/06,Nashville,1.31,355,5187,0,986,1696,0,Fall,1341,6883,0,True
2015,08/30,Nashville,1.45,378,5319,0,1074,328,0,Summer,1452,5647,0,True
2015,08/23,Nashville,1.36,388,4852,0,1287,1240,0,Summer,1675,6092,0,True
2015,08/16,Nashville,1.4,324,4650,0,1246,980,0,Summer,1570,5630,0,True
2015,08/09,Nashville,1.43,384,5358,0,705,993,0,Summer,1089,6351,0,True
2015,08/02,Nashville,1.43,428,6058,0,694,902,0,Summer,1122,6960,0,True
2015,07/26,Nashville,1.15,385,5220,0,576,2991,0,Summer,961,8211,0,True
2015,07/19,Nashville,1.23,266,4409,0,1228,1826,0,Summer,1494,6235,0,True
2015,07/12,Nashville,1.28,373,4517,0,988,1875,0,Summer,1361,6392,0,True
2015,07/05,Nashville,1.23,338,4695,0,326,1788,0,Summer,664,6483,0,True
2015,06/28,Nashville,1.47,389,4223,0,393,884,0,Summer,782,5107,0,True
2015,06/21,Nashville,1.8,402,4021,0,376,458,0,Summer,778,4479,0,True
2015,06/14,Nashville,1.76,335,3570,0,400,679,0,Summer,735,4249,0,True
2015,06/07,Nashville,1.25,316,3217,0,498,2692,0,Summer,814,5909,0,True
2015,05/31,Nashville,1.55,380,2767,0,835,1001,0,Spring,1215,3768,0,True
2015,05/24,Nashville,1.35,368,3203,0,863,2141,0,Spring,1231,5344,0,True
2015,05/17,Nashville,1.55,383,4720,0,884,378,0,Spring,1267,5098,0,True
2015,05/10,Nashville,1.13,369,4669,18,750,3658,0,Spring,1119,8327,18,True
2015,05/03,Nashville,1.57,334,2364,68,719,1042,0,Spring,1053,3406,68,True
2015,04/26,Nashville,1.68,255,3162,53,345,1005,0,Spring,600,4167,53,True
2015,04/19,Nashville,1.45,355,6291,52,655,1812,0,Spring,1010,8103,52,True
2015,04/12,Nashville,1.5,493,4812,83,301,915,0,Spring,794,5727,83,True
2015,04/05,Nashville,1.66,261,3354,116,938,580,0,Spring,1199,3934,116,True
2015,03/29,Nashville,1.67,334,2754,96,580,690,0,Spring,914,3444,96,True
2015,03/22,Nashville,1.64,297,2408,51,306,748,0,Spring,603,3156,51,True
2015,03/15,Nashville,1.78,230,2525,54,263,125,0,Spring,493,2650,54,True
2015,03/08,Nashville,1.8,213,2967,110,916,23,0,Spring,1129,2990,110,True
2015,03/01,Nashville,1.76,217,3226,101,556,167,0,Spring,773,3393,101,True
2015,02/22,Nashville,1.32,299,8060,53,1166,210,0,Winter,1465,8270,53,True
2015,02/15,Nashville,1.11,244,8525,89,250,1471,0,Winter,494,9996,89,True
2015,02/08,Nashville,1.64,249,2704,124,743,792,0,Winter,992,3496,124,True
2015,02/01,Nashville,1.65,213,2682,99,603,606,0,Winter,816,3288,99,True
2015,01/25,Nashville,1.71,192,2511,60,850,834,0,Winter,1042,3345,60,True
2015,01/18,Nashville,1.81,188,1951,86,773,119,0,Winter,961,2070,86,True
2015,01/11,Nashville,1.92,204,2168,80,435,3,0,Winter,639,2171,80,True
2015,01/04,Nashville,1.84,244,2700,76,838,107,0,Winter,1082,2807,76,True
2015,12/27,NewOrleansMobile,1.55,383,5,0,1826,0,0,Winter,2209,5,0,True
2015,12/20,NewOrleansMobile,1.66,470,0,0,1351,0,0,Winter,1821,0,0,True
2015,12/13,NewOrleansMobile,1.6,424,0,0,1104,0,0,Winter,1528,0,0,True
2015,12/06,NewOrleansMobile,1.35,294,0,0,1916,0,0,Winter,2210,0,0,True
2015,11/29,NewOrleansMobile,1.58,221,0,0,1812,6,0,Fall,2033,6,0,True
2015,11/22,NewOrleansMobile,1.7,286,0,0,1069,0,0,Fall,1355,0,0,True
2015,11/15,NewOrleansMobile,1.7,425,0,0,1321,3,0,Fall,1746,3,0,True
2015,11/08,NewOrleansMobile,1.52,249,5,0,3257,0,0,Fall,3506,5,0,True
2015,11/01,NewOrleansMobile,1.67,334,94,0,1280,3,0,Fall,1614,97,0,True
2015,10/25,NewOrleansMobile,1.45,251,94,0,2968,0,0,Fall,3219,94,0,True
2015,10/18,NewOrleansMobile,1.52,366,93,0,2688,0,0,Fall,3054,93,0,True
2015,10/11,NewOrleansMobile,1.54,398,94,0,2616,23,0,Fall,3014,117,0,True
2015,10/04,NewOrleansMobile,1.61,244,104,0,2681,13,0,Fall,2925,117,0,True
2015,09/27,NewOrleansMobile,1.68,390,71,0,1285,0,0,Fall,1675,71,0,True
2015,09/20,NewOrleansMobile,1.65,291,82,0,1745,0,0,Fall,2036,82,0,True
2015,09/13,NewOrleansMobile,1.62,310,107,0,1935,0,0,Fall,2245,107,0,True
2015,09/06,NewOrleansMobile,1.59,280,136,0,2153,0,0,Fall,2433,136,0,True
2015,08/30,NewOrleansMobile,1.08,206,136,0,4257,0,0,Summer,4463,136,0,True
2015,08/23,NewOrleansMobile,1.63,257,222,0,1792,0,0,Summer,2049,222,0,True
2015,08/16,NewOrleansMobile,1.55,256,119,0,2421,0,0,Summer,2677,119,0,True
2015,08/09,NewOrleansMobile,1.69,383,255,0,1809,0,0,Summer,2192,255,0,True
2015,08/02,NewOrleansMobile,1.86,468,258,0,850,0,0,Summer,1318,258,0,True
2015,07/26,NewOrleansMobile,1.59,339,76,0,877,48,0,Summer,1216,124,0,True
2015,07/19,NewOrleansMobile,1.45,290,100,0,1864,108,0,Summer,2154,208,0,True
2015,07/12,NewOrleansMobile,1.55,221,5,0,2000,0,0,Summer,2221,5,0,True
2015,07/05,NewOrleansMobile,1.58,349,62,0,1816,0,0,Summer,2165,62,0,True
2015,06/28,NewOrleansMobile,1.61,428,185,0,1863,0,0,Summer,2291,185,0,True
2015,06/21,NewOrleansMobile,1.64,569,218,0,1990,0,0,Summer,2559,218,0,True
2015,06/14,NewOrleansMobile,1.63,536,54,0,1670,0,0,Summer,2206,54,0,True
2015,06/07,NewOrleansMobile,1.54,773,24,0,975,0,0,Summer,1748,24,0,True
2015,05/31,NewOrleansMobile,1.55,495,11,0,2211,0,0,Spring,2706,11,0,True
2015,05/24,NewOrleansMobile,1.61,434,16,0,1204,0,0,Spring,1638,16,0,True
2015,05/17,NewOrleansMobile,1.53,395,0,0,1387,0,0,Spring,1782,0,0,True
2015,05/10,NewOrleansMobile,1.6,348,0,0,1065,3,0,Spring,1413,3,0,True
2015,05/03,NewOrleansMobile,1.55,238,41,0,1189,0,0,Spring,1427,41,0,True
2015,04/26,NewOrleansMobile,1.56,353,83,0,2310,0,0,Spring,2663,83,0,True
2015,04/19,NewOrleansMobile,1.57,414,0,0,1964,0,0,Spring,2378,0,0,True
2015,04/12,NewOrleansMobile,1.58,417,2,0,2183,0,0,Spring,2600,2,0,True
2015,04/05,NewOrleansMobile,1.53,418,74,0,4327,0,0,Spring,4745,74,0,True
2015,03/29,NewOrleansMobile,1.57,527,19,0,2783,0,0,Spring,3310,19,0,True
2015,03/22,NewOrleansMobile,1.56,428,30,0,2110,0,0,Spring,2538,30,0,True
2015,03/15,NewOrleansMobile,1.55,317,43,0,2593,0,0,Spring,2910,43,0,True
2015,03/08,NewOrleansMobile,1.65,486,8,0,1080,0,0,Spring,1566,8,0,True
2015,03/01,NewOrleansMobile,1.54,300,35,0,2140,3,0,Spring,2440,38,0,True
2015,02/22,NewOrleansMobile,1.52,342,16,0,3203,0,0,Winter,3545,16,0,True
2015,02/15,NewOrleansMobile,1.48,208,56,0,4886,0,0,Winter,5094,56,0,True
2015,02/08,NewOrleansMobile,1.53,392,50,0,3090,0,0,Winter,3482,50,0,True
2015,02/01,NewOrleansMobile,1.48,162,34,0,1816,0,0,Winter,1978,34,0,True
2015,01/25,NewOrleansMobile,1.47,204,10,0,1063,0,0,Winter,1267,10,0,True
2015,01/18,NewOrleansMobile,0.98,256,2,0,4480,0,0,Winter,4736,2,0,True
2015,01/11,NewOrleansMobile,1.44,233,15,0,1243,0,0,Winter,1476,15,0,True
2015,01/04,NewOrleansMobile,1.41,220,23,0,2360,0,0,Winter,2580,23,0,True
2015,12/27,NewYork,1.9,1752,6546,1319,5757,6189,0,Winter,7509,12735,1319,True
2015,12/20,NewYork,1.93,3571,11118,1760,7057,1041,0,Winter,10628,12159,1760,True
2015,12/13,NewYork,1.9,2764,6739,4130,7553,2739,0,Winter,10317,9478,4130,True
2015,12/06,NewYork,1.65,4117,7226,1106,200,5843,0,Winter,4317,13069,1106,True
2015,11/29,NewYork,1.89,1481,4689,807,336,2648,0,Fall,1817,7337,807,True
2015,11/22,NewYork,1.84,2862,8165,209,260,1940,0,Fall,3122,10105,209,True
2015,11/15,NewYork,1.76,3015,9221,43,353,988,0,Fall,3368,10209,43,True
2015,11/08,NewYork,1.82,3607,9164,90,242,831,0,Fall,3849,9995,90,True
2015,11/01,NewYork,2.09,3272,8029,707,320,92,0,Fall,3592,8121,707,True
2015,10/25,NewYork,1.94,2675,8966,411,187,3487,0,Fall,2862,12453,411,True
2015,10/18,NewYork,2.07,1528,9002,516,169,1719,0,Fall,1697,10721,516,True
2015,10/11,NewYork,2.09,1981,8760,233,301,1240,0,Fall,2282,10000,233,True
2015,10/04,NewYork,2.25,1978,11877,47,428,1122,0,Fall,2406,12999,47,True
2015,09/27,NewYork,2.22,2222,12986,536,898,409,0,Fall,3120,13395,536,True
2015,09/20,NewYork,2.01,3810,12299,1110,695,0,0,Fall,4505,12299,1110,True
2015,09/13,NewYork,2.18,2210,9782,815,1855,3,0,Fall,4065,9785,815,True
2015,09/06,NewYork,2.01,3451,11143,1178,3330,192,0,Fall,6781,11335,1178,True
2015,08/30,NewYork,2.24,2258,10984,844,2063,391,0,Summer,4321,11375,844,True
2015,08/23,NewYork,2.28,2738,9860,921,1734,88,0,Summer,4472,9948,921,True
2015,08/16,NewYork,2.3,2843,11396,789,1242,21,0,Summer,4085,11417,789,True
2015,08/09,NewYork,1.98,4053,10634,760,1688,0,0,Summer,5741,10634,760,True
2015,08/02,NewYork,2.12,1929,8910,213,2798,0,0,Summer,4727,8910,213,True
2015,07/26,NewYork,1.91,2931,8850,45,958,0,0,Summer,3889,8850,45,True
2015,07/19,NewYork,2.2,2236,9080,68,2360,0,0,Summer,4596,9080,68,True
2015,07/12,NewYork,2.02,2075,8167,53,502,0,0,Summer,2577,8167,53,True
2015,07/05,NewYork,2.24,1816,6858,123,721,0,0,Summer,2537,6858,123,True
2015,06/28,NewYork,1.93,3320,10764,457,2204,0,0,Summer,5524,10764,457,True
2015,06/21,NewYork,2.34,3466,9967,1167,1124,6,0,Summer,4590,9973,1167,True
2015,06/14,NewYork,2.0,5012,14260,923,2735,0,0,Summer,7747,14260,923,True
2015,06/07,NewYork,2.31,2746,9225,875,2885,0,0,Summer,5631,9225,875,True
2015,05/31,NewYork,1.93,3348,11206,649,2441,0,0,Spring,5789,11206,649,True
2015,05/24,NewYork,2.17,3933,9577,417,4817,0,0,Spring,8750,9577,417,True
2015,05/17,NewYork,2.06,2917,10860,90,7947,0,0,Spring,10864,10860,90,True
2015,05/10,NewYork,1.93,2719,13976,7,6481,10,0,Spring,9200,13986,7,True
2015,05/03,NewYork,2.14,2667,11540,505,3832,30,0,Spring,6499,11570,505,True
2015,04/26,NewYork,2.21,1765,10026,466,3911,0,0,Spring,5676,10026,466,True
2015,04/19,NewYork,2.04,2688,16785,34,4758,0,0,Spring,7446,16785,34,True
2015,04/12,NewYork,1.86,3711,14390,22,7550,0,0,Spring,11261,14390,22,True
2015,04/05,NewYork,2.14,1901,8814,10,4172,8,0,Spring,6073,8822,10,True
2015,03/29,NewYork,2.08,4160,9765,85,2555,0,0,Spring,6715,9765,85,True
2015,03/22,NewYork,2.02,2987,11096,23,1330,0,0,Spring,4317,11096,23,True
2015,03/15,NewYork,1.81,1525,9190,0,5855,0,0,Spring,7380,9190,0,True
2015,03/08,NewYork,1.9,2620,8510,34,8738,0,0,Spring,11358,8510,34,True
2015,03/01,NewYork,2.0,5138,10612,10,5025,0,0,Spring,10163,10612,10,True
2015,02/22,NewYork,2.21,3471,9549,43,3556,0,0,Winter,7027,9549,43,True
2015,02/15,NewYork,1.91,2255,15250,49,7481,0,0,Winter,9736,15250,49,True
2015,02/08,NewYork,1.95,1793,10974,16,9786,0,0,Winter,11579,10974,16,True
2015,02/01,NewYork,1.93,1867,12683,7,10139,0,0,Winter,12006,12683,7,True
2015,01/25,NewYork,2.02,1363,10912,46,2015,0,0,Winter,3378,10912,46,True
2015,01/18,NewYork,2.08,692,7146,37,1327,0,0,Winter,2019,7146,37,True
2015,01/11,NewYork,2.03,1744,10901,60,2111,0,0,Winter,3855,10901,60,True
2015,01/04,NewYork,1.93,2357,12692,9,2269,0,0,Winter,4626,12692,9,True
2015,12/27,NorthernNewEngland,1.65,10,155,0,7953,0,0,Winter,7963,155,0,True
2015,12/20,NorthernNewEngland,1.65,9,149,0,9103,0,0,Winter,9112,149,0,True
2015,12/13,NorthernNewEngland,1.62,9,134,0,7885,0,0,Winter,7894,134,0,True
2015,12/06,NorthernNewEngland,1.61,11,78,0,9184,3,0,Winter,9195,81,0,True
2015,11/29,NorthernNewEngland,1.63,4,89,0,8108,3,0,Fall,8112,92,0,True
2015,11/22,NorthernNewEngland,1.66,15,78,0,9486,0,0,Fall,9501,78,0,True
2015,11/15,NorthernNewEngland,1.57,8,187,0,9731,3,0,Fall,9739,190,0,True
2015,11/08,NorthernNewEngland,1.58,9,261,0,8069,0,0,Fall,8078,261,0,True
2015,11/01,NorthernNewEngland,1.62,13,88,0,8158,0,0,Fall,8171,88,0,True
2015,10/25,NorthernNewEngland,1.61,8,84,0,7765,0,0,Fall,7773,84,0,True
2015,10/18,NorthernNewEngland,1.63,1,76,0,7842,0,0,Fall,7843,76,0,True
2015,10/11,NorthernNewEngland,1.61,6,68,0,8675,0,0,Fall,8681,68,0,True
2015,10/04,NorthernNewEngland,1.62,15,189,0,8806,0,0,Fall,8821,189,0,True
2015,09/27,NorthernNewEngland,1.93,6,263,0,5104,0,0,Fall,5110,263,0,True
2015,09/20,NorthernNewEngland,1.96,30,656,0,6112,0,0,Fall,6142,656,0,True
2015,09/13,NorthernNewEngland,1.93,18,687,0,6759,0,0,Fall,6777,687,0,True
2015,09/06,NorthernNewEngland,1.95,3,669,0,6262,0,0,Fall,6265,669,0,True
2015,08/30,NorthernNewEngland,1.92,3,675,0,7327,0,0,Summer,7330,675,0,True
2015,08/23,NorthernNewEngland,1.91,18,769,0,8327,0,0,Summer,8345,769,0,True
2015,08/16,NorthernNewEngland,1.93,16,690,0,7552,0,0,Summer,7568,690,0,True
2015,08/09,NorthernNewEngland,1.92,21,639,0,7881,10,0,Summer,7902,649,0,True
2015,08/02,NorthernNewEngland,1.96,87,753,0,8478,26,0,Summer,8565,779,0,True
2015,07/26,NorthernNewEngland,1.95,94,1065,0,6313,36,0,Summer,6407,1101,0,True
2015,07/19,NorthernNewEngland,1.96,20,1104,0,6942,0,0,Summer,6962,1104,0,True
2015,07/12,NorthernNewEngland,1.95,20,1072,0,7728,0,0,Summer,7748,1072,0,True
2015,07/05,NorthernNewEngland,1.95,6,1080,0,9332,0,0,Summer,9338,1080,0,True
2015,06/28,NorthernNewEngland,1.95,1,1099,0,7413,0,0,Summer,7414,1099,0,True
2015,06/21,NorthernNewEngland,1.93,37,722,0,7268,0,0,Summer,7305,722,0,True
2015,06/14,NorthernNewEngland,1.94,36,780,0,7816,0,0,Summer,7852,780,0,True
2015,06/07,NorthernNewEngland,1.92,4,848,0,7238,0,0,Summer,7242,848,0,True
2015,05/31,NorthernNewEngland,1.91,4,1045,0,7839,0,0,Spring,7843,1045,0,True
2015,05/24,NorthernNewEngland,1.88,5,677,0,6832,0,0,Spring,6837,677,0,True
2015,05/17,NorthernNewEngland,1.88,35,879,0,7293,0,0,Spring,7328,879,0,True
2015,05/10,NorthernNewEngland,1.91,41,819,0,6713,0,0,Spring,6754,819,0,True
2015,05/03,NorthernNewEngland,1.92,6,631,0,7344,0,0,Spring,7350,631,0,True
2015,04/26,NorthernNewEngland,1.88,6,617,0,6958,0,0,Spring,6964,617,0,True
2015,04/19,NorthernNewEngland,1.88,3,643,0,6821,0,0,Spring,6824,643,0,True
2015,04/12,NorthernNewEngland,1.87,46,444,0,6604,0,0,Spring,6650,444,0,True
2015,04/05,NorthernNewEngland,1.88,56,553,0,7834,0,0,Spring,7890,553,0,True
2015,03/29,NorthernNewEngland,1.9,24,569,0,5839,0,0,Spring,5863,569,0,True
2015,03/22,NorthernNewEngland,1.88,10,977,0,7096,0,0,Spring,7106,977,0,True
2015,03/15,NorthernNewEngland,1.9,7,687,0,4904,0,0,Spring,4911,687,0,True
2015,03/08,NorthernNewEngland,1.87,32,809,0,5915,0,0,Spring,5947,809,0,True
2015,03/01,NorthernNewEngland,1.82,5,870,0,6064,0,0,Spring,6069,870,0,True
2015,02/22,NorthernNewEngland,1.82,6,873,0,5387,0,0,Winter,5393,873,0,True
2015,02/15,NorthernNewEngland,1.87,7,590,0,6600,0,0,Winter,6607,590,0,True
2015,02/08,NorthernNewEngland,1.88,0,522,0,7333,0,0,Winter,7333,522,0,True
2015,02/01,NorthernNewEngland,1.89,4,568,0,5978,0,0,Winter,5982,568,0,True
2015,01/25,NorthernNewEngland,1.9,0,593,0,6163,0,0,Winter,6163,593,0,True
2015,01/18,NorthernNewEngland,1.88,0,569,0,7049,0,0,Winter,7049,569,0,True
2015,01/11,NorthernNewEngland,1.88,1,590,0,5894,0,0,Winter,5895,590,0,True
2015,01/04,NorthernNewEngland,1.83,6,630,0,6664,0,0,Winter,6670,630,0,True
2015,12/27,Orlando,1.67,1617,49,0,1119,323,0,Winter,2736,372,0,True
2015,12/20,Orlando,1.89,2169,70,0,610,0,0,Winter,2779,70,0,True
2015,12/13,Orlando,1.87,1757,80,0,598,0,0,Winter,2355,80,0,True
2015,12/06,Orlando,1.85,1961,52,0,796,0,0,Winter,2757,52,0,True
2015,11/29,Orlando,1.87,1491,41,0,546,3,0,Fall,2037,44,0,True
2015,11/22,Orlando,1.84,1572,43,0,726,33,0,Fall,2298,76,0,True
2015,11/15,Orlando,1.83,1908,44,0,946,3,0,Fall,2854,47,0,True
2015,11/08,Orlando,1.83,1987,27,0,1053,0,0,Fall,3040,27,0,True
2015,11/01,Orlando,1.8,1849,18,0,1258,0,0,Fall,3107,18,0,True
2015,10/25,Orlando,1.85,2019,8,0,876,0,0,Fall,2895,8,0,True
2015,10/18,Orlando,2.18,1876,48,0,880,0,0,Fall,2756,48,0,True
2015,10/11,Orlando,2.05,1759,50,0,1475,0,0,Fall,3234,50,0,True
2015,10/04,Orlando,2.11,1810,27,0,1152,0,0,Fall,2962,27,0,True
2015,09/27,Orlando,2.24,1825,22,0,642,0,0,Fall,2467,22,0,True
2015,09/20,Orlando,2.08,1870,47,0,1334,0,0,Fall,3204,47,0,True
2015,09/13,Orlando,2.11,1770,41,0,1083,0,0,Fall,2853,41,0,True
2015,09/06,Orlando,1.95,1471,66,0,1799,0,0,Fall,3270,66,0,True
2015,08/30,Orlando,2.11,1875,56,0,1149,0,0,Summer,3024,56,0,True
2015,08/23,Orlando,1.96,2043,63,0,1653,0,0,Summer,3696,63,0,True
2015,08/16,Orlando,1.72,2166,56,0,3619,0,0,Summer,5785,56,0,True
2015,08/09,Orlando,1.77,2327,56,0,2214,0,0,Summer,4541,56,0,True
2015,08/02,Orlando,2.0,2241,46,0,1766,0,0,Summer,4007,46,0,True
2015,07/26,Orlando,1.74,2483,56,0,3484,0,0,Summer,5967,56,0,True
2015,07/19,Orlando,1.72,2002,61,0,2966,0,0,Summer,4968,61,0,True
2015,07/12,Orlando,1.89,1639,49,0,3592,0,0,Summer,5231,49,0,True
2015,07/05,Orlando,1.82,1659,16,0,810,42,0,Summer,2469,58,0,True
2015,06/28,Orlando,1.87,2068,79,0,656,0,0,Summer,2724,79,0,True
2015,06/21,Orlando,1.89,1841,79,0,490,32,0,Summer,2331,111,0,True
2015,06/14,Orlando,1.86,2115,67,0,830,0,0,Summer,2945,67,0,True
2015,06/07,Orlando,1.81,1715,45,0,1073,0,0,Summer,2788,45,0,True
2015,05/31,Orlando,1.84,2221,89,0,1040,0,0,Spring,3261,89,0,True
2015,05/24,Orlando,1.81,1582,41,0,1016,0,0,Spring,2598,41,0,True
2015,05/17,Orlando,1.88,2073,46,0,610,0,0,Spring,2683,46,0,True
2015,05/10,Orlando,1.78,1658,61,0,1263,0,0,Spring,2921,61,0,True
2015,05/03,Orlando,1.82,1559,48,0,890,0,0,Spring,2449,48,0,True
2015,04/26,Orlando,1.88,1845,57,0,586,0,0,Spring,2431,57,0,True
2015,04/19,Orlando,1.76,1577,103,0,1064,0,0,Spring,2641,103,0,True
2015,04/12,Orlando,1.89,1774,84,0,452,0,0,Spring,2226,84,0,True
2015,04/05,Orlando,1.82,1494,62,0,848,0,0,Spring,2342,62,0,True
2015,03/29,Orlando,1.89,2081,47,0,589,0,0,Spring,2670,47,0,True
2015,03/22,Orlando,1.77,1876,81,0,1620,0,0,Spring,3496,81,0,True
2015,03/15,Orlando,1.82,1548,33,0,896,0,0,Spring,2444,33,0,True
2015,03/08,Orlando,1.75,1382,52,0,1346,0,0,Spring,2728,52,0,True
2015,03/01,Orlando,1.7,1222,28,0,1780,0,0,Spring,3002,28,0,True
2015,02/22,Orlando,1.76,1346,31,0,1206,0,0,Winter,2552,31,0,True
2015,02/15,Orlando,1.85,1386,41,0,610,0,0,Winter,1996,41,0,True
2015,02/08,Orlando,1.75,1576,36,0,1616,0,0,Winter,3192,36,0,True
2015,02/01,Orlando,1.76,1262,53,0,1183,0,0,Winter,2445,53,0,True
2015,01/25,Orlando,1.82,1174,53,0,696,0,0,Winter,1870,53,0,True
2015,01/18,Orlando,1.79,1237,31,0,883,0,0,Winter,2120,31,0,True
2015,01/11,Orlando,1.92,1290,53,0,266,0,0,Winter,1556,53,0,True
2015,01/04,Orlando,1.8,1200,53,0,803,0,0,Winter,2003,53,0,True
2015,12/27,Philadelphia,1.5,340,2365,3,560,5511,0,Winter,900,7876,3,True
2015,12/20,Philadelphia,1.83,719,2853,522,1195,1610,0,Winter,1914,4463,522,True
2015,12/13,Philadelphia,1.79,256,1559,952,1098,3425,0,Winter,1354,4984,952,True
2015,12/06,Philadelphia,1.35,482,1520,23,64,5233,0,Winter,546,6753,23,True
2015,11/29,Philadelphia,1.45,257,1325,5,102,3412,0,Fall,359,4737,5,True
2015,11/22,Philadelphia,1.55,400,1708,40,93,2455,0,Fall,493,4163,40,True
2015,11/15,Philadelphia,1.76,619,1814,16,333,182,0,Fall,952,1996,16,True
2015,11/08,Philadelphia,1.87,662,1823,18,210,218,0,Fall,872,2041,18,True
2015,11/01,Philadelphia,2.06,503,1619,10,89,146,0,Fall,592,1765,10,True
2015,10/25,Philadelphia,1.86,441,1817,15,72,907,0,Fall,513,2724,15,True
2015,10/18,Philadelphia,1.74,230,1600,15,111,1708,0,Fall,341,3308,15,True
2015,10/11,Philadelphia,1.62,325,1595,16,147,2183,0,Fall,472,3778,16,True
2015,10/04,Philadelphia,2.15,395,1815,51,447,0,0,Fall,842,1815,51,True
2015,09/27,Philadelphia,2.21,327,1854,26,794,0,0,Fall,1121,1854,26,True
2015,09/20,Philadelphia,1.87,620,1921,24,1390,0,0,Fall,2010,1921,24,True
2015,09/13,Philadelphia,1.95,312,1865,48,2071,5,0,Fall,2383,1870,48,True
2015,09/06,Philadelphia,1.71,624,1790,23,4378,31,0,Fall,5002,1821,23,True
2015,08/30,Philadelphia,1.93,421,1691,17,2207,89,0,Summer,2628,1780,17,True
2015,08/23,Philadelphia,1.99,490,1959,15,2140,11,0,Summer,2630,1970,15,True
2015,08/16,Philadelphia,2.06,431,2067,30,1356,0,0,Summer,1787,2067,30,True
2015,08/09,Philadelphia,1.79,628,2300,20,2495,0,0,Summer,3123,2300,20,True
2015,08/02,Philadelphia,1.94,369,1876,11,2890,0,0,Summer,3259,1876,11,True
2015,07/26,Philadelphia,1.92,280,1802,28,960,0,0,Summer,1240,1802,28,True
2015,07/19,Philadelphia,1.97,250,1960,11,3067,0,0,Summer,3317,1960,11,True
2015,07/12,Philadelphia,1.98,442,1768,33,372,0,0,Summer,814,1768,33,True
2015,07/05,Philadelphia,2.03,318,1596,12,1147,0,0,Summer,1465,1596,12,True
2015,06/28,Philadelphia,1.88,378,1816,26,2564,0,0,Summer,2942,1816,26,True
2015,06/21,Philadelphia,2.05,405,1534,27,1813,0,0,Summer,2218,1534,27,True
2015,06/14,Philadelphia,1.84,534,2127,7,3682,0,0,Summer,4216,2127,7,True
2015,06/07,Philadelphia,1.94,608,1221,14,3198,0,0,Summer,3806,1221,14,True
2015,05/31,Philadelphia,1.86,508,1828,3,3121,0,0,Spring,3629,1828,3,True
2015,05/24,Philadelphia,1.9,371,1693,18,3413,0,0,Spring,3784,1693,18,True
2015,05/17,Philadelphia,1.85,293,1605,11,3667,0,0,Spring,3960,1605,11,True
2015,05/10,Philadelphia,1.79,365,1644,11,5274,0,0,Spring,5639,1644,11,True
2015,05/03,Philadelphia,1.85,247,1531,18,3940,0,0,Spring,4187,1531,18,True
2015,04/26,Philadelphia,1.86,305,1171,3,3218,0,0,Spring,3523,1171,3,True
2015,04/19,Philadelphia,1.89,386,1671,12,2477,0,0,Spring,2863,1671,12,True
2015,04/12,Philadelphia,1.73,677,1892,7,3379,0,0,Spring,4056,1892,7,True
2015,04/05,Philadelphia,1.81,390,1248,26,2717,0,0,Spring,3107,1248,26,True
2015,03/29,Philadelphia,1.83,382,1310,17,2600,0,0,Spring,2982,1310,17,True
2015,03/22,Philadelphia,1.84,454,1885,7,429,0,0,Spring,883,1885,7,True
2015,03/15,Philadelphia,1.7,387,1357,23,2384,0,0,Spring,2771,1357,23,True
2015,03/08,Philadelphia,1.63,284,1349,8,4864,0,0,Spring,5148,1349,8,True
2015,03/01,Philadelphia,1.83,227,1390,7,1823,0,0,Spring,2050,1390,7,True
2015,02/22,Philadelphia,1.75,255,1244,14,2827,0,0,Winter,3082,1244,14,True
2015,02/15,Philadelphia,1.68,280,1672,19,3714,0,0,Winter,3994,1672,19,True
2015,02/08,Philadelphia,1.76,253,1031,7,2880,0,0,Winter,3133,1031,7,True
2015,02/01,Philadelphia,1.69,285,1416,4,3201,0,0,Winter,3486,1416,4,True
2015,01/25,Philadelphia,1.82,235,1358,22,1271,0,0,Winter,1506,1358,22,True
2015,01/18,Philadelphia,1.93,258,731,19,689,0,0,Winter,947,731,19,True
2015,01/11,Philadelphia,1.63,428,1809,4,4465,6,0,Winter,4893,1815,4,True
2015,01/04,Philadelphia,1.72,384,1597,11,1794,0,0,Winter,2178,1597,11,True
2015,12/27,PhoenixTucson,1.72,5038,906,0,1324,153,0,Winter,6362,1059,0,True
2015,12/20,PhoenixTucson,1.79,4879,919,0,679,21,0,Winter,5558,940,0,True
2015,12/13,PhoenixTucson,1.72,5065,1160,0,765,0,0,Winter,5830,1160,0,True
2015,12/06,PhoenixTucson,1.87,4843,832,0,260,0,0,Winter,5103,832,0,True
2015,11/29,PhoenixTucson,1.89,4379,689,0,106,0,0,Fall,4485,689,0,True
2015,11/22,PhoenixTucson,1.89,5652,901,0,196,5,0,Fall,5848,906,0,True
2015,11/15,PhoenixTucson,1.89,6237,1005,0,203,5,0,Fall,6440,1010,0,True
2015,11/08,PhoenixTucson,1.72,7679,1160,0,325,27,0,Fall,8004,1187,0,True
2015,11/01,PhoenixTucson,1.7,7091,1301,0,238,5,0,Fall,7329,1306,0,True
2015,10/25,PhoenixTucson,1.52,8001,1140,0,143,22,0,Fall,8144,1162,0,True
2015,10/18,PhoenixTucson,1.84,10832,1317,0,166,42,0,Fall,10998,1359,0,True
2015,10/11,PhoenixTucson,1.91,5438,970,0,181,3,0,Fall,5619,973,0,True
2015,10/04,PhoenixTucson,1.93,5605,1059,0,143,17,0,Fall,5748,1076,0,True
2015,09/27,PhoenixTucson,1.85,5085,1578,0,442,21,0,Fall,5527,1599,0,True
2015,09/20,PhoenixTucson,1.98,3741,890,0,193,56,0,Fall,3934,946,0,True
2015,09/13,PhoenixTucson,1.9,5346,1082,0,968,225,0,Fall,6314,1307,0,True
2015,09/06,PhoenixTucson,1.79,7314,1597,0,759,896,0,Fall,8073,2493,0,True
2015,08/30,PhoenixTucson,1.8,7278,1588,0,1013,654,0,Summer,8291,2242,0,True
2015,08/23,PhoenixTucson,1.81,7394,1347,0,796,466,0,Summer,8190,1813,0,True
2015,08/16,PhoenixTucson,1.79,7874,1893,0,1013,168,0,Summer,8887,2061,0,True
2015,08/09,PhoenixTucson,1.82,7476,1473,0,880,236,0,Summer,8356,1709,0,True
2015,08/02,PhoenixTucson,1.88,6675,1272,0,533,112,0,Summer,7208,1384,0,True
2015,07/26,PhoenixTucson,1.85,5314,1303,0,290,270,0,Summer,5604,1573,0,True
2015,07/19,PhoenixTucson,1.85,4840,1182,0,223,183,0,Summer,5063,1365,0,True
2015,07/12,PhoenixTucson,1.82,5715,1462,0,746,139,0,Summer,6461,1601,0,True
2015,07/05,PhoenixTucson,1.72,7517,1465,0,1126,371,0,Summer,8643,1836,0,True
2015,06/28,PhoenixTucson,1.54,9145,1568,0,303,615,0,Summer,9448,2183,0,True
2015,06/21,PhoenixTucson,1.48,11743,1864,0,736,311,0,Summer,12479,2175,0,True
2015,06/14,PhoenixTucson,1.62,8833,2031,0,1193,741,0,Summer,10026,2772,0,True
2015,06/07,PhoenixTucson,1.54,10264,1518,0,973,1085,0,Summer,11237,2603,0,True
2015,05/31,PhoenixTucson,1.54,10865,1272,0,1025,1226,0,Spring,11890,2498,0,True
2015,05/24,PhoenixTucson,1.7,8631,1351,0,960,663,0,Spring,9591,2014,0,True
2015,05/17,PhoenixTucson,1.67,8485,1510,0,866,730,0,Spring,9351,2240,0,True
2015,05/10,PhoenixTucson,1.46,11232,1442,0,906,1173,0,Spring,12138,2615,0,True
2015,05/03,PhoenixTucson,1.4,12879,2627,0,1073,939,0,Spring,13952,3566,0,True
2015,04/26,PhoenixTucson,1.65,11276,4970,0,726,801,0,Spring,12002,5771,0,True
2015,04/19,PhoenixTucson,1.48,12488,1697,0,670,879,0,Spring,13158,2576,0,True
2015,04/12,PhoenixTucson,1.56,10085,1365,0,2138,692,0,Spring,12223,2057,0,True
2015,04/05,PhoenixTucson,1.5,10944,1290,0,1812,280,0,Spring,12756,1570,0,True
2015,03/29,PhoenixTucson,1.46,13441,1143,0,665,36,0,Spring,14106,1179,0,True
2015,03/22,PhoenixTucson,1.37,11611,1541,0,659,12,0,Spring,12270,1553,0,True
2015,03/15,PhoenixTucson,1.56,7209,1255,0,1056,9,0,Spring,8265,1264,0,True
2015,03/08,PhoenixTucson,1.52,8912,1115,0,2513,4,0,Spring,11425,1119,0,True
2015,03/01,PhoenixTucson,1.37,11419,1565,0,1626,7,0,Spring,13045,1572,0,True
2015,02/22,PhoenixTucson,1.59,8585,1454,0,866,17,0,Winter,9451,1471,0,True
2015,02/15,PhoenixTucson,1.66,7842,1205,0,1096,15,0,Winter,8938,1220,0,True
2015,02/08,PhoenixTucson,1.55,9275,1356,0,1786,0,0,Winter,11061,1356,0,True
2015,02/01,PhoenixTucson,1.18,10810,2016,0,813,5,0,Winter,11623,2021,0,True
2015,01/25,PhoenixTucson,1.54,7988,1728,0,1120,12,0,Winter,9108,1740,0,True
2015,01/18,PhoenixTucson,1.36,10248,1529,0,473,0,0,Winter,10721,1529,0,True
2015,01/11,PhoenixTucson,1.36,11523,1632,0,876,2,0,Winter,12399,1634,0,True
2015,01/04,PhoenixTucson,1.12,14569,1868,0,830,28,0,Winter,15399,1896,0,True
2015,12/27,Pittsburgh,1.5,199,29,0,450,69,0,Winter,649,98,0,True
2015,12/20,Pittsburgh,1.55,234,31,0,287,125,0,Winter,521,156,0,True
2015,12/13,Pittsburgh,1.56,283,46,0,354,167,0,Winter,637,213,0,True
2015,12/06,Pittsburgh,1.55,332,238,0,555,186,0,Winter,887,424,0,True
2015,11/29,Pittsburgh,1.4,345,136,0,522,157,0,Fall,867,293,0,True
2015,11/22,Pittsburgh,1.54,386,214,0,248,308,0,Fall,634,522,0,True
2015,11/15,Pittsburgh,1.43,466,33,0,360,527,0,Fall,826,560,0,True
2015,11/08,Pittsburgh,1.44,365,42,0,597,263,0,Fall,962,305,0,True
2015,11/01,Pittsburgh,1.46,399,57,0,694,231,0,Fall,1093,288,0,True
2015,10/25,Pittsburgh,1.47,594,27,0,1328,22,0,Fall,1922,49,0,True
2015,10/18,Pittsburgh,1.45,477,37,0,765,49,0,Fall,1242,86,0,True
2015,10/11,Pittsburgh,1.45,447,53,0,622,243,0,Fall,1069,296,0,True
2015,10/04,Pittsburgh,1.19,305,265,0,996,281,0,Fall,1301,546,0,True
2015,09/27,Pittsburgh,1.47,361,30,0,385,373,0,Fall,746,403,0,True
2015,09/20,Pittsburgh,1.44,668,61,0,223,560,0,Fall,891,621,0,True
2015,09/13,Pittsburgh,1.47,529,46,0,631,182,0,Fall,1160,228,0,True
2015,09/06,Pittsburgh,1.5,657,162,0,814,643,0,Fall,1471,805,0,True
2015,08/30,Pittsburgh,1.52,790,61,0,713,616,0,Summer,1503,677,0,True
2015,08/23,Pittsburgh,1.66,749,61,0,1083,79,0,Summer,1832,140,0,True
2015,08/16,Pittsburgh,1.57,677,34,0,426,393,0,Summer,1103,427,0,True
2015,08/09,Pittsburgh,1.47,464,6,0,1217,467,0,Summer,1681,473,0,True
2015,08/02,Pittsburgh,1.57,574,45,0,257,361,0,Summer,831,406,0,True
2015,07/26,Pittsburgh,1.46,533,38,0,80,537,0,Summer,613,575,0,True
2015,07/19,Pittsburgh,1.83,516,46,0,153,37,0,Summer,669,83,0,True
2015,07/12,Pittsburgh,1.81,695,126,0,457,0,0,Summer,1152,126,0,True
2015,07/05,Pittsburgh,1.83,751,204,0,423,3,0,Summer,1174,207,0,True
2015,06/28,Pittsburgh,1.77,821,32,0,529,18,0,Summer,1350,50,0,True
2015,06/21,Pittsburgh,1.58,776,32,0,495,394,0,Summer,1271,426,0,True
2015,06/14,Pittsburgh,1.56,525,68,0,687,235,0,Summer,1212,303,0,True
2015,06/07,Pittsburgh,1.57,687,20,0,911,108,0,Summer,1598,128,0,True
2015,05/31,Pittsburgh,1.51,839,30,0,1106,178,0,Spring,1945,208,0,True
2015,05/24,Pittsburgh,1.54,856,71,0,1007,318,0,Spring,1863,389,0,True
2015,05/17,Pittsburgh,1.53,1092,64,0,1378,78,0,Spring,2470,142,0,True
2015,05/10,Pittsburgh,1.49,844,42,0,1220,187,0,Spring,2064,229,0,True
2015,05/03,Pittsburgh,1.49,624,39,0,995,231,0,Spring,1619,270,0,True
2015,04/26,Pittsburgh,1.38,720,50,0,1402,110,0,Spring,2122,160,0,True
2015,04/19,Pittsburgh,1.37,1061,232,0,1606,282,0,Spring,2667,514,0,True
2015,04/12,Pittsburgh,1.45,999,152,0,1748,322,0,Spring,2747,474,0,True
2015,04/05,Pittsburgh,1.35,726,208,0,1668,205,0,Spring,2394,413,0,True
2015,03/29,Pittsburgh,1.41,748,181,0,1344,0,0,Spring,2092,181,0,True
2015,03/22,Pittsburgh,1.47,842,91,0,1122,1,0,Spring,1964,92,0,True
2015,03/15,Pittsburgh,1.68,706,66,0,357,122,0,Spring,1063,188,0,True
2015,03/08,Pittsburgh,1.65,561,330,0,1233,212,0,Spring,1794,542,0,True
2015,03/01,Pittsburgh,1.63,754,51,0,1379,38,0,Spring,2133,89,0,True
2015,02/22,Pittsburgh,1.71,889,56,0,518,396,0,Winter,1407,452,0,True
2015,02/15,Pittsburgh,1.71,617,248,0,760,157,0,Winter,1377,405,0,True
2015,02/08,Pittsburgh,1.6,427,371,0,1138,316,0,Winter,1565,687,0,True
2015,02/01,Pittsburgh,1.77,760,74,0,585,7,0,Winter,1345,81,0,True
2015,01/25,Pittsburgh,1.7,598,91,0,559,192,0,Winter,1157,283,0,True
2015,01/18,Pittsburgh,1.55,312,709,0,257,2168,0,Winter,569,2877,0,True
2015,01/11,Pittsburgh,1.82,767,328,0,564,3,0,Winter,1331,331,0,True
2015,01/04,Pittsburgh,1.81,754,124,0,447,14,0,Winter,1201,138,0,True
2015,12/27,Portland,1.24,1189,10909,10,6705,8303,0,Winter,7894,19212,10,True
2015,12/20,Portland,1.21,1202,8864,3,5902,9672,0,Winter,7104,18536,3,True
2015,12/13,Portland,0.93,1262,20963,3,21656,23626,0,Winter,22918,44589,3,True
2015,12/06,Portland,1.66,934,8211,0,7,3515,0,Winter,941,11726,0,True
2015,11/29,Portland,1.38,964,9321,8,55,10642,0,Fall,1019,19963,8,True
2015,11/22,Portland,1.12,1279,21670,0,81,34378,0,Fall,1360,56048,0,True
2015,11/15,Portland,1.8,890,9465,3,110,2459,0,Fall,1000,11924,3,True
2015,11/08,Portland,1.39,1110,13364,1,1115,6708,0,Fall,2225,20072,1,True
2015,11/01,Portland,0.98,1163,21981,46,7849,31551,0,Fall,9012,53532,46,True
2015,10/25,Portland,1.74,628,9578,6,36,6246,0,Fall,664,15824,6,True
2015,10/18,Portland,1.78,800,12022,6,7,4753,0,Fall,807,16775,6,True
2015,10/11,Portland,1.68,780,15805,3,14,9943,0,Fall,794,25748,3,True
2015,10/04,Portland,1.57,1489,22640,3,18,11031,0,Fall,1507,33671,3,True
2015,09/27,Portland,1.72,1045,10525,3,0,6459,0,Fall,1045,16984,3,True
2015,09/20,Portland,1.76,2052,9055,0,0,6906,0,Fall,2052,15961,0,True
2015,09/13,Portland,2.07,3092,10615,0,7,4243,0,Fall,3099,14858,0,True
2015,09/06,Portland,2.16,3225,12040,0,0,3166,0,Fall,3225,15206,0,True
2015,08/30,Portland,1.37,3242,35409,0,0,11546,0,Summer,3242,46955,0,True
2015,08/23,Portland,2.21,3696,12224,1,0,1225,0,Summer,3696,13449,1,True
2015,08/16,Portland,1.73,4315,19426,0,0,6777,0,Summer,4315,26203,0,True
2015,08/09,Portland,2.02,4930,10792,0,0,2426,0,Summer,4930,13218,0,True
2015,08/02,Portland,1.94,6605,10611,0,0,837,0,Summer,6605,11448,0,True
2015,07/26,Portland,1.96,6781,14705,28,0,1579,0,Summer,6781,16284,28,True
2015,07/19,Portland,1.37,8464,38289,9,0,9049,0,Summer,8464,47338,9,True
2015,07/12,Portland,1.82,9115,12902,4,0,2684,0,Summer,9115,15586,4,True
2015,07/05,Portland,1.93,8938,14928,3,0,1085,0,Summer,8938,16013,3,True
2015,06/28,Portland,1.53,7314,33780,21,0,0,0,Summer,7314,33780,21,True
2015,06/21,Portland,1.53,8095,23586,13,0,699,0,Summer,8095,24285,13,True
2015,06/14,Portland,1.91,8491,14130,15,0,1396,0,Summer,8491,15526,15,True
2015,06/07,Portland,1.96,9745,16510,0,0,608,0,Summer,9745,17118,0,True
2015,05/31,Portland,1.5,7282,34362,1,0,81,0,Spring,7282,34443,1,True
2015,05/24,Portland,1.82,7408,14746,3,0,792,0,Spring,7408,15538,3,True
2015,05/17,Portland,1.68,13615,14195,0,0,2985,0,Spring,13615,17180,0,True
2015,05/10,Portland,1.64,9687,13297,0,0,3772,0,Spring,9687,17069,0,True
2015,05/03,Portland,1.54,9002,11551,0,0,5550,0,Spring,9002,17101,0,True
2015,04/26,Portland,1.27,8483,21190,1,0,10465,0,Spring,8483,31655,1,True
2015,04/19,Portland,1.57,12834,12733,0,0,3108,0,Spring,12834,15841,0,True
2015,04/12,Portland,1.32,8217,41945,11,0,13324,0,Spring,8217,55269,11,True
2015,04/05,Portland,1.76,9037,17777,4,0,608,0,Spring,9037,18385,4,True
2015,03/29,Portland,1.45,9134,45312,3,3,4952,0,Spring,9137,50264,3,True
2015,03/22,Portland,1.29,15676,40685,17,12,6475,0,Spring,15688,47160,17,True
2015,03/15,Portland,1.61,9298,13800,1,0,2144,0,Spring,9298,15944,1,True
2015,03/08,Portland,1.45,15501,44127,10,0,1019,0,Spring,15501,45146,10,True
2015,03/01,Portland,1.32,17519,12225,35,0,500,0,Spring,17519,12725,35,True
2015,02/22,Portland,1.38,17377,9920,34,3,1352,0,Winter,17380,11272,34,True
2015,02/15,Portland,1.51,10884,10887,32,180,3707,0,Winter,11064,14594,32,True
2015,02/08,Portland,1.23,16202,32480,6,710,8270,0,Winter,16912,40750,6,True
2015,02/01,Portland,1.2,20129,12970,4,540,6028,0,Winter,20669,18998,4,True
2015,01/25,Portland,1.35,15946,10638,3,540,3734,0,Winter,16486,14372,3,True
2015,01/18,Portland,1.24,11894,30078,4,303,9623,0,Winter,12197,39701,4,True
2015,01/11,Portland,1.22,18893,19745,0,480,3997,0,Winter,19373,23742,0,True
2015,01/04,Portland,1.28,17580,11685,3,613,3045,0,Winter,18193,14730,3,True
2015,12/27,RaleighGreensboro,1.74,256,1936,437,1116,158,0,Winter,1372,2094,437,True
2015,12/20,RaleighGreensboro,1.77,309,2197,543,1350,0,0,Winter,1659,2197,543,True
2015,12/13,RaleighGreensboro,1.81,240,2033,379,570,47,0,Winter,810,2080,379,True
2015,12/06,RaleighGreensboro,1.82,146,2097,419,798,33,0,Winter,944,2130,419,True
2015,11/29,RaleighGreensboro,1.78,115,1898,481,1172,150,0,Fall,1287,2048,481,True
2015,11/22,RaleighGreensboro,1.79,141,2164,531,1302,22,0,Fall,1443,2186,531,True
2015,11/15,RaleighGreensboro,1.77,107,1947,551,1567,127,0,Fall,1674,2074,551,True
2015,11/08,RaleighGreensboro,1.75,74,2037,655,1357,166,0,Fall,1431,2203,655,True
2015,11/01,RaleighGreensboro,1.65,77,2249,707,2156,486,0,Fall,2233,2735,707,True
2015,10/25,RaleighGreensboro,1.78,32,2451,1023,2102,48,0,Fall,2134,2499,1023,True
2015,10/18,RaleighGreensboro,1.73,43,2506,698,2241,137,0,Fall,2284,2643,698,True
2015,10/11,RaleighGreensboro,1.59,42,2450,861,2405,923,0,Fall,2447,3373,861,True
2015,10/04,RaleighGreensboro,1.76,28,2449,645,2062,406,0,Fall,2090,2855,645,True
2015,09/27,RaleighGreensboro,1.81,78,2446,686,2796,242,0,Fall,2874,2688,686,True
2015,09/20,RaleighGreensboro,1.86,44,2235,660,2490,0,0,Fall,2534,2235,660,True
2015,09/13,RaleighGreensboro,1.94,28,2870,683,1762,0,0,Fall,1790,2870,683,True
2015,09/06,RaleighGreensboro,1.95,73,2705,821,1931,21,0,Fall,2004,2726,821,True
2015,08/30,RaleighGreensboro,1.94,46,3098,750,2132,78,0,Summer,2178,3176,750,True
2015,08/23,RaleighGreensboro,1.92,88,3262,891,2335,268,0,Summer,2423,3530,891,True
2015,08/16,RaleighGreensboro,1.9,50,2851,899,2151,170,0,Summer,2201,3021,899,True
2015,08/09,RaleighGreensboro,1.82,50,3879,1022,2344,133,0,Summer,2394,4012,1022,True
2015,08/02,RaleighGreensboro,1.86,88,3021,690,2588,77,0,Summer,2676,3098,690,True
2015,07/26,RaleighGreensboro,1.77,142,2831,791,1918,696,0,Summer,2060,3527,791,True
2015,07/19,RaleighGreensboro,1.76,93,2710,780,1873,612,0,Summer,1966,3322,780,True
2015,07/12,RaleighGreensboro,1.77,141,2811,822,2357,629,0,Summer,2498,3440,822,True
2015,07/05,RaleighGreensboro,1.82,136,2955,1021,2200,459,0,Summer,2336,3414,1021,True
2015,06/28,RaleighGreensboro,1.8,145,2750,849,1451,480,0,Summer,1596,3230,849,True
2015,06/21,RaleighGreensboro,1.83,233,3039,803,1007,360,0,Summer,1240,3399,803,True
2015,06/14,RaleighGreensboro,1.75,203,2924,1010,2179,594,0,Summer,2382,3518,1010,True
2015,06/07,RaleighGreensboro,1.66,158,2909,772,2473,962,0,Summer,2631,3871,772,True
2015,05/31,RaleighGreensboro,1.6,244,5424,1038,2150,356,0,Spring,2394,5780,1038,True
2015,05/24,RaleighGreensboro,1.36,97,6165,1001,1933,1372,0,Spring,2030,7537,1001,True
2015,05/17,RaleighGreensboro,1.15,171,10462,4562,2118,641,0,Spring,2289,11103,4562,True
2015,05/10,RaleighGreensboro,1.32,168,5374,1163,1981,1938,0,Spring,2149,7312,1163,True
2015,05/03,RaleighGreensboro,1.35,111,6282,1655,2261,1531,0,Spring,2372,7813,1655,True
2015,04/26,RaleighGreensboro,1.51,89,4454,919,1748,897,0,Spring,1837,5351,919,True
2015,04/19,RaleighGreensboro,1.68,79,4244,1260,2248,62,0,Spring,2327,4306,1260,True
2015,04/12,RaleighGreensboro,1.67,115,3462,1068,1011,795,0,Spring,1126,4257,1068,True
2015,04/05,RaleighGreensboro,1.96,152,2540,930,1086,149,0,Spring,1238,2689,930,True
2015,03/29,RaleighGreensboro,1.78,389,2583,1021,1363,15,0,Spring,1752,2598,1021,True
2015,03/22,RaleighGreensboro,1.85,83,2618,902,485,160,0,Spring,568,2778,902,True
2015,03/15,RaleighGreensboro,1.87,96,2298,886,550,19,0,Spring,646,2317,886,True
2015,03/08,RaleighGreensboro,1.74,86,2512,977,2947,15,0,Spring,3033,2527,977,True
2015,03/01,RaleighGreensboro,1.73,55,2571,931,1814,118,0,Spring,1869,2689,931,True
2015,02/22,RaleighGreensboro,1.77,31,2088,801,1003,64,0,Winter,1034,2152,801,True
2015,02/15,RaleighGreensboro,1.69,30,1862,712,1690,27,0,Winter,1720,1889,712,True
2015,02/08,RaleighGreensboro,1.73,56,2117,855,2635,84,0,Winter,2691,2201,855,True
2015,02/01,RaleighGreensboro,1.79,27,2044,968,1330,14,0,Winter,1357,2058,968,True
2015,01/25,RaleighGreensboro,2.02,60,1948,627,620,101,0,Winter,680,2049,627,True
2015,01/18,RaleighGreensboro,1.97,78,1775,628,925,89,0,Winter,1003,1864,628,True
2015,01/11,RaleighGreensboro,1.98,31,1957,672,1195,4,0,Winter,1226,1961,672,True
2015,01/04,RaleighGreensboro,2.01,58,1493,772,993,78,0,Winter,1051,1571,772,True
2015,12/27,RichmondNorfolk,1.53,59,1910,233,1292,620,0,Winter,1351,2530,233,True
2015,12/20,RichmondNorfolk,1.67,66,2449,215,1265,3,0,Winter,1331,2452,215,True
2015,12/13,RichmondNorfolk,1.67,85,2009,194,1213,62,0,Winter,1298,2071,194,True
2015,12/06,RichmondNorfolk,1.67,42,1608,223,1060,154,0,Winter,1102,1762,223,True
2015,11/29,RichmondNorfolk,1.68,45,1463,180,773,266,0,Fall,818,1729,180,True
2015,11/22,RichmondNorfolk,1.65,54,2599,278,596,79,0,Fall,650,2678,278,True
2015,11/15,RichmondNorfolk,1.65,101,2225,300,640,290,0,Fall,741,2515,300,True
2015,11/08,RichmondNorfolk,1.58,96,2006,342,1466,287,0,Fall,1562,2293,342,True
2015,11/01,RichmondNorfolk,1.4,105,2108,385,806,1253,0,Fall,911,3361,385,True
2015,10/25,RichmondNorfolk,1.66,58,2344,371,1176,223,0,Fall,1234,2567,371,True
2015,10/18,RichmondNorfolk,1.63,87,2410,385,1616,237,0,Fall,1703,2647,385,True
2015,10/11,RichmondNorfolk,1.31,34,2522,422,846,1868,0,Fall,880,4390,422,True
2015,10/04,RichmondNorfolk,1.68,58,2719,405,993,288,0,Fall,1051,3007,405,True
2015,09/27,RichmondNorfolk,1.65,37,2720,313,583,392,0,Fall,620,3112,313,True
2015,09/20,RichmondNorfolk,1.87,69,2727,345,26,32,0,Fall,95,2759,345,True
2015,09/13,RichmondNorfolk,1.84,52,3412,414,730,0,0,Fall,782,3412,414,True
2015,09/06,RichmondNorfolk,1.85,56,3368,386,1263,40,0,Fall,1319,3408,386,True
2015,08/30,RichmondNorfolk,1.8,32,3282,393,1006,337,0,Summer,1038,3619,393,True
2015,08/23,RichmondNorfolk,1.74,98,3358,451,1550,457,0,Summer,1648,3815,451,True
2015,08/16,RichmondNorfolk,1.68,128,3804,436,553,689,0,Summer,681,4493,436,True
2015,08/09,RichmondNorfolk,1.59,139,4351,564,2290,562,0,Summer,2429,4913,564,True
2015,08/02,RichmondNorfolk,1.7,93,4051,383,703,128,0,Summer,796,4179,383,True
2015,07/26,RichmondNorfolk,1.41,138,4129,342,220,1903,0,Summer,358,6032,342,True
2015,07/19,RichmondNorfolk,1.35,84,3233,428,296,1835,0,Summer,380,5068,428,True
2015,07/12,RichmondNorfolk,1.28,119,3413,413,486,2440,0,Summer,605,5853,413,True
2015,07/05,RichmondNorfolk,1.49,77,3608,516,640,1157,0,Summer,717,4765,516,True
2015,06/28,RichmondNorfolk,1.4,136,3651,493,776,1106,0,Summer,912,4757,493,True
2015,06/21,RichmondNorfolk,1.35,172,4236,438,570,1275,0,Summer,742,5511,438,True
2015,06/14,RichmondNorfolk,1.33,155,3425,452,1282,1675,0,Summer,1437,5100,452,True
2015,06/07,RichmondNorfolk,1.24,290,3796,435,1820,2864,0,Summer,2110,6660,435,True
2015,05/31,RichmondNorfolk,1.13,232,6403,431,1038,1986,0,Spring,1270,8389,431,True
2015,05/24,RichmondNorfolk,1.02,368,6973,495,1688,2919,0,Spring,2056,9892,495,True
2015,05/17,RichmondNorfolk,1.01,281,7695,1454,1634,1341,0,Spring,1915,9036,1454,True
2015,05/10,RichmondNorfolk,1.03,348,6066,560,1193,2558,0,Spring,1541,8624,560,True
2015,05/03,RichmondNorfolk,1.03,426,6174,548,2313,2962,0,Spring,2739,9136,548,True
2015,04/26,RichmondNorfolk,1.12,497,5299,378,1640,1689,0,Spring,2137,6988,378,True
2015,04/19,RichmondNorfolk,1.26,422,4874,474,1910,488,0,Spring,2332,5362,474,True
2015,04/12,RichmondNorfolk,1.23,344,3395,524,915,1311,0,Spring,1259,4706,524,True
2015,04/05,RichmondNorfolk,1.54,235,2349,523,1330,454,0,Spring,1565,2803,523,True
2015,03/29,RichmondNorfolk,1.6,214,3073,486,1721,63,0,Spring,1935,3136,486,True
2015,03/22,RichmondNorfolk,1.52,169,2320,381,40,434,0,Spring,209,2754,381,True
2015,03/15,RichmondNorfolk,1.57,157,2458,516,2603,98,0,Spring,2760,2556,516,True
2015,03/08,RichmondNorfolk,1.57,131,2471,488,2553,102,0,Spring,2684,2573,488,True
2015,03/01,RichmondNorfolk,1.47,145,2466,411,916,357,0,Spring,1061,2823,411,True
2015,02/22,RichmondNorfolk,1.51,87,2167,487,1206,171,0,Winter,1293,2338,487,True
2015,02/15,RichmondNorfolk,1.59,126,1701,408,1070,180,0,Winter,1196,1881,408,True
2015,02/08,RichmondNorfolk,1.55,103,1872,444,2083,215,0,Winter,2186,2087,444,True
2015,02/01,RichmondNorfolk,1.58,83,2059,440,1296,37,0,Winter,1379,2096,440,True
2015,01/25,RichmondNorfolk,1.57,184,1998,325,1002,349,0,Winter,1186,2347,325,True
2015,01/18,RichmondNorfolk,1.62,120,2152,363,583,261,0,Winter,703,2413,363,True
2015,01/11,RichmondNorfolk,1.66,143,2060,270,412,26,0,Winter,555,2086,270,True
2015,01/04,RichmondNorfolk,1.54,238,1678,372,1570,352,0,Winter,1808,2030,372,True
2015,12/27,Roanoke,1.41,33,2525,0,690,1118,0,Winter,723,3643,0,True
2015,12/20,Roanoke,1.59,47,3008,0,495,17,0,Winter,542,3025,0,True
2015,12/13,Roanoke,1.55,108,2452,0,467,168,0,Winter,575,2620,0,True
2015,12/06,Roanoke,1.55,61,2193,0,483,277,0,Winter,544,2470,0,True
2015,11/29,Roanoke,1.61,95,2175,0,390,497,0,Fall,485,2672,0,True
2015,11/22,Roanoke,1.54,108,3153,0,346,185,0,Fall,454,3338,0,True
2015,11/15,Roanoke,1.53,110,2793,0,456,485,0,Fall,566,3278,0,True
2015,11/08,Roanoke,1.44,111,2755,0,906,858,0,Fall,1017,3613,0,True
2015,11/01,Roanoke,1.19,96,2646,0,536,2505,0,Fall,632,5151,0,True
2015,10/25,Roanoke,1.56,62,3016,0,690,567,0,Fall,752,3583,0,True
2015,10/18,Roanoke,1.58,60,3578,0,840,720,0,Fall,900,4298,0,True
2015,10/11,Roanoke,1.13,83,3470,0,543,4074,0,Fall,626,7544,0,True
2015,10/04,Roanoke,1.6,54,4018,0,583,1172,0,Fall,637,5190,0,True
2015,09/27,Roanoke,1.67,59,4263,0,583,854,0,Fall,642,5117,0,True
2015,09/20,Roanoke,1.85,67,4246,0,350,27,0,Fall,417,4273,0,True
2015,09/13,Roanoke,1.84,89,5082,0,793,6,0,Fall,882,5088,0,True
2015,09/06,Roanoke,1.78,60,5542,0,1090,320,0,Fall,1150,5862,0,True
2015,08/30,Roanoke,1.73,61,5079,0,760,705,0,Summer,821,5784,0,True
2015,08/23,Roanoke,1.69,143,5309,0,1123,1061,0,Summer,1266,6370,0,True
2015,08/16,Roanoke,1.65,115,5312,0,533,1282,0,Summer,648,6594,0,True
2015,08/09,Roanoke,1.6,93,5320,0,1270,1264,0,Summer,1363,6584,0,True
2015,08/02,Roanoke,1.7,123,4829,0,333,516,0,Summer,456,5345,0,True
2015,07/26,Roanoke,1.34,115,4828,0,53,2698,0,Summer,168,7526,0,True
2015,07/19,Roanoke,1.19,131,4316,0,156,3083,0,Summer,287,7399,0,True
2015,07/12,Roanoke,1.14,125,4732,0,273,3839,0,Summer,398,8571,0,True
2015,07/05,Roanoke,1.37,169,5367,0,693,1653,0,Summer,862,7020,0,True
2015,06/28,Roanoke,1.31,131,4981,0,813,1750,0,Summer,944,6731,0,True
2015,06/21,Roanoke,1.33,142,6373,0,846,1529,0,Summer,988,7902,0,True
2015,06/14,Roanoke,1.16,128,5037,0,916,3757,0,Summer,1044,8794,0,True
2015,06/07,Roanoke,1.08,145,6329,0,1443,5784,0,Summer,1588,12113,0,True
2015,05/31,Roanoke,0.98,118,12165,0,1314,4517,0,Spring,1432,16682,0,True
2015,05/24,Roanoke,0.89,191,15349,0,1124,5369,0,Spring,1315,20718,0,True
2015,05/17,Roanoke,0.92,203,16312,0,1435,3585,0,Spring,1638,19897,0,True
2015,05/10,Roanoke,0.82,227,12996,0,1230,6971,0,Spring,1457,19967,0,True
2015,05/03,Roanoke,0.88,259,13301,0,1570,5886,0,Spring,1829,19187,0,True
2015,04/26,Roanoke,0.94,275,10599,0,1243,3151,0,Spring,1518,13750,0,True
2015,04/19,Roanoke,1.05,172,8811,0,976,428,0,Spring,1148,9239,0,True
2015,04/12,Roanoke,1.03,202,6608,0,735,2654,0,Spring,937,9262,0,True
2015,04/05,Roanoke,1.42,92,5159,0,953,645,0,Spring,1045,5804,0,True
2015,03/29,Roanoke,1.51,125,5301,0,956,95,0,Spring,1081,5396,0,True
2015,03/22,Roanoke,1.36,68,4201,0,233,986,0,Spring,301,5187,0,True
2015,03/15,Roanoke,1.5,76,4755,0,1323,236,0,Spring,1399,4991,0,True
2015,03/08,Roanoke,1.48,66,3761,0,2096,125,0,Spring,2162,3886,0,True
2015,03/01,Roanoke,1.33,70,4546,0,873,620,0,Spring,943,5166,0,True
2015,02/22,Roanoke,1.36,126,3417,0,860,260,0,Winter,986,3677,0,True
2015,02/15,Roanoke,1.46,57,3264,0,1016,169,0,Winter,1073,3433,0,True
2015,02/08,Roanoke,1.44,81,3221,0,1583,297,0,Winter,1664,3518,0,True
2015,02/01,Roanoke,1.5,150,3819,0,903,68,0,Winter,1053,3887,0,True
2015,01/25,Roanoke,1.47,117,4133,0,759,400,0,Winter,876,4533,0,True
2015,01/18,Roanoke,1.48,109,4464,0,626,420,0,Winter,735,4884,0,True
2015,01/11,Roanoke,1.47,82,4065,0,806,173,0,Winter,888,4238,0,True
2015,01/04,Roanoke,1.39,56,2760,0,1139,457,0,Winter,1195,3217,0,True
2015,12/27,Sacramento,1.72,1142,3722,0,80,0,0,Winter,1222,3722,0,True
2015,12/20,Sacramento,1.68,1124,3959,0,77,0,0,Winter,1201,3959,0,True
2015,12/13,Sacramento,1.68,1171,3811,0,158,0,0,Winter,1329,3811,0,True
2015,12/06,Sacramento,1.43,1835,4810,0,762,13,0,Winter,2597,4823,0,True
2015,11/29,Sacramento,2.04,872,3592,0,112,66,0,Fall,984,3658,0,True
2015,11/22,Sacramento,1.79,923,3860,0,140,30,0,Fall,1063,3890,0,True
2015,11/15,Sacramento,1.87,969,3931,0,54,28,0,Fall,1023,3959,0,True
2015,11/08,Sacramento,1.8,1335,4090,0,247,277,0,Fall,1582,4367,0,True
2015,11/01,Sacramento,1.9,1136,4277,0,66,0,0,Fall,1202,4277,0,True
2015,10/25,Sacramento,1.86,1291,4345,0,222,0,0,Fall,1513,4345,0,True
2015,10/18,Sacramento,2.14,1221,4054,0,193,0,0,Fall,1414,4054,0,True
2015,10/11,Sacramento,2.1,1179,3815,0,237,0,0,Fall,1416,3815,0,True
2015,10/04,Sacramento,2.01,1289,4536,0,179,0,0,Fall,1468,4536,0,True
2015,09/27,Sacramento,1.95,1261,3990,0,220,0,0,Fall,1481,3990,0,True
2015,09/20,Sacramento,2.0,1172,5251,0,171,0,0,Fall,1343,5251,0,True
2015,09/13,Sacramento,2.02,1364,4883,0,157,0,0,Fall,1521,4883,0,True
2015,09/06,Sacramento,2.15,1356,4540,0,78,0,0,Fall,1434,4540,0,True
2015,08/30,Sacramento,2.1,1798,4370,0,219,0,0,Summer,2017,4370,0,True
2015,08/23,Sacramento,1.84,2933,6146,0,498,0,0,Summer,3431,6146,0,True
2015,08/16,Sacramento,2.09,2115,5065,0,177,0,0,Summer,2292,5065,0,True
2015,08/09,Sacramento,2.17,1873,5095,0,290,0,0,Summer,2163,5095,0,True
2015,08/02,Sacramento,2.1,2221,4378,0,232,0,0,Summer,2453,4378,0,True
2015,07/26,Sacramento,2.12,2850,5160,0,172,0,0,Summer,3022,5160,0,True
2015,07/19,Sacramento,1.98,3147,6150,0,262,0,0,Summer,3409,6150,0,True
2015,07/12,Sacramento,1.72,5333,7961,0,425,0,0,Summer,5758,7961,0,True
2015,07/05,Sacramento,1.86,4437,5180,0,137,0,0,Summer,4574,5180,0,True
2015,06/28,Sacramento,1.84,4916,4050,0,253,0,0,Summer,5169,4050,0,True
2015,06/21,Sacramento,1.82,5107,4488,0,157,0,0,Summer,5264,4488,0,True
2015,06/14,Sacramento,1.81,4885,5256,0,197,0,0,Summer,5082,5256,0,True
2015,06/07,Sacramento,1.85,4934,4500,0,122,0,0,Summer,5056,4500,0,True
2015,05/31,Sacramento,1.62,5542,4688,0,199,0,0,Spring,5741,4688,0,True
2015,05/24,Sacramento,1.62,6010,5119,0,268,0,0,Spring,6278,5119,0,True
2015,05/17,Sacramento,1.53,7163,5530,0,351,0,0,Spring,7514,5530,0,True
2015,05/10,Sacramento,1.3,13918,13294,0,622,0,0,Spring,14540,13294,0,True
2015,05/03,Sacramento,1.64,4124,4001,0,189,0,0,Spring,4313,4001,0,True
2015,04/26,Sacramento,1.62,5069,4401,0,166,0,0,Spring,5235,4401,0,True
2015,04/19,Sacramento,1.65,4447,4568,0,148,0,0,Spring,4595,4568,0,True
2015,04/12,Sacramento,1.65,4230,3803,0,171,0,0,Spring,4401,3803,0,True
2015,04/05,Sacramento,1.64,4591,4319,0,102,0,0,Spring,4693,4319,0,True
2015,03/29,Sacramento,1.64,5357,4490,0,111,0,0,Spring,5468,4490,0,True
2015,03/22,Sacramento,1.52,4117,3666,0,91,0,0,Spring,4208,3666,0,True
2015,03/15,Sacramento,1.63,4595,4262,0,217,0,0,Spring,4812,4262,0,True
2015,03/08,Sacramento,1.6,4923,4582,0,160,0,0,Spring,5083,4582,0,True
2015,03/01,Sacramento,1.22,25103,19850,0,401,0,0,Spring,25504,19850,0,True
2015,02/22,Sacramento,1.51,5027,3605,0,148,3,0,Winter,5175,3608,0,True
2015,02/15,Sacramento,1.63,3520,3406,0,509,0,0,Winter,4029,3406,0,True
2015,02/08,Sacramento,1.5,3831,3186,0,1658,0,0,Winter,5489,3186,0,True
2015,02/01,Sacramento,1.22,7103,5624,0,467,0,0,Winter,7570,5624,0,True
2015,01/25,Sacramento,1.44,4291,4741,0,674,0,0,Winter,4965,4741,0,True
2015,01/18,Sacramento,1.13,15363,20986,0,883,0,0,Winter,16246,20986,0,True
2015,01/11,Sacramento,1.27,4243,3033,0,321,0,0,Winter,4564,3033,0,True
2015,01/04,Sacramento,1.33,3727,4327,0,1158,0,0,Winter,4885,4327,0,True
2015,12/27,SanDiego,1.62,1834,5181,0,472,1215,0,Winter,2306,6396,0,True
2015,12/20,SanDiego,1.23,1099,5048,0,592,4986,0,Winter,1691,10034,0,True
2015,12/13,SanDiego,1.27,1084,5007,3,674,5472,0,Winter,1758,10479,3,True
2015,12/06,SanDiego,1.83,1256,3763,0,541,3,0,Winter,1797,3766,0,True
2015,11/29,SanDiego,1.87,1232,5300,0,489,0,0,Fall,1721,5300,0,True
2015,11/22,SanDiego,1.85,1689,5341,0,397,10,0,Fall,2086,5351,0,True
2015,11/15,SanDiego,1.68,1537,6399,0,430,71,0,Fall,1967,6470,0,True
2015,11/08,SanDiego,1.82,1234,7001,0,499,166,0,Fall,1733,7167,0,True
2015,11/01,SanDiego,1.64,1478,7160,0,775,41,0,Fall,2253,7201,0,True
2015,10/25,SanDiego,1.65,1955,6641,0,561,5,0,Fall,2516,6646,0,True
2015,10/18,SanDiego,1.85,1707,5314,0,554,0,0,Fall,2261,5314,0,True
2015,10/11,SanDiego,1.82,2112,4869,0,491,0,0,Fall,2603,4869,0,True
2015,10/04,SanDiego,1.85,1759,6195,0,535,0,0,Fall,2294,6195,0,True
2015,09/27,SanDiego,1.7,2858,5619,0,420,0,0,Fall,3278,5619,0,True
2015,09/20,SanDiego,1.69,2634,7404,0,245,0,0,Fall,2879,7404,0,True
2015,09/13,SanDiego,1.81,3295,6467,0,596,3,0,Fall,3891,6470,0,True
2015,09/06,SanDiego,1.85,2333,6614,0,392,0,0,Fall,2725,6614,0,True
2015,08/30,SanDiego,1.88,1986,6676,0,422,0,0,Summer,2408,6676,0,True
2015,08/23,SanDiego,1.74,2433,7936,0,447,0,0,Summer,2880,7936,0,True
2015,08/16,SanDiego,1.82,2762,5555,0,745,0,0,Summer,3507,5555,0,True
2015,08/09,SanDiego,1.82,2628,5592,0,680,0,0,Summer,3308,5592,0,True
2015,08/02,SanDiego,1.86,2569,7080,0,592,0,0,Summer,3161,7080,0,True
2015,07/26,SanDiego,1.71,2844,7142,0,289,0,0,Summer,3133,7142,0,True
2015,07/19,SanDiego,1.85,2480,6332,0,346,0,0,Summer,2826,6332,0,True
2015,07/12,SanDiego,1.81,3360,5927,0,472,0,0,Summer,3832,5927,0,True
2015,07/05,SanDiego,1.55,3011,12801,0,538,0,0,Summer,3549,12801,0,True
2015,06/28,SanDiego,1.55,2398,10206,0,342,0,0,Summer,2740,10206,0,True
2015,06/21,SanDiego,1.56,2962,7601,0,491,0,0,Summer,3453,7601,0,True
2015,06/14,SanDiego,1.53,3328,7539,3,567,0,0,Summer,3895,7539,3,True
2015,06/07,SanDiego,1.51,2793,6690,0,888,0,0,Summer,3681,6690,0,True
2015,05/31,SanDiego,1.49,2933,6895,0,1111,0,0,Spring,4044,6895,0,True
2015,05/24,SanDiego,1.51,2853,8566,0,624,0,0,Spring,3477,8566,0,True
2015,05/17,SanDiego,1.48,2511,7398,0,1003,0,0,Spring,3514,7398,0,True
2015,05/10,SanDiego,1.45,2069,7045,0,1365,0,0,Spring,3434,7045,0,True
2015,05/03,SanDiego,1.41,2617,6294,0,1594,0,0,Spring,4211,6294,0,True
2015,04/26,SanDiego,1.48,2780,6603,0,1314,0,0,Spring,4094,6603,0,True
2015,04/19,SanDiego,1.52,2524,7216,0,527,0,0,Spring,3051,7216,0,True
2015,04/12,SanDiego,1.49,3994,6126,0,545,0,0,Spring,4539,6126,0,True
2015,04/05,SanDiego,1.53,4079,6401,0,690,0,0,Spring,4769,6401,0,True
2015,03/29,SanDiego,1.53,3207,5150,0,604,0,0,Spring,3811,5150,0,True
2015,03/22,SanDiego,1.16,8173,4447,0,330,0,0,Spring,8503,4447,0,True
2015,03/15,SanDiego,1.49,7690,315,0,343,0,0,Spring,8033,315,0,True
2015,03/08,SanDiego,1.48,8439,375,0,654,0,0,Spring,9093,375,0,True
2015,03/01,SanDiego,1.09,18706,795,0,904,0,0,Spring,19610,795,0,True
2015,02/22,SanDiego,1.44,10994,483,0,286,0,0,Winter,11280,483,0,True
2015,02/15,SanDiego,1.49,11531,555,0,688,0,0,Winter,12219,555,0,True
2015,02/08,SanDiego,1.29,13016,926,0,1111,0,0,Winter,14127,926,0,True
2015,02/01,SanDiego,1.11,16215,1142,2,1263,0,0,Winter,17478,1142,2,True
2015,01/25,SanDiego,1.26,9245,470,0,1416,0,0,Winter,10661,470,0,True
2015,01/18,SanDiego,1.29,12300,580,0,1593,0,0,Winter,13893,580,0,True
2015,01/11,SanDiego,1.05,18294,767,1,1025,0,0,Winter,19319,767,1,True
2015,01/04,SanDiego,1.23,17522,735,2,828,0,0,Winter,18350,735,2,True
2015,12/27,SanFrancisco,1.88,792,13036,0,252,0,0,Winter,1044,13036,0,True
2015,12/20,SanFrancisco,1.87,980,12582,0,140,0,0,Winter,1120,12582,0,True
2015,12/13,SanFrancisco,1.94,1379,12152,0,181,0,0,Winter,1560,12152,0,True
2015,12/06,SanFrancisco,1.92,1663,13355,0,125,0,0,Winter,1788,13355,0,True
2015,11/29,SanFrancisco,2.58,953,12235,0,3,26,0,Fall,956,12261,0,True
2015,11/22,SanFrancisco,2.04,791,13499,0,37,26,0,Fall,828,13525,0,True
2015,11/15,SanFrancisco,2.02,1082,15979,0,16,0,0,Fall,1098,15979,0,True
2015,11/08,SanFrancisco,1.98,1285,16543,0,51,6,0,Fall,1336,16549,0,True
2015,11/01,SanFrancisco,2.01,1359,16197,0,25,0,0,Fall,1384,16197,0,True
2015,10/25,SanFrancisco,1.94,1334,17960,0,15,0,0,Fall,1349,17960,0,True
2015,10/18,SanFrancisco,2.79,961,11680,0,0,0,0,Fall,961,11680,0,True
2015,10/11,SanFrancisco,2.66,1046,12984,0,0,0,0,Fall,1046,12984,0,True
2015,10/04,SanFrancisco,2.59,1418,13915,0,12,0,0,Fall,1430,13915,0,True
2015,09/27,SanFrancisco,2.74,1220,10523,0,54,0,0,Fall,1274,10523,0,True
2015,09/20,SanFrancisco,2.79,1209,13971,0,15,0,0,Fall,1224,13971,0,True
2015,09/13,SanFrancisco,2.73,1404,13395,0,3,0,0,Fall,1407,13395,0,True
2015,09/06,SanFrancisco,2.73,1413,14090,0,6,0,0,Fall,1419,14090,0,True
2015,08/30,SanFrancisco,2.77,1561,13617,0,22,0,0,Summer,1583,13617,0,True
2015,08/23,SanFrancisco,2.71,1808,13252,0,50,0,0,Summer,1858,13252,0,True
2015,08/16,SanFrancisco,2.73,1761,13512,0,15,0,0,Summer,1776,13512,0,True
2015,08/09,SanFrancisco,2.72,1802,13737,0,25,0,0,Summer,1827,13737,0,True
2015,08/02,SanFrancisco,2.76,1762,12145,0,28,0,0,Summer,1790,12145,0,True
2015,07/26,SanFrancisco,2.75,2892,13047,0,12,0,0,Summer,2904,13047,0,True
2015,07/19,SanFrancisco,2.36,3893,15665,0,0,0,0,Summer,3893,15665,0,True
2015,07/12,SanFrancisco,2.09,7913,15212,0,15,0,0,Summer,7928,15212,0,True
2015,07/05,SanFrancisco,1.96,13491,9796,0,18,0,0,Summer,13509,9796,0,True
2015,06/28,SanFrancisco,1.96,12195,7667,0,6,0,0,Summer,12201,7667,0,True
2015,06/21,SanFrancisco,1.95,14256,9227,0,15,3,0,Summer,14271,9230,0,True
2015,06/14,SanFrancisco,1.95,15257,8712,0,3,0,0,Summer,15260,8712,0,True
2015,06/07,SanFrancisco,1.96,14837,8027,0,21,0,0,Summer,14858,8027,0,True
2015,05/31,SanFrancisco,1.54,15942,8626,0,12,0,0,Spring,15954,8626,0,True
2015,05/24,SanFrancisco,1.52,19270,10024,0,24,0,0,Spring,19294,10024,0,True
2015,05/17,SanFrancisco,1.53,22521,8741,0,9,0,0,Spring,22530,8741,0,True
2015,05/10,SanFrancisco,1.48,23021,10608,0,46,0,0,Spring,23067,10608,0,True
2015,05/03,SanFrancisco,1.55,19043,10162,0,43,0,0,Spring,19086,10162,0,True
2015,04/26,SanFrancisco,1.52,22964,8946,0,40,0,0,Spring,23004,8946,0,True
2015,04/19,SanFrancisco,1.55,19780,9164,0,40,0,0,Spring,19820,9164,0,True
2015,04/12,SanFrancisco,1.54,18887,9332,0,0,0,0,Spring,18887,9332,0,True
2015,04/05,SanFrancisco,1.55,17104,9426,0,0,0,0,Spring,17104,9426,0,True
2015,03/29,SanFrancisco,1.55,18872,9215,0,6,0,0,Spring,18878,9215,0,True
2015,03/22,SanFrancisco,1.34,12997,8370,0,3,0,0,Spring,13000,8370,0,True
2015,03/15,SanFrancisco,1.56,13268,8105,0,15,0,0,Spring,13283,8105,0,True
2015,03/08,SanFrancisco,1.56,12933,7159,0,18,0,0,Spring,12951,7159,0,True
2015,03/01,SanFrancisco,1.09,34980,14818,0,21,0,0,Spring,35001,14818,0,True
2015,02/22,SanFrancisco,1.39,25492,11724,0,6,0,0,Winter,25498,11724,0,True
2015,02/15,SanFrancisco,1.55,16514,8294,0,177,0,0,Winter,16691,8294,0,True
2015,02/08,SanFrancisco,1.35,17561,9396,0,598,0,0,Winter,18159,9396,0,True
2015,02/01,SanFrancisco,1.06,38413,19160,0,227,0,0,Winter,38640,19160,0,True
2015,01/25,SanFrancisco,1.34,17038,9879,0,228,0,0,Winter,17266,9879,0,True
2015,01/18,SanFrancisco,1.27,26336,14789,0,356,0,0,Winter,26692,14789,0,True
2015,01/11,SanFrancisco,1.12,17907,11586,0,182,0,0,Winter,18089,11586,0,True
2015,01/04,SanFrancisco,1.18,13175,9028,0,426,0,0,Winter,13601,9028,0,True
2015,12/27,Seattle,1.51,610,13103,4,80,7580,0,Winter,690,20683,4,True
2015,12/20,Seattle,1.55,505,13425,12,51,8823,0,Winter,556,22248,12,True
2015,12/13,Seattle,1.03,617,19731,34,51,32901,0,Winter,668,52632,34,True
2015,12/06,Seattle,2.06,556,11750,14,11,4272,0,Winter,567,16022,14,True
2015,11/29,Seattle,2.06,647,13403,34,31,3649,0,Fall,678,17052,34,True
2015,11/22,Seattle,1.14,969,22035,51,115,41650,0,Fall,1084,63685,51,True
2015,11/15,Seattle,1.5,2049,11965,17,290,13114,0,Fall,2339,25079,17,True
2015,11/08,Seattle,1.46,7713,14739,54,470,8624,0,Fall,8183,23363,54,True
2015,11/01,Seattle,1.25,7748,20764,418,9127,17108,0,Fall,16875,37872,418,True
2015,10/25,Seattle,1.74,3749,11950,63,647,9346,0,Fall,4396,21296,63,True
2015,10/18,Seattle,1.88,4351,11840,19,1027,5893,0,Fall,5378,17733,19,True
2015,10/11,Seattle,1.75,4297,13215,11,2,9222,0,Fall,4299,22437,11,True
2015,10/04,Seattle,1.73,4207,19775,6,5,10027,0,Fall,4212,29802,6,True
2015,09/27,Seattle,1.75,4793,11315,6,2,8489,0,Fall,4795,19804,6,True
2015,09/20,Seattle,1.97,4479,8805,15,2,4555,0,Fall,4481,13360,15,True
2015,09/13,Seattle,2.11,5766,11752,6,14,5371,0,Fall,5780,17123,6,True
2015,09/06,Seattle,1.99,5475,11441,5,2,6965,0,Fall,5477,18406,5,True
2015,08/30,Seattle,1.58,5555,35591,2,0,7026,0,Summer,5555,42617,2,True
2015,08/23,Seattle,1.9,5058,23395,31,0,6493,0,Summer,5058,29888,31,True
2015,08/16,Seattle,1.7,7047,27537,2,0,13138,0,Summer,7047,40675,2,True
2015,08/09,Seattle,1.96,7894,14573,17,0,5313,0,Summer,7894,19886,17,True
2015,08/02,Seattle,2.04,8531,14816,55,0,3353,0,Summer,8531,18169,55,True
2015,07/26,Seattle,2.2,8288,18815,50,0,582,0,Summer,8288,19397,50,True
2015,07/19,Seattle,1.64,7839,35593,73,0,5977,0,Summer,7839,41570,73,True
2015,07/12,Seattle,2.23,6831,18168,16,0,85,0,Summer,6831,18253,16,True
2015,07/05,Seattle,1.98,8841,20807,280,0,0,0,Summer,8841,20807,280,True
2015,06/28,Seattle,1.71,8112,37972,144,0,0,0,Summer,8112,37972,144,True
2015,06/21,Seattle,1.75,8727,29192,91,0,82,0,Summer,8727,29274,91,True
2015,06/14,Seattle,2.03,10611,20743,197,0,349,0,Summer,10611,21092,197,True
2015,06/07,Seattle,2.01,10962,21345,37,0,1059,0,Summer,10962,22404,37,True
2015,05/31,Seattle,1.65,11101,41130,83,0,1507,0,Spring,11101,42637,83,True
2015,05/24,Seattle,1.85,10926,17449,33,0,2584,0,Spring,10926,20033,33,True
2015,05/17,Seattle,1.81,10837,18774,11,0,3929,0,Spring,10837,22703,11,True
2015,05/10,Seattle,1.66,9690,22159,58,0,5171,0,Spring,9690,27330,58,True
2015,05/03,Seattle,1.56,8323,21227,11,14,7680,0,Spring,8337,28907,11,True
2015,04/26,Seattle,1.66,8195,30041,74,0,1598,0,Spring,8195,31639,74,True
2015,04/19,Seattle,1.76,9788,24647,72,0,2225,0,Spring,9788,26872,72,True
2015,04/12,Seattle,1.59,8715,48802,45,2,3459,0,Spring,8717,52261,45,True
2015,04/05,Seattle,1.92,6708,22605,43,0,334,0,Spring,6708,22939,43,True
2015,03/29,Seattle,1.56,8899,43641,18,0,3548,0,Spring,8899,47189,18,True
2015,03/22,Seattle,1.53,10717,38095,30,0,2512,0,Spring,10717,40607,30,True
2015,03/15,Seattle,1.8,8978,17520,15,0,203,0,Spring,8978,17723,15,True
2015,03/08,Seattle,1.62,7056,38276,95,0,2048,0,Spring,7056,40324,95,True
2015,03/01,Seattle,1.71,8762,14933,226,0,608,0,Spring,8762,15541,226,True
2015,02/22,Seattle,1.5,13839,20645,83,0,615,0,Winter,13839,21260,83,True
2015,02/15,Seattle,1.59,11802,22861,51,116,2637,0,Winter,11918,25498,51,True
2015,02/08,Seattle,1.4,8561,34897,32,586,10406,0,Winter,9147,45303,32,True
2015,02/01,Seattle,1.44,12927,21460,35,406,5505,0,Winter,13333,26965,35,True
2015,01/25,Seattle,1.7,6876,17363,7,453,4654,0,Winter,7329,22017,7,True
2015,01/18,Seattle,1.45,6222,30224,7,216,7944,0,Winter,6438,38168,7,True
2015,01/11,Seattle,1.46,8691,33361,13,223,4396,0,Winter,8914,37757,13,True
2015,01/04,Seattle,1.49,6821,20720,1,452,5799,0,Winter,7273,26519,1,True
2015,12/27,SouthCarolina,1.71,561,1202,306,1516,30,0,Winter,2077,1232,306,True
2015,12/20,SouthCarolina,1.77,572,1280,344,1033,10,0,Winter,1605,1290,344,True
2015,12/13,SouthCarolina,1.74,558,1373,268,1601,92,0,Winter,2159,1465,268,True
2015,12/06,SouthCarolina,1.73,574,1195,295,1594,116,0,Winter,2168,1311,295,True
2015,11/29,SouthCarolina,1.71,369,1185,348,1472,166,0,Fall,1841,1351,348,True
2015,11/22,SouthCarolina,1.89,557,1342,371,847,9,0,Fall,1404,1351,371,True
2015,11/15,SouthCarolina,1.82,575,1273,373,1366,6,0,Fall,1941,1279,373,True
2015,11/08,SouthCarolina,1.74,638,1186,422,2429,42,0,Fall,3067,1228,422,True
2015,11/01,SouthCarolina,1.75,506,1292,526,1626,101,0,Fall,2132,1393,526,True
2015,10/25,SouthCarolina,1.77,600,1367,589,2089,16,0,Fall,2689,1383,589,True
2015,10/18,SouthCarolina,1.84,519,1511,500,1726,75,0,Fall,2245,1586,500,True
2015,10/11,SouthCarolina,1.79,609,1494,511,1239,342,0,Fall,1848,1836,511,True
2015,10/04,SouthCarolina,1.96,575,1475,464,1192,69,0,Fall,1767,1544,464,True
2015,09/27,SouthCarolina,2.06,509,1236,450,527,0,0,Fall,1036,1236,450,True
2015,09/20,SouthCarolina,1.91,409,1327,482,1623,7,0,Fall,2032,1334,482,True
2015,09/13,SouthCarolina,1.98,510,1315,465,1036,10,0,Fall,1546,1325,465,True
2015,09/06,SouthCarolina,2.0,541,1732,545,1166,47,0,Fall,1707,1779,545,True
2015,08/30,SouthCarolina,1.92,659,1483,554,1457,139,0,Summer,2116,1622,554,True
2015,08/23,SouthCarolina,1.91,806,1883,572,1308,336,0,Summer,2114,2219,572,True
2015,08/16,SouthCarolina,1.97,751,1634,550,1321,114,0,Summer,2072,1748,550,True
2015,08/09,SouthCarolina,2.0,610,1768,661,707,66,0,Summer,1317,1834,661,True
2015,08/02,SouthCarolina,1.94,636,1406,535,947,330,0,Summer,1583,1736,535,True
2015,07/26,SouthCarolina,1.81,825,1299,416,775,534,0,Summer,1600,1833,416,True
2015,07/19,SouthCarolina,1.79,634,1338,481,1141,480,0,Summer,1775,1818,481,True
2015,07/12,SouthCarolina,1.84,585,1449,538,1609,431,0,Summer,2194,1880,538,True
2015,07/05,SouthCarolina,1.84,535,1440,595,909,360,0,Summer,1444,1800,595,True
2015,06/28,SouthCarolina,1.9,686,1498,548,719,320,0,Summer,1405,1818,548,True
2015,06/21,SouthCarolina,2.07,585,1526,541,430,108,0,Summer,1015,1634,541,True
2015,06/14,SouthCarolina,1.99,665,1470,598,1107,79,0,Summer,1772,1549,598,True
2015,06/07,SouthCarolina,1.95,498,1234,499,1236,86,0,Summer,1734,1320,499,True
2015,05/31,SouthCarolina,2.02,613,1454,540,660,136,0,Spring,1273,1590,540,True
2015,05/24,SouthCarolina,1.99,617,1406,644,1059,85,0,Spring,1676,1491,644,True
2015,05/17,SouthCarolina,1.44,718,2245,1424,944,101,0,Spring,1662,2346,1424,True
2015,05/10,SouthCarolina,1.87,822,1101,487,1049,322,0,Spring,1871,1423,487,True
2015,05/03,SouthCarolina,1.92,451,1266,750,862,5,0,Spring,1313,1271,750,True
2015,04/26,SouthCarolina,2.02,684,1269,485,1022,83,0,Spring,1706,1352,485,True
2015,04/19,SouthCarolina,1.87,631,1637,592,1502,12,0,Spring,2133,1649,592,True
2015,04/12,SouthCarolina,1.94,527,1873,722,776,130,0,Spring,1303,2003,722,True
2015,04/05,SouthCarolina,1.97,581,1475,517,944,82,0,Spring,1525,1557,517,True
2015,03/29,SouthCarolina,1.93,727,1386,623,455,2,0,Spring,1182,1388,623,True
2015,03/22,SouthCarolina,1.77,610,1876,528,1041,99,0,Spring,1651,1975,528,True
2015,03/15,SouthCarolina,1.5,516,2676,568,823,639,0,Spring,1339,3315,568,True
2015,03/08,SouthCarolina,1.53,498,2462,536,1109,347,0,Spring,1607,2809,536,True
2015,03/01,SouthCarolina,1.52,466,2571,530,870,392,0,Spring,1336,2963,530,True
2015,02/22,SouthCarolina,1.69,484,1876,412,706,135,0,Winter,1190,2011,412,True
2015,02/15,SouthCarolina,1.72,458,1289,428,1170,16,0,Winter,1628,1305,428,True
2015,02/08,SouthCarolina,1.56,475,2142,552,2600,302,0,Winter,3075,2444,552,True
2015,02/01,SouthCarolina,1.66,456,1272,503,1580,164,0,Winter,2036,1436,503,True
2015,01/25,SouthCarolina,2.01,776,621,450,970,46,0,Winter,1746,667,450,True
2015,01/18,SouthCarolina,1.93,686,656,310,1346,24,0,Winter,2032,680,310,True
2015,01/11,SouthCarolina,2.06,474,793,357,674,3,0,Winter,1148,796,357,True
2015,01/04,SouthCarolina,1.86,355,754,439,1768,33,0,Winter,2123,787,439,True
2015,12/27,Spokane,1.59,41,1206,0,12,462,0,Winter,53,1668,0,True
2015,12/20,Spokane,1.56,42,1048,0,0,621,0,Winter,42,1669,0,True
2015,12/13,Spokane,1.32,38,1587,0,0,942,0,Winter,38,2529,0,True
2015,12/06,Spokane,2.09,56,972,0,0,123,0,Winter,56,1095,0,True
2015,11/29,Spokane,1.8,42,825,0,0,312,0,Fall,42,1137,0,True
2015,11/22,Spokane,1.23,96,1743,0,6,2040,0,Fall,102,3783,0,True
2015,11/15,Spokane,1.71,85,1059,0,70,593,0,Fall,155,1652,0,True
2015,11/08,Spokane,1.73,118,1392,0,16,310,0,Fall,134,1702,0,True
2015,11/01,Spokane,1.33,158,1585,0,0,1469,0,Fall,158,3054,0,True
2015,10/25,Spokane,1.99,220,810,0,0,374,0,Fall,220,1184,0,True
2015,10/18,Spokane,1.89,233,1103,0,8,381,0,Fall,241,1484,0,True
2015,10/11,Spokane,1.8,242,1442,0,8,487,0,Fall,250,1929,0,True
2015,10/04,Spokane,1.92,283,2418,3,12,169,0,Fall,295,2587,3,True
2015,09/27,Spokane,1.91,333,1381,0,0,277,0,Fall,333,1658,0,True
2015,09/20,Spokane,2.13,370,1127,0,0,36,0,Fall,370,1163,0,True
2015,09/13,Spokane,2.06,374,1300,0,0,167,0,Fall,374,1467,0,True
2015,09/06,Spokane,2.12,368,1198,0,0,248,0,Fall,368,1446,0,True
2015,08/30,Spokane,1.58,415,3575,0,0,326,0,Summer,415,3901,0,True
2015,08/23,Spokane,2.11,315,1027,9,0,201,0,Summer,315,1228,9,True
2015,08/16,Spokane,1.77,435,2735,0,0,887,0,Summer,435,3622,0,True
2015,08/09,Spokane,2.07,400,1609,0,0,280,0,Summer,400,1889,0,True
2015,08/02,Spokane,2.11,331,1800,0,0,52,0,Summer,331,1852,0,True
2015,07/26,Spokane,2.07,486,2057,1,0,41,0,Summer,486,2098,1,True
2015,07/19,Spokane,1.55,480,3201,0,0,533,0,Summer,480,3734,0,True
2015,07/12,Spokane,2.07,680,2105,0,0,0,0,Summer,680,2105,0,True
2015,07/05,Spokane,1.85,799,2362,0,0,0,0,Summer,799,2362,0,True
2015,06/28,Spokane,1.61,537,3550,0,0,0,0,Summer,537,3550,0,True
2015,06/21,Spokane,1.59,872,3564,0,0,0,0,Summer,872,3564,0,True
2015,06/14,Spokane,1.88,911,2160,0,0,27,0,Summer,911,2187,0,True
2015,06/07,Spokane,1.88,899,2051,0,0,192,0,Summer,899,2243,0,True
2015,05/31,Spokane,1.55,860,3616,1,0,60,0,Spring,860,3676,1,True
2015,05/24,Spokane,1.76,951,1617,3,0,309,0,Spring,951,1926,3,True
2015,05/17,Spokane,1.78,774,1609,7,0,213,0,Spring,774,1822,7,True
2015,05/10,Spokane,1.76,900,1925,0,0,340,0,Spring,900,2265,0,True
2015,05/03,Spokane,1.62,1380,2400,3,0,362,0,Spring,1380,2762,3,True
2015,04/26,Spokane,1.5,1010,2865,0,0,285,0,Spring,1010,3150,0,True
2015,04/19,Spokane,1.69,1570,2153,0,0,305,0,Spring,1570,2458,0,True
2015,04/12,Spokane,1.58,837,5183,0,106,230,0,Spring,943,5413,0,True
2015,04/05,Spokane,1.8,667,1972,0,20,43,0,Spring,687,2015,0,True
2015,03/29,Spokane,1.55,758,4642,0,0,210,0,Spring,758,4852,0,True
2015,03/22,Spokane,1.47,1522,5302,0,0,157,0,Spring,1522,5459,0,True
2015,03/15,Spokane,1.66,1140,2078,0,0,18,0,Spring,1140,2096,0,True
2015,03/08,Spokane,1.55,1044,3523,1,0,266,0,Spring,1044,3789,1,True
2015,03/01,Spokane,1.58,1237,2113,7,0,146,0,Spring,1237,2259,7,True
2015,02/22,Spokane,1.41,2067,2588,0,0,0,0,Winter,2067,2588,0,True
2015,02/15,Spokane,1.51,1630,2660,0,30,128,0,Winter,1660,2788,0,True
2015,02/08,Spokane,1.43,1103,3973,1,223,485,0,Winter,1326,4458,1,True
2015,02/01,Spokane,1.38,2284,3738,0,220,201,0,Winter,2504,3939,0,True
2015,01/25,Spokane,1.66,611,2325,3,226,146,0,Winter,837,2471,3,True
2015,01/18,Spokane,1.44,582,3132,0,146,501,0,Winter,728,3633,0,True
2015,01/11,Spokane,1.38,1159,3192,1,140,287,0,Winter,1299,3479,1,True
2015,01/04,Spokane,1.3,723,4221,0,223,614,0,Winter,946,4835,0,True
2015,12/27,StLouis,1.07,1347,935,12,214,5341,0,Winter,1561,6276,12,True
2015,12/20,StLouis,1.34,1228,866,8,47,3079,0,Winter,1275,3945,8,True
2015,12/13,StLouis,1.8,1002,927,0,25,412,0,Winter,1027,1339,0,True
2015,12/06,StLouis,2.12,733,1478,0,24,103,0,Winter,757,1581,0,True
2015,11/29,StLouis,1.58,1748,1098,0,33,1005,0,Fall,1781,2103,0,True
2015,11/22,StLouis,1.35,1866,1133,0,70,1985,0,Fall,1936,3118,0,True
2015,11/15,StLouis,1.25,1627,1240,10,227,2607,0,Fall,1854,3847,10,True
2015,11/08,StLouis,1.48,1709,1279,194,388,1391,0,Fall,2097,2670,194,True
2015,11/01,StLouis,1.04,1566,975,277,603,3765,0,Fall,2169,4740,277,True
2015,10/25,StLouis,1.2,1676,1349,227,40,3288,0,Fall,1716,4637,227,True
2015,10/18,StLouis,1.26,1817,1798,0,56,3358,0,Fall,1873,5156,0,True
2015,10/11,StLouis,1.57,1197,1561,0,76,1344,0,Fall,1273,2905,0,True
2015,10/04,StLouis,1.52,1420,1780,0,54,1887,0,Fall,1474,3667,0,True
2015,09/27,StLouis,1.94,1305,1606,0,40,375,0,Fall,1345,1981,0,True
2015,09/20,StLouis,1.91,1640,1871,0,99,425,0,Fall,1739,2296,0,True
2015,09/13,StLouis,1.87,1750,1766,0,223,355,0,Fall,1973,2121,0,True
2015,09/06,StLouis,1.96,1926,1973,0,46,220,0,Fall,1972,2193,0,True
2015,08/30,StLouis,1.92,1560,2046,0,84,550,0,Summer,1644,2596,0,True
2015,08/23,StLouis,1.97,1953,1730,0,151,229,0,Summer,2104,1959,0,True
2015,08/16,StLouis,2.07,1696,1464,0,362,0,0,Summer,2058,1464,0,True
2015,08/09,StLouis,1.97,2208,822,0,470,0,0,Summer,2678,822,0,True
2015,08/02,StLouis,1.87,3129,7,0,820,0,0,Summer,3949,7,0,True
2015,07/26,StLouis,1.91,2170,19,0,816,0,0,Summer,2986,19,0,True
2015,07/19,StLouis,1.86,1758,910,0,109,317,0,Summer,1867,1227,0,True
2015,07/12,StLouis,1.92,1501,2048,0,20,593,0,Summer,1521,2641,0,True
2015,07/05,StLouis,1.86,2030,1664,0,30,404,0,Summer,2060,2068,0,True
2015,06/28,StLouis,2.0,1101,1669,0,63,299,0,Summer,1164,1968,0,True
2015,06/21,StLouis,1.83,2154,1059,0,125,146,0,Summer,2279,1205,0,True
2015,06/14,StLouis,1.85,1911,826,0,92,107,0,Summer,2003,933,0,True
2015,06/07,StLouis,1.92,1910,1704,0,103,174,0,Summer,2013,1878,0,True
2015,05/31,StLouis,2.06,1430,2097,0,123,110,0,Spring,1553,2207,0,True
2015,05/24,StLouis,2.04,1591,2270,0,56,186,0,Spring,1647,2456,0,True
2015,05/17,StLouis,2.01,1372,1813,0,116,147,0,Spring,1488,1960,0,True
2015,05/10,StLouis,2.0,1577,1820,0,80,114,0,Spring,1657,1934,0,True
2015,05/03,StLouis,2.0,1378,1720,0,56,84,0,Spring,1434,1804,0,True
2015,04/26,StLouis,2.03,1096,1659,0,73,201,0,Spring,1169,1860,0,True
2015,04/19,StLouis,2.09,1372,1894,0,6,51,0,Spring,1378,1945,0,True
2015,04/12,StLouis,2.05,1375,1735,0,106,0,0,Spring,1481,1735,0,True
2015,04/05,StLouis,2.13,1254,2065,0,100,0,0,Spring,1354,2065,0,True
2015,03/29,StLouis,2.09,1054,2013,0,70,0,0,Spring,1124,2013,0,True
2015,03/22,StLouis,1.83,1305,2489,0,0,0,0,Spring,1305,2489,0,True
2015,03/15,StLouis,1.81,1321,2068,0,20,0,0,Spring,1341,2068,0,True
2015,03/08,StLouis,1.65,1432,675,0,153,0,0,Spring,1585,675,0,True
2015,03/01,StLouis,1.85,1100,2330,0,103,0,0,Spring,1203,2330,0,True
2015,02/22,StLouis,1.8,1268,1776,0,46,0,0,Winter,1314,1776,0,True
2015,02/15,StLouis,1.82,1691,2272,0,270,0,0,Winter,1961,2272,0,True
2015,02/08,StLouis,1.89,1601,1352,0,753,0,0,Winter,2354,1352,0,True
2015,02/01,StLouis,1.93,912,1425,0,350,0,0,Winter,1262,1425,0,True
2015,01/25,StLouis,1.93,1526,2031,0,573,0,0,Winter,2099,2031,0,True
2015,01/18,StLouis,1.92,2410,213,0,300,0,0,Winter,2710,213,0,True
2015,01/11,StLouis,1.84,1908,1590,0,263,0,0,Winter,2171,1590,0,True
2015,01/04,StLouis,1.8,1552,1521,0,523,0,0,Winter,2075,1521,0,True
2015,12/27,Syracuse,1.54,0,73,0,1336,242,0,Winter,1336,315,0,True
2015,12/20,Syracuse,1.53,0,72,0,2119,299,0,Winter,2119,371,0,True
2015,12/13,Syracuse,1.53,1,124,0,1223,785,0,Winter,1224,909,0,True
2015,12/06,Syracuse,1.56,0,54,0,1738,10,0,Winter,1738,64,0,True
2015,11/29,Syracuse,1.59,4,39,0,979,0,0,Fall,983,39,0,True
2015,11/22,Syracuse,1.63,0,48,0,1003,0,0,Fall,1003,48,0,True
2015,11/15,Syracuse,1.64,0,114,0,1235,0,0,Fall,1235,114,0,True
2015,11/08,Syracuse,1.6,3,138,0,1408,3,0,Fall,1411,141,0,True
2015,11/01,Syracuse,1.65,1,76,0,961,0,0,Fall,962,76,0,True
2015,10/25,Syracuse,1.6,0,91,0,1474,0,0,Fall,1474,91,0,True
2015,10/18,Syracuse,1.61,0,59,0,1336,2,0,Fall,1336,61,0,True
2015,10/11,Syracuse,1.57,0,26,0,1572,0,0,Fall,1572,26,0,True
2015,10/04,Syracuse,1.64,0,72,0,1058,0,0,Fall,1058,72,0,True
2015,09/27,Syracuse,1.72,1,72,0,583,0,0,Fall,584,72,0,True
2015,09/20,Syracuse,1.68,4,121,0,749,0,0,Fall,753,121,0,True
2015,09/13,Syracuse,1.61,0,102,0,1499,0,0,Fall,1499,102,0,True
2015,09/06,Syracuse,1.6,0,107,0,1989,0,0,Fall,1989,107,0,True
2015,08/30,Syracuse,1.68,1,56,0,883,0,0,Summer,884,56,0,True
2015,08/23,Syracuse,1.62,3,87,0,1527,0,0,Summer,1530,87,0,True
2015,08/16,Syracuse,1.86,0,67,0,521,0,0,Summer,521,67,0,True
2015,08/09,Syracuse,1.66,16,53,0,1226,0,0,Summer,1242,53,0,True
2015,08/02,Syracuse,1.98,5,131,0,755,3,0,Summer,760,134,0,True
2015,07/26,Syracuse,1.92,55,96,0,911,6,0,Summer,966,102,0,True
2015,07/19,Syracuse,2.07,0,75,0,406,0,0,Summer,406,75,0,True
2015,07/12,Syracuse,2.05,0,63,0,356,0,0,Summer,356,63,0,True
2015,07/05,Syracuse,1.84,1,64,0,948,0,0,Summer,949,64,0,True
2015,06/28,Syracuse,1.86,3,80,0,1536,22,0,Summer,1539,102,0,True
2015,06/21,Syracuse,1.88,9,67,0,738,81,0,Summer,747,148,0,True
2015,06/14,Syracuse,1.91,1,163,0,1200,0,0,Summer,1201,163,0,True
2015,06/07,Syracuse,1.77,0,49,0,2095,0,0,Summer,2095,49,0,True
2015,05/31,Syracuse,1.81,0,122,0,2398,0,0,Spring,2398,122,0,True
2015,05/24,Syracuse,1.8,7,103,0,2167,0,0,Spring,2174,103,0,True
2015,05/17,Syracuse,1.74,11,90,0,1978,0,0,Spring,1989,90,0,True
2015,05/10,Syracuse,1.85,1,229,0,2038,0,0,Spring,2039,229,0,True
2015,05/03,Syracuse,1.84,6,101,0,2613,0,0,Spring,2619,101,0,True
2015,04/26,Syracuse,1.77,2,45,0,2054,0,0,Spring,2056,45,0,True
2015,04/19,Syracuse,1.83,3,57,0,1001,0,0,Spring,1004,57,0,True
2015,04/12,Syracuse,1.71,0,47,0,1694,0,0,Spring,1694,47,0,True
2015,04/05,Syracuse,1.76,2,104,0,1583,0,0,Spring,1585,104,0,True
2015,03/29,Syracuse,1.82,0,126,0,627,0,0,Spring,627,126,0,True
2015,03/22,Syracuse,1.76,0,193,0,617,0,0,Spring,617,193,0,True
2015,03/15,Syracuse,1.67,0,134,0,712,0,0,Spring,712,134,0,True
2015,03/08,Syracuse,1.6,2,162,0,1719,0,0,Spring,1721,162,0,True
2015,03/01,Syracuse,1.59,0,98,0,2009,0,0,Spring,2009,98,0,True
2015,02/22,Syracuse,1.57,3,50,0,1872,0,0,Winter,1875,50,0,True
2015,02/15,Syracuse,1.72,0,47,0,513,0,0,Winter,513,47,0,True
2015,02/08,Syracuse,1.65,0,114,0,1169,0,0,Winter,1169,114,0,True
2015,02/01,Syracuse,1.65,3,111,0,1169,0,0,Winter,1172,111,0,True
2015,01/25,Syracuse,1.77,1,130,0,712,0,0,Winter,713,130,0,True
2015,01/18,Syracuse,1.84,0,151,0,476,0,0,Winter,476,151,0,True
2015,01/11,Syracuse,1.66,1,195,0,565,0,0,Winter,566,195,0,True
2015,01/04,Syracuse,1.72,0,102,0,490,0,0,Winter,490,102,0,True
2015,12/27,Tampa,1.63,874,17,0,1216,52,0,Winter,2090,69,0,True
2015,12/20,Tampa,1.79,1214,11,0,853,0,0,Winter,2067,11,0,True
2015,12/13,Tampa,1.76,947,25,0,872,0,0,Winter,1819,25,0,True
2015,12/06,Tampa,1.76,919,16,0,803,0,0,Winter,1722,16,0,True
2015,11/29,Tampa,1.73,791,8,0,885,0,0,Fall,1676,8,0,True
2015,11/22,Tampa,1.78,1113,63,0,797,10,0,Fall,1910,73,0,True
2015,11/15,Tampa,1.75,1455,44,0,1304,3,0,Fall,2759,47,0,True
2015,11/08,Tampa,1.74,871,10,0,921,0,0,Fall,1792,10,0,True
2015,11/01,Tampa,1.5,8,0,0,1530,3,0,Fall,1538,3,0,True
2015,10/25,Tampa,1.49,2,0,0,1096,0,0,Fall,1098,0,0,True
2015,10/18,Tampa,1.49,1,1,0,1160,0,0,Fall,1161,1,0,True
2015,10/11,Tampa,1.5,4,1,0,1726,0,0,Fall,1730,1,0,True
2015,10/04,Tampa,1.47,15,0,0,1387,0,0,Fall,1402,0,0,True
2015,09/27,Tampa,1.31,7,0,0,923,0,0,Fall,930,0,0,True
2015,09/20,Tampa,1.46,28,0,0,1710,0,0,Fall,1738,0,0,True
2015,09/13,Tampa,1.43,9,5,0,1240,0,0,Fall,1249,5,0,True
2015,09/06,Tampa,1.49,18,0,0,1767,0,0,Fall,1785,0,0,True
2015,08/30,Tampa,1.48,5,1,0,1272,0,0,Summer,1277,1,0,True
2015,08/23,Tampa,1.5,7,1,0,990,0,0,Summer,997,1,0,True
2015,08/16,Tampa,1.5,4,3,0,1180,0,0,Summer,1184,3,0,True
2015,08/09,Tampa,1.5,4,2,0,1243,0,0,Summer,1247,2,0,True
2015,08/02,Tampa,1.5,7,0,0,1193,0,0,Summer,1200,0,0,True
2015,07/26,Tampa,1.49,5,0,0,692,0,0,Summer,697,0,0,True
2015,07/19,Tampa,1.42,18,0,0,1090,0,0,Summer,1108,0,0,True
2015,07/12,Tampa,1.63,306,3,0,2067,0,0,Summer,2373,3,0,True
2015,07/05,Tampa,1.9,1115,2,0,990,0,0,Summer,2105,2,0,True
2015,06/28,Tampa,1.81,1325,3,0,770,0,0,Summer,2095,3,0,True
2015,06/21,Tampa,1.84,915,16,0,414,0,0,Summer,1329,16,0,True
2015,06/14,Tampa,1.73,934,5,0,1086,0,0,Summer,2020,5,0,True
2015,06/07,Tampa,1.71,972,9,0,1293,0,0,Summer,2265,9,0,True
2015,05/31,Tampa,1.72,943,5,0,1142,0,0,Spring,2085,5,0,True
2015,05/24,Tampa,1.7,803,7,0,1150,0,0,Spring,1953,7,0,True
2015,05/17,Tampa,1.69,982,3,0,929,0,0,Spring,1911,3,0,True
2015,05/10,Tampa,1.69,1063,16,0,1542,0,0,Spring,2605,16,0,True
2015,05/03,Tampa,1.34,2342,17,0,1230,0,0,Spring,3572,17,0,True
2015,04/26,Tampa,1.31,3030,16,0,728,0,0,Spring,3758,16,0,True
2015,04/19,Tampa,1.48,907,22,0,2188,0,0,Spring,3095,22,0,True
2015,04/12,Tampa,1.69,891,27,0,805,0,0,Spring,1696,27,0,True
2015,04/05,Tampa,1.72,922,5,0,1070,0,0,Spring,1992,5,0,True
2015,03/29,Tampa,1.73,1045,8,0,1156,0,0,Spring,2201,8,0,True
2015,03/22,Tampa,1.68,1190,13,0,2110,0,0,Spring,3300,13,0,True
2015,03/15,Tampa,1.68,852,5,0,1443,0,0,Spring,2295,5,0,True
2015,03/08,Tampa,1.65,832,5,0,1843,0,0,Spring,2675,5,0,True
2015,03/01,Tampa,1.63,787,7,0,2106,0,0,Spring,2893,7,0,True
2015,02/22,Tampa,1.68,965,8,0,1676,0,0,Winter,2641,8,0,True
2015,02/15,Tampa,1.75,990,2,0,993,0,0,Winter,1983,2,0,True
2015,02/08,Tampa,1.65,883,7,0,2063,0,0,Winter,2946,7,0,True
2015,02/01,Tampa,1.68,762,20,0,1326,0,0,Winter,2088,20,0,True
2015,01/25,Tampa,1.75,715,17,0,726,0,0,Winter,1441,17,0,True
2015,01/18,Tampa,1.73,810,23,0,916,0,0,Winter,1726,23,0,True
2015,01/11,Tampa,1.84,814,44,0,400,0,0,Winter,1214,44,0,True
2015,01/04,Tampa,1.7,748,30,0,1106,0,0,Winter,1854,30,0,True
2015,12/27,WestTexNewMexico,1.81,1478,2629,14,2855,177,0,Winter,4333,2806,14,True
2015,12/20,WestTexNewMexico,1.92,1512,2407,11,2213,109,0,Winter,3725,2516,11,True
2015,12/13,WestTexNewMexico,1.8,2194,2981,25,2598,36,0,Winter,4792,3017,25,True
2015,11/29,WestTexNewMexico,2.08,1395,2238,61,943,0,0,Fall,2338,2238,61,True
2015,11/22,WestTexNewMexico,1.97,1733,2873,30,1590,21,0,Fall,3323,2894,30,True
2015,11/15,WestTexNewMexico,1.92,1925,3271,16,2946,15,0,Fall,4871,3286,16,True
2015,11/08,WestTexNewMexico,1.98,2198,3139,26,2223,15,0,Fall,4421,3154,26,True
2015,11/01,WestTexNewMexico,1.92,1652,3123,0,2520,0,0,Fall,4172,3123,0,True
2015,10/25,WestTexNewMexico,2.0,1235,2895,0,2316,0,0,Fall,3551,2895,0,True
2015,10/18,WestTexNewMexico,2.02,1523,3491,0,2606,42,0,Fall,4129,3533,0,True
2015,10/11,WestTexNewMexico,2.05,1544,3601,0,2173,26,0,Fall,3717,3627,0,True
2015,10/04,WestTexNewMexico,2.01,1690,3621,0,2723,24,0,Fall,4413,3645,0,True
2015,09/27,WestTexNewMexico,1.76,1500,5237,0,1406,6,0,Fall,2906,5243,0,True
2015,09/20,WestTexNewMexico,2.19,896,2911,0,1190,25,0,Fall,2086,2936,0,True
2015,09/13,WestTexNewMexico,1.99,1309,3114,0,1763,420,0,Fall,3072,3534,0,True
2015,09/06,WestTexNewMexico,1.78,3494,3556,0,2866,636,0,Fall,6360,4192,0,True
2015,08/30,WestTexNewMexico,1.69,4328,3911,0,2383,835,0,Summer,6711,4746,0,True
2015,08/23,WestTexNewMexico,1.61,5070,3018,0,2216,1035,0,Summer,7286,4053,0,True
2015,08/16,WestTexNewMexico,1.66,3284,5434,0,2726,92,0,Summer,6010,5526,0,True
2015,08/09,WestTexNewMexico,1.86,3994,3545,0,2516,111,0,Summer,6510,3656,0,True
2015,08/02,WestTexNewMexico,1.9,4238,3463,0,596,70,0,Summer,4834,3533,0,True
2015,07/26,WestTexNewMexico,1.84,2951,3851,0,960,214,0,Summer,3911,4065,0,True
2015,07/19,WestTexNewMexico,1.74,2502,3493,0,266,601,0,Summer,2768,4094,0,True
2015,07/12,WestTexNewMexico,1.96,2449,3542,0,553,143,0,Summer,3002,3685,0,True
2015,07/05,WestTexNewMexico,1.58,6430,4300,0,2744,341,0,Summer,9174,4641,0,True
2015,06/28,WestTexNewMexico,1.58,5443,3745,0,1460,807,0,Summer,6903,4552,0,True
2015,06/21,WestTexNewMexico,1.66,5294,4443,0,1035,326,0,Summer,6329,4769,0,True
2015,06/14,WestTexNewMexico,1.55,4106,5782,0,2706,911,0,Summer,6812,6693,0,True
2015,06/07,WestTexNewMexico,1.48,5337,4286,0,2190,1550,0,Summer,7527,5836,0,True
2015,05/31,WestTexNewMexico,1.39,5389,5289,0,1948,1340,0,Spring,7337,6629,0,True
2015,05/24,WestTexNewMexico,1.38,6545,4514,0,1826,1427,0,Spring,8371,5941,0,True
2015,05/17,WestTexNewMexico,1.42,7604,5425,0,1936,1547,0,Spring,9540,6972,0,True
2015,05/10,WestTexNewMexico,1.43,5881,4326,6,1853,1539,0,Spring,7734,5865,6,True
2015,05/03,WestTexNewMexico,1.51,4523,4781,0,1523,1338,0,Spring,6046,6119,0,True
2015,04/26,WestTexNewMexico,1.92,3284,12724,4,2616,1003,0,Spring,5900,13727,4,True
2015,04/19,WestTexNewMexico,1.6,3654,4477,0,1770,1174,0,Spring,5424,5651,0,True
2015,04/12,WestTexNewMexico,1.66,2470,3359,0,1860,645,0,Spring,4330,4004,0,True
2015,04/05,WestTexNewMexico,1.8,2827,3353,0,2619,271,0,Spring,5446,3624,0,True
2015,03/29,WestTexNewMexico,1.77,2193,3230,0,2061,0,0,Spring,4254,3230,0,True
2015,03/22,WestTexNewMexico,1.84,2209,3525,0,2036,0,0,Spring,4245,3525,0,True
2015,03/15,WestTexNewMexico,1.82,1732,2997,0,1316,0,0,Spring,3048,2997,0,True
2015,03/08,WestTexNewMexico,1.59,2757,2923,0,4715,10,0,Spring,7472,2933,0,True
2015,03/01,WestTexNewMexico,1.64,2206,2725,0,3811,0,0,Spring,6017,2725,0,True
2015,02/22,WestTexNewMexico,1.71,2209,3488,0,3017,5,0,Winter,5226,3493,0,True
2015,02/15,WestTexNewMexico,1.7,2095,2610,0,2604,0,0,Winter,4699,2610,0,True
2015,02/08,WestTexNewMexico,1.66,2240,2867,0,4163,0,0,Winter,6403,2867,0,True
2015,02/01,WestTexNewMexico,1.77,1634,3012,0,2563,0,0,Winter,4197,3012,0,True
2015,01/25,WestTexNewMexico,1.63,1934,3032,0,2320,36,0,Winter,4254,3068,0,True
2015,01/18,WestTexNewMexico,1.71,1793,2078,0,1620,15,0,Winter,3413,2093,0,True
2015,01/11,WestTexNewMexico,1.69,1822,2377,0,2656,5,0,Winter,4478,2382,0,True
2015,01/04,WestTexNewMexico,1.64,1561,2958,0,1663,0,0,Winter,3224,2958,0,True
2016,12/25,Albany,1.93,77,250,0,1387,0,0,Winter,1464,250,0,True
2016,12/18,Albany,1.86,111,198,0,1163,0,0,Winter,1274,198,0,True
2016,12/11,Albany,1.9,42,156,0,1687,0,0,Winter,1729,156,0,True
2016,12/04,Albany,1.97,100,99,0,1165,0,0,Winter,1265,99,0,True
2016,11/27,Albany,1.97,50,177,0,1418,0,0,Fall,1468,177,0,True
2016,11/20,Albany,1.93,122,197,0,1542,0,0,Fall,1664,197,0,True
2016,11/13,Albany,2.0,75,191,0,1817,0,0,Fall,1892,191,0,True
2016,11/06,Albany,1.93,60,194,0,2419,0,0,Fall,2479,194,0,True
2016,10/30,Albany,1.96,57,93,0,1175,0,0,Fall,1232,93,0,True
2016,10/23,Albany,1.86,37,80,0,1795,0,0,Fall,1832,80,0,True
2016,10/16,Albany,1.75,71,111,0,1756,0,0,Fall,1827,111,0,True
2016,10/09,Albany,1.75,77,155,0,1946,0,0,Fall,2023,155,0,True
2016,10/02,Albany,1.73,51,139,0,2301,0,0,Fall,2352,139,0,True
2016,09/25,Albany,1.68,33,190,0,1795,0,0,Fall,1828,190,0,True
2016,09/18,Albany,1.69,47,194,0,1895,0,0,Fall,1942,194,0,True
2016,09/11,Albany,1.68,128,227,0,3144,0,0,Fall,3272,227,0,True
2016,09/04,Albany,1.73,52,181,0,1960,0,0,Fall,2012,181,0,True
2016,08/28,Albany,1.66,17,200,0,1704,0,0,Summer,1721,200,0,True
2016,08/21,Albany,1.67,19,233,0,1672,0,0,Summer,1691,233,0,True
2016,08/14,Albany,1.72,29,252,0,1326,0,0,Summer,1355,252,0,True
2016,08/07,Albany,1.67,54,206,0,1285,0,0,Summer,1339,206,0,True
2016,07/31,Albany,1.43,29,204,0,1319,0,0,Summer,1348,204,0,True
2016,07/24,Albany,1.42,23,175,0,1612,0,0,Summer,1635,175,0,True
2016,07/17,Albany,1.57,16,201,0,2182,0,0,Summer,2198,201,0,True
2016,07/10,Albany,1.58,31,113,0,2027,0,0,Summer,2058,113,0,True
2016,07/03,Albany,1.43,11,261,0,3256,0,0,Summer,3267,261,0,True
2016,06/26,Albany,1.53,0,162,0,1759,0,0,Summer,1759,162,0,True
2016,06/19,Albany,1.45,10,149,0,814,0,0,Summer,824,149,0,True
2016,06/12,Albany,1.43,4,150,0,732,0,0,Summer,736,150,0,True
2016,06/05,Albany,1.47,2,203,0,801,0,0,Summer,803,203,0,True
2016,05/29,Albany,1.49,5,218,0,892,0,0,Spring,897,218,0,True
2016,05/22,Albany,1.55,26,346,0,820,0,0,Spring,846,346,0,True
2016,05/15,Albany,1.59,17,367,0,874,0,0,Spring,891,367,0,True
2016,05/08,Albany,1.83,0,536,0,1567,0,0,Spring,1567,536,0,True
2016,05/01,Albany,1.78,5,240,0,1357,0,0,Spring,1362,240,0,True
2016,04/24,Albany,1.77,19,430,0,1878,0,0,Spring,1897,430,0,True
2016,04/17,Albany,1.82,0,374,0,1684,0,0,Spring,1684,374,0,True
2016,04/10,Albany,1.62,7,161,0,1992,0,0,Spring,1999,161,0,True
2016,04/03,Albany,1.56,36,193,0,1673,0,0,Spring,1709,193,0,True
2016,03/27,Albany,1.65,14,98,0,1592,0,0,Spring,1606,98,0,True
2016,03/20,Albany,1.76,14,258,0,1460,0,0,Spring,1474,258,0,True
2016,03/13,Albany,1.79,25,303,0,1493,0,0,Spring,1518,303,0,True
2016,03/06,Albany,1.92,65,401,0,1236,0,0,Spring,1301,401,0,True
2016,02/28,Albany,1.79,9,143,0,1327,5,0,Winter,1336,148,0,True
2016,02/21,Albany,1.79,23,213,0,1045,0,0,Winter,1068,213,0,True
2016,02/14,Albany,1.81,50,263,0,933,0,0,Winter,983,263,0,True
2016,02/07,Albany,1.81,33,254,0,962,2,0,Winter,995,256,0,True
2016,01/31,Albany,1.79,34,186,0,1085,0,0,Winter,1119,186,0,True
2016,01/24,Albany,1.83,23,294,0,1180,7,0,Winter,1203,301,0,True
2016,01/17,Albany,1.67,66,430,0,992,7,0,Winter,1058,437,0,True
2016,01/10,Albany,1.83,35,329,0,1311,0,0,Winter,1346,329,0,True
2016,01/03,Albany,1.75,7,187,0,950,0,0,Winter,957,187,0,True
2016,12/25,Atlanta,1.76,895,2981,0,0,1579,0,Winter,895,4560,0,True
2016,12/18,Atlanta,1.19,824,2790,0,5,5800,0,Winter,829,8590,0,True
2016,12/11,Atlanta,1.06,916,2803,0,78,9455,0,Winter,994,12258,0,True
2016,12/04,Atlanta,1.22,738,2945,0,20,6286,0,Winter,758,9231,0,True
2016,11/27,Atlanta,1.41,705,2515,0,510,4023,0,Fall,1215,6538,0,True
2016,11/20,Atlanta,1.56,917,3156,0,1769,3912,0,Fall,2686,7068,0,True
2016,11/13,Atlanta,1.63,924,3867,0,2042,4283,0,Fall,2966,8150,0,True
2016,11/06,Atlanta,1.64,1268,5723,0,196,5221,0,Fall,1464,10944,0,True
2016,10/30,Atlanta,2.25,1126,5373,0,0,1067,0,Fall,1126,6440,0,True
2016,10/23,Atlanta,1.25,979,5629,0,11,10171,0,Fall,990,15800,0,True
2016,10/16,Atlanta,1.15,1142,4640,0,47,11834,0,Fall,1189,16474,0,True
2016,10/09,Atlanta,1.07,1672,4499,0,65,13026,0,Fall,1737,17525,0,True
2016,10/02,Atlanta,2.29,1714,4946,0,22,373,0,Fall,1736,5319,0,True
2016,09/25,Atlanta,2.02,1400,4568,0,83,1862,0,Fall,1483,6430,0,True
2016,09/18,Atlanta,1.91,1392,4819,0,112,1906,0,Fall,1504,6725,0,True
2016,09/11,Atlanta,1.43,1355,4532,0,1772,5355,0,Fall,3127,9887,0,True
2016,09/04,Atlanta,1.38,1585,5389,0,2064,6067,0,Fall,3649,11456,0,True
2016,08/28,Atlanta,1.14,1480,4894,0,1774,10333,0,Summer,3254,15227,0,True
2016,08/21,Atlanta,1.62,2212,4513,0,2478,3227,0,Summer,4690,7740,0,True
2016,08/14,Atlanta,1.58,2514,4567,0,1854,4113,0,Summer,4368,8680,0,True
2016,08/07,Atlanta,1.06,2265,5919,0,1331,14791,0,Summer,3596,20710,0,True
2016,07/31,Atlanta,1.62,2799,5878,0,1371,4413,0,Summer,4170,10291,0,True
2016,07/24,Atlanta,1.91,2682,6193,0,1668,1075,0,Summer,4350,7268,0,True
2016,07/17,Atlanta,1.21,2094,4551,0,1996,8163,0,Summer,4090,12714,0,True
2016,07/10,Atlanta,1.13,2275,6735,0,1524,6776,0,Summer,3799,13511,0,True
2016,07/03,Atlanta,0.85,2065,6670,0,1465,10123,0,Summer,3530,16793,0,True
2016,06/26,Atlanta,0.92,2096,5307,0,1075,7679,0,Summer,3171,12986,0,True
2016,06/19,Atlanta,0.81,1602,5021,0,588,9364,0,Summer,2190,14385,0,True
2016,06/12,Atlanta,0.97,2079,5830,0,894,7657,0,Summer,2973,13487,0,True
2016,06/05,Atlanta,1.04,1891,4901,0,950,5083,0,Summer,2841,9984,0,True
2016,05/29,Atlanta,1.35,1866,4018,0,883,2080,0,Spring,2749,6098,0,True
2016,05/22,Atlanta,1.27,2303,3734,0,1262,4104,0,Spring,3565,7838,0,True
2016,05/15,Atlanta,1.29,1970,3792,0,1442,3657,0,Spring,3412,7449,0,True
2016,05/08,Atlanta,1.42,2105,3559,0,1348,2649,0,Spring,3453,6208,0,True
2016,05/01,Atlanta,1.25,2003,4136,0,897,4011,0,Spring,2900,8147,0,True
2016,04/24,Atlanta,1.38,2236,4002,0,1418,2201,0,Spring,3654,6203,0,True
2016,04/17,Atlanta,1.36,2435,3185,0,891,1839,0,Spring,3326,5024,0,True
2016,04/10,Atlanta,1.5,2789,3538,0,714,88,0,Spring,3503,3626,0,True
2016,04/03,Atlanta,1.51,3529,3854,0,993,906,0,Spring,4522,4760,0,True
2016,03/27,Atlanta,1.48,2454,3700,0,820,1951,0,Spring,3274,5651,0,True
2016,03/20,Atlanta,1.44,2263,2989,0,613,1569,0,Spring,2876,4558,0,True
2016,03/13,Atlanta,1.52,2392,3420,0,562,592,0,Spring,2954,4012,0,True
2016,03/06,Atlanta,1.66,2601,3440,0,246,330,0,Spring,2847,3770,0,True
2016,02/28,Atlanta,1.78,2039,2747,0,223,59,0,Winter,2262,2806,0,True
2016,02/21,Atlanta,1.74,2034,2318,0,503,402,0,Winter,2537,2720,0,True
2016,02/14,Atlanta,1.59,1825,2428,0,346,1136,0,Winter,2171,3564,0,True
2016,02/07,Atlanta,1.72,1932,2613,0,160,715,0,Winter,2092,3328,0,True
2016,01/31,Atlanta,1.71,2689,2147,0,1163,591,0,Winter,3852,2738,0,True
2016,01/24,Atlanta,1.65,2193,2432,0,713,854,0,Winter,2906,3286,0,True
2016,01/17,Atlanta,1.84,2279,2471,0,203,272,0,Winter,2482,2743,0,True
2016,01/10,Atlanta,1.66,2123,2121,0,392,977,0,Winter,2515,3098,0,True
2016,01/03,Atlanta,1.48,3970,2151,0,1037,793,0,Winter,5007,2944,0,True
2016,12/25,BaltimoreWashington,1.83,802,5202,232,10821,3,0,Winter,11623,5205,232,True
2016,12/18,BaltimoreWashington,1.86,968,5004,302,7711,42,0,Winter,8679,5046,302,True
2016,12/11,BaltimoreWashington,1.97,820,6367,229,8822,5,0,Winter,9642,6372,229,True
2016,12/04,BaltimoreWashington,2.15,947,6090,266,6684,0,0,Winter,7631,6090,266,True
2016,11/27,BaltimoreWashington,2.17,676,6554,239,5195,8,0,Fall,5871,6562,239,True
2016,11/20,BaltimoreWashington,2.03,639,6753,330,5399,24,0,Fall,6038,6777,330,True
2016,11/13,BaltimoreWashington,2.2,842,6128,449,4209,6,0,Fall,5051,6134,449,True
2016,11/06,BaltimoreWashington,2.28,815,7611,461,5633,15,0,Fall,6448,7626,461,True
2016,10/30,BaltimoreWashington,1.85,546,12485,681,3424,11,0,Fall,3970,12496,681,True
2016,10/23,BaltimoreWashington,1.81,368,12887,756,3407,15,0,Fall,3775,12902,756,True
2016,10/16,BaltimoreWashington,1.95,824,9095,680,6226,17,0,Fall,7050,9112,680,True
2016,10/09,BaltimoreWashington,1.87,691,10306,575,7004,33,0,Fall,7695,10339,575,True
2016,10/02,BaltimoreWashington,2.15,482,9803,330,7645,27,0,Fall,8127,9830,330,True
2016,09/25,BaltimoreWashington,2.06,538,10810,285,9892,6,0,Fall,10430,10816,285,True
2016,09/18,BaltimoreWashington,2.06,541,7808,321,14046,17,0,Fall,14587,7825,321,True
2016,09/11,BaltimoreWashington,2.14,633,6730,315,12716,0,0,Fall,13349,6730,315,True
2016,09/04,BaltimoreWashington,2.03,705,9032,432,9025,2,0,Fall,9730,9034,432,True
2016,08/28,BaltimoreWashington,2.05,1227,8991,300,3534,16,0,Summer,4761,9007,300,True
2016,08/21,BaltimoreWashington,1.77,2700,8409,466,8945,2,0,Summer,11645,8411,466,True
2016,08/14,BaltimoreWashington,1.76,2206,10855,367,3443,16,0,Summer,5649,10871,367,True
2016,08/07,BaltimoreWashington,1.87,644,10561,472,6379,13,0,Summer,7023,10574,472,True
2016,07/31,BaltimoreWashington,2.02,895,10096,495,3301,0,0,Summer,4196,10096,495,True
2016,07/24,BaltimoreWashington,2.08,739,9008,541,6748,228,0,Summer,7487,9236,541,True
2016,07/17,BaltimoreWashington,1.98,692,9119,716,8595,2509,0,Summer,9287,11628,716,True
2016,07/10,BaltimoreWashington,1.96,672,9092,535,6320,593,0,Summer,6992,9685,535,True
2016,07/03,BaltimoreWashington,1.99,888,9004,454,5720,1166,0,Summer,6608,10170,454,True
2016,06/26,BaltimoreWashington,1.89,1820,9002,427,7795,1205,0,Summer,9615,10207,427,True
2016,06/19,BaltimoreWashington,1.75,1023,10027,405,4620,828,0,Summer,5643,10855,405,True
2016,06/12,BaltimoreWashington,1.73,719,10078,381,6648,973,0,Summer,7367,11051,381,True
2016,06/05,BaltimoreWashington,1.75,642,9973,312,11219,772,0,Summer,11861,10745,312,True
2016,05/29,BaltimoreWashington,1.7,754,10667,322,9420,2270,0,Spring,10174,12937,322,True
2016,05/22,BaltimoreWashington,1.87,623,9582,278,11243,326,0,Spring,11866,9908,278,True
2016,05/15,BaltimoreWashington,1.7,684,8702,189,6434,924,0,Spring,7118,9626,189,True
2016,05/08,BaltimoreWashington,1.52,1619,11266,322,6751,1336,0,Spring,8370,12602,322,True
2016,05/01,BaltimoreWashington,1.77,1081,10151,331,12286,350,0,Spring,13367,10501,331,True
2016,04/24,BaltimoreWashington,1.65,969,12045,254,13051,1014,0,Spring,14020,13059,254,True
2016,04/17,BaltimoreWashington,1.49,2672,11275,293,7622,504,0,Spring,10294,11779,293,True
2016,04/10,BaltimoreWashington,1.73,890,9254,351,9771,1744,0,Spring,10661,10998,351,True
2016,04/03,BaltimoreWashington,1.71,648,9898,276,10792,653,0,Spring,11440,10551,276,True
2016,03/27,BaltimoreWashington,1.65,1397,7193,301,7020,1104,0,Spring,8417,8297,301,True
2016,03/20,BaltimoreWashington,1.61,1677,6707,390,6172,1384,0,Spring,7849,8091,390,True
2016,03/13,BaltimoreWashington,1.54,851,8994,281,5005,3935,0,Spring,5856,12929,281,True
2016,03/06,BaltimoreWashington,1.41,658,10332,340,2023,8256,0,Spring,2681,18588,340,True
2016,02/28,BaltimoreWashington,1.62,503,8253,308,1187,4303,0,Winter,1690,12556,308,True
2016,02/21,BaltimoreWashington,1.54,602,10520,284,1978,4618,0,Winter,2580,15138,284,True
2016,02/14,BaltimoreWashington,1.82,625,7940,269,3703,2389,0,Winter,4328,10329,269,True
2016,02/07,BaltimoreWashington,1.66,643,7814,346,2034,6364,0,Winter,2677,14178,346,True
2016,01/31,BaltimoreWashington,1.47,680,7178,385,788,9994,0,Winter,1468,17172,385,True
2016,01/24,BaltimoreWashington,1.58,719,5525,327,2472,9243,0,Winter,3191,14768,327,True
2016,01/17,BaltimoreWashington,1.59,527,7394,316,910,5218,0,Winter,1437,12612,316,True
2016,01/10,BaltimoreWashington,1.37,495,6973,401,915,11731,0,Winter,1410,18704,401,True
2016,01/03,BaltimoreWashington,1.56,581,6584,507,1212,7221,0,Winter,1793,13805,507,True
2016,12/25,Boise,0.77,3,610,0,862,4622,0,Winter,865,5232,0,True
2016,12/18,Boise,1.14,6,406,0,552,1646,0,Winter,558,2052,0,True
2016,12/11,Boise,1.52,0,461,0,433,969,0,Winter,433,1430,0,True
2016,12/04,Boise,1.48,0,442,0,405,1205,0,Winter,405,1647,0,True
2016,11/27,Boise,1.38,0,296,0,598,1563,0,Fall,598,1859,0,True
2016,11/20,Boise,1.46,0,368,0,490,1451,0,Fall,490,1819,0,True
2016,11/13,Boise,1.92,0,653,0,250,918,0,Fall,250,1571,0,True
2016,11/06,Boise,2.0,0,726,0,40,628,0,Fall,40,1354,0,True
2016,10/30,Boise,1.87,0,349,0,0,522,0,Fall,0,871,0,True
2016,10/23,Boise,1.76,0,396,0,216,434,0,Fall,216,830,0,True
2016,10/16,Boise,1.33,0,384,0,442,2012,0,Fall,442,2396,0,True
2016,10/09,Boise,1.5,3,380,0,290,783,0,Fall,293,1163,0,True
2016,10/02,Boise,1.33,0,409,0,471,1793,0,Fall,471,2202,0,True
2016,09/25,Boise,1.39,3,414,0,545,1193,0,Fall,548,1607,0,True
2016,09/18,Boise,1.76,4,815,0,705,613,0,Fall,709,1428,0,True
2016,09/11,Boise,1.29,0,620,0,1238,1679,0,Fall,1238,2299,0,True
2016,09/04,Boise,1.47,0,1426,0,419,1255,0,Fall,419,2681,0,True
2016,08/28,Boise,2.24,0,1508,0,311,16,0,Summer,311,1524,0,True
2016,08/21,Boise,1.64,0,1042,0,378,1064,0,Summer,378,2106,0,True
2016,08/14,Boise,1.87,2,1243,0,335,560,0,Summer,337,1803,0,True
2016,08/07,Boise,1.26,0,547,0,1143,958,0,Summer,1143,1505,0,True
2016,07/31,Boise,1.42,12,718,0,975,526,0,Summer,987,1244,0,True
2016,07/24,Boise,1.92,0,991,0,489,16,0,Summer,489,1007,0,True
2016,07/17,Boise,1.54,2,1238,0,760,945,0,Summer,762,2183,0,True
2016,07/10,Boise,1.34,0,1495,0,446,2787,0,Summer,446,4282,0,True
2016,07/03,Boise,1.2,0,1729,0,471,5037,0,Summer,471,6766,0,True
2016,06/26,Boise,1.26,0,2173,0,678,2892,0,Summer,678,5065,0,True
2016,06/19,Boise,1.05,0,4079,0,2003,2825,0,Summer,2003,6904,0,True
2016,06/12,Boise,1.59,0,1092,0,380,309,0,Summer,380,1401,0,True
2016,06/05,Boise,1.65,0,1431,0,373,24,0,Summer,373,1455,0,True
2016,05/29,Boise,1.38,5,1132,0,473,595,0,Spring,478,1727,0,True
2016,05/22,Boise,1.43,0,2320,0,390,68,0,Spring,390,2388,0,True
2016,05/15,Boise,1.55,2,1152,0,360,240,0,Spring,362,1392,0,True
2016,05/08,Boise,1.11,0,835,0,273,1372,0,Spring,273,2207,0,True
2016,05/01,Boise,0.92,0,496,0,176,1767,0,Spring,176,2263,0,True
2016,04/24,Boise,1.46,1,2510,0,336,58,0,Spring,337,2568,0,True
2016,04/17,Boise,1.56,11,670,0,306,240,0,Spring,317,910,0,True
2016,04/10,Boise,1.0,2,1463,0,240,1763,0,Spring,242,3226,0,True
2016,04/03,Boise,1.08,15,772,0,225,1895,0,Spring,240,2667,0,True
2016,03/27,Boise,1.41,19,1333,0,353,858,0,Spring,372,2191,0,True
2016,03/20,Boise,0.82,14,1604,0,216,4258,0,Spring,230,5862,0,True
2016,03/13,Boise,0.95,25,586,0,96,2631,0,Spring,121,3217,0,True
2016,03/06,Boise,1.15,16,490,0,0,874,0,Spring,16,1364,0,True
2016,02/28,Boise,1.84,45,514,0,0,7,0,Winter,45,521,0,True
2016,02/21,Boise,1.67,35,425,0,14,87,0,Winter,49,512,0,True
2016,02/14,Boise,0.87,42,839,0,204,1775,0,Winter,246,2614,0,True
2016,02/07,Boise,0.84,15,460,0,720,876,0,Winter,735,1336,0,True
2016,01/31,Boise,1.24,23,425,0,223,987,0,Winter,246,1412,0,True
2016,01/24,Boise,1.77,12,497,0,183,423,0,Winter,195,920,0,True
2016,01/17,Boise,1.37,16,602,0,153,955,0,Winter,169,1557,0,True
2016,01/10,Boise,1.04,36,684,0,211,1440,0,Winter,247,2124,0,True
2016,01/03,Boise,1.28,14,394,0,250,542,0,Winter,264,936,0,True
2016,12/25,Boston,1.98,11,938,0,10593,9,0,Winter,10604,947,0,True
2016,12/18,Boston,2.0,30,1065,1,10535,178,0,Winter,10565,1243,1,True
2016,12/11,Boston,1.88,22,1093,0,12593,4,0,Winter,12615,1097,0,True
2016,12/04,Boston,2.0,29,945,0,12893,37,0,Winter,12922,982,0,True
2016,11/27,Boston,1.94,29,907,0,8776,73,0,Fall,8805,980,0,True
2016,11/20,Boston,1.8,51,1005,0,10225,4,0,Fall,10276,1009,0,True
2016,11/13,Boston,1.59,22,1133,0,8505,0,0,Fall,8527,1133,0,True
2016,11/06,Boston,1.72,62,1259,0,8433,0,0,Fall,8495,1259,0,True
2016,10/30,Boston,1.49,118,810,0,7479,0,0,Fall,7597,810,0,True
2016,10/23,Boston,1.32,13,337,0,7802,0,0,Fall,7815,337,0,True
2016,10/16,Boston,1.43,7,1123,0,7624,4,0,Fall,7631,1127,0,True
2016,10/09,Boston,1.57,30,706,0,9676,4,0,Fall,9706,710,0,True
2016,10/02,Boston,1.63,11,771,0,10425,0,0,Fall,10436,771,0,True
2016,09/25,Boston,1.72,19,578,0,13296,10,0,Fall,13315,588,0,True
2016,09/18,Boston,1.86,8,704,0,17658,0,0,Fall,17666,704,0,True
2016,09/11,Boston,1.84,39,888,0,16052,0,0,Fall,16091,888,0,True
2016,09/04,Boston,1.73,15,754,0,13679,68,0,Fall,13694,822,0,True
2016,08/28,Boston,1.36,9,678,0,7653,53,0,Summer,7662,731,0,True
2016,08/21,Boston,1.28,32,677,0,10694,9,0,Summer,10726,686,0,True
2016,08/14,Boston,1.23,20,589,0,6502,4,0,Summer,6522,593,0,True
2016,08/07,Boston,1.31,18,535,0,9025,0,0,Summer,9043,535,0,True
2016,07/31,Boston,1.14,16,576,0,6710,10,0,Summer,6726,586,0,True
2016,07/24,Boston,1.49,3,666,0,8677,489,0,Summer,8680,1155,0,True
2016,07/17,Boston,1.77,4,624,0,12690,1458,0,Summer,12694,2082,0,True
2016,07/10,Boston,1.59,17,461,0,11196,837,0,Summer,11213,1298,0,True
2016,07/03,Boston,1.61,16,444,0,12451,1797,0,Summer,12467,2241,0,True
2016,06/26,Boston,1.6,1,488,0,10365,1587,0,Summer,10366,2075,0,True
2016,06/19,Boston,1.53,1,588,0,9667,1332,0,Summer,9668,1920,0,True
2016,06/12,Boston,1.37,2,571,0,8165,1311,0,Summer,8167,1882,0,True
2016,06/05,Boston,1.49,6,566,0,10325,1823,0,Summer,10331,2389,0,True
2016,05/29,Boston,1.59,8,713,0,10705,1225,0,Spring,10713,1938,0,True
2016,05/22,Boston,1.57,8,593,0,15470,1958,0,Spring,15478,2551,0,True
2016,05/15,Boston,1.58,6,549,0,12627,1592,0,Spring,12633,2141,0,True
2016,05/08,Boston,1.58,1,742,0,12213,2632,0,Spring,12214,3374,0,True
2016,05/01,Boston,1.79,6,1444,0,15476,1610,0,Spring,15482,3054,0,True
2016,04/24,Boston,1.73,1,689,0,16196,1770,0,Spring,16197,2459,0,True
2016,04/17,Boston,1.59,0,634,0,10973,1171,0,Spring,10973,1805,0,True
2016,04/10,Boston,1.68,2,548,0,11818,2194,0,Spring,11820,2742,0,True
2016,04/03,Boston,1.73,7,549,0,10844,1361,0,Spring,10851,1910,0,True
2016,03/27,Boston,1.59,2,805,0,11614,721,0,Spring,11616,1526,0,True
2016,03/20,Boston,1.59,7,760,0,10018,880,0,Spring,10025,1640,0,True
2016,03/13,Boston,1.59,3,670,0,8439,1442,0,Spring,8442,2112,0,True
2016,03/06,Boston,1.7,11,1079,0,7203,1905,0,Spring,7214,2984,0,True
2016,02/28,Boston,1.64,6,1286,0,7968,1997,0,Winter,7974,3283,0,True
2016,02/21,Boston,1.52,13,451,0,7679,1249,0,Winter,7692,1700,0,True
2016,02/14,Boston,1.59,9,711,0,8456,349,0,Winter,8465,1060,0,True
2016,02/07,Boston,1.62,7,1515,0,7179,758,0,Winter,7186,2273,0,True
2016,01/31,Boston,1.52,6,553,0,7494,167,0,Winter,7500,720,0,True
2016,01/24,Boston,1.46,6,616,0,8226,0,0,Winter,8232,616,0,True
2016,01/17,Boston,1.13,14,743,0,8569,0,0,Winter,8583,743,0,True
2016,01/10,Boston,1.32,65,766,1,6918,0,0,Winter,6983,766,1,True
2016,01/03,Boston,1.26,6,1010,0,6612,0,0,Winter,6618,1010,0,True
2016,12/25,BuffaloRochester,1.51,1,264,0,806,26,0,Winter,807,290,0,True
2016,12/18,BuffaloRochester,1.52,34,240,0,1574,10,0,Winter,1608,250,0,True
2016,12/11,BuffaloRochester,1.81,24,516,0,2758,4,0,Winter,2782,520,0,True
2016,12/04,BuffaloRochester,1.88,25,1091,0,2521,74,0,Winter,2546,1165,0,True
2016,11/27,BuffaloRochester,1.76,9,210,0,940,61,0,Fall,949,271,0,True
2016,11/20,BuffaloRochester,1.77,6,156,0,2883,0,0,Fall,2889,156,0,True
2016,11/13,BuffaloRochester,1.68,20,247,0,878,0,0,Fall,898,247,0,True
2016,11/06,BuffaloRochester,1.56,12,144,0,1030,0,0,Fall,1042,144,0,True
2016,10/30,BuffaloRochester,1.63,3,126,0,433,0,0,Fall,436,126,0,True
2016,10/23,BuffaloRochester,1.61,20,221,0,836,0,0,Fall,856,221,0,True
2016,10/16,BuffaloRochester,1.57,29,143,0,990,0,0,Fall,1019,143,0,True
2016,10/09,BuffaloRochester,1.57,16,245,0,856,0,0,Fall,872,245,0,True
2016,10/02,BuffaloRochester,1.55,10,206,0,987,5,0,Fall,997,211,0,True
2016,09/25,BuffaloRochester,1.6,33,184,0,1636,0,0,Fall,1669,184,0,True
2016,09/18,BuffaloRochester,1.52,40,156,0,3800,2,0,Fall,3840,158,0,True
2016,09/11,BuffaloRochester,1.51,59,107,0,1529,2,0,Fall,1588,109,0,True
2016,09/04,BuffaloRochester,1.53,83,195,0,5408,0,0,Fall,5491,195,0,True
2016,08/28,BuffaloRochester,1.54,23,329,0,2552,3,0,Summer,2575,332,0,True
2016,08/21,BuffaloRochester,1.51,24,188,0,4882,23,0,Summer,4906,211,0,True
2016,08/14,BuffaloRochester,1.55,20,217,0,1455,0,0,Summer,1475,217,0,True
2016,08/07,BuffaloRochester,1.52,51,215,0,4084,0,0,Summer,4135,215,0,True
2016,07/31,BuffaloRochester,1.55,49,252,0,1101,361,0,Summer,1150,613,0,True
2016,07/24,BuffaloRochester,1.62,38,258,0,1446,962,0,Summer,1484,1220,0,True
2016,07/17,BuffaloRochester,1.76,65,397,0,1881,1877,0,Summer,1946,2274,0,True
2016,07/10,BuffaloRochester,1.8,118,169,0,2552,2220,0,Summer,2670,2389,0,True
2016,07/03,BuffaloRochester,2.02,25,263,0,1055,3759,0,Summer,1080,4022,0,True
2016,06/26,BuffaloRochester,1.78,50,224,0,3173,2432,0,Summer,3223,2656,0,True
2016,06/19,BuffaloRochester,1.72,20,228,0,4115,3200,0,Summer,4135,3428,0,True
2016,06/12,BuffaloRochester,1.57,8,294,0,2595,3719,0,Summer,2603,4013,0,True
2016,06/05,BuffaloRochester,1.54,53,464,0,2677,2662,0,Summer,2730,3126,0,True
2016,05/29,BuffaloRochester,1.64,33,1055,0,1972,3993,0,Spring,2005,5048,0,True
2016,05/22,BuffaloRochester,1.55,9,993,0,4217,3162,0,Spring,4226,4155,0,True
2016,05/15,BuffaloRochester,1.46,30,239,0,5027,2534,0,Spring,5057,2773,0,True
2016,05/08,BuffaloRochester,1.56,3,152,0,3333,3738,0,Spring,3336,3890,0,True
2016,05/01,BuffaloRochester,1.58,4,265,0,3226,3711,0,Spring,3230,3976,0,True
2016,04/24,BuffaloRochester,1.55,17,203,0,3428,3253,0,Spring,3445,3456,0,True
2016,04/17,BuffaloRochester,1.76,0,164,0,602,3527,0,Spring,602,3691,0,True
2016,04/10,BuffaloRochester,1.63,0,174,0,1835,4761,0,Spring,1835,4935,0,True
2016,04/03,BuffaloRochester,1.48,3,198,0,3321,2694,0,Spring,3324,2892,0,True
2016,03/27,BuffaloRochester,1.57,0,214,0,2237,3277,0,Spring,2237,3491,0,True
2016,03/20,BuffaloRochester,1.48,13,180,0,3454,2841,0,Spring,3467,3021,0,True
2016,03/13,BuffaloRochester,1.63,7,127,0,1186,3168,0,Spring,1193,3295,0,True
2016,03/06,BuffaloRochester,2.13,0,182,0,386,3183,0,Spring,386,3365,0,True
2016,02/28,BuffaloRochester,1.56,0,223,0,699,6011,0,Winter,699,6234,0,True
2016,02/21,BuffaloRochester,1.66,0,279,0,1223,3825,0,Winter,1223,4104,0,True
2016,02/14,BuffaloRochester,1.99,0,246,0,2769,1561,0,Winter,2769,1807,0,True
2016,02/07,BuffaloRochester,2.11,0,223,0,854,3940,0,Winter,854,4163,0,True
2016,01/31,BuffaloRochester,1.81,0,226,0,2749,1670,0,Winter,2749,1896,0,True
2016,01/24,BuffaloRochester,1.49,1,129,0,1703,205,0,Winter,1704,334,0,True
2016,01/17,BuffaloRochester,1.51,0,154,0,3138,313,0,Winter,3138,467,0,True
2016,01/10,BuffaloRochester,1.5,1,182,0,3058,1155,0,Winter,3059,1337,0,True
2016,01/03,BuffaloRochester,1.44,2,160,0,2335,3240,0,Winter,2337,3400,0,True
2016,12/25,Charlotte,1.62,74,2520,399,3479,306,0,Winter,3553,2826,399,True
2016,12/18,Charlotte,1.59,128,2824,517,3515,499,0,Winter,3643,3323,517,True
2016,12/11,Charlotte,1.68,132,2651,459,3506,404,0,Winter,3638,3055,459,True
2016,12/04,Charlotte,1.99,93,2472,346,2603,336,0,Winter,2696,2808,346,True
2016,11/27,Charlotte,2.03,163,2762,514,2766,380,0,Fall,2929,3142,514,True
2016,11/20,Charlotte,1.95,102,2877,555,3908,437,0,Fall,4010,3314,555,True
2016,11/13,Charlotte,1.94,177,2996,615,4083,643,0,Fall,4260,3639,615,True
2016,11/06,Charlotte,1.92,208,3144,728,5234,348,0,Fall,5442,3492,728,True
2016,10/30,Charlotte,1.66,160,4973,1171,3748,393,0,Fall,3908,5366,1171,True
2016,10/23,Charlotte,1.64,147,4509,811,3400,473,0,Fall,3547,4982,811,True
2016,10/16,Charlotte,1.64,162,4681,778,3485,335,0,Fall,3647,5016,778,True
2016,10/09,Charlotte,1.64,246,4951,759,4276,75,0,Fall,4522,5026,759,True
2016,10/02,Charlotte,1.78,262,3891,643,4065,47,0,Fall,4327,3938,643,True
2016,09/25,Charlotte,1.8,281,3611,676,3102,318,0,Fall,3383,3929,676,True
2016,09/18,Charlotte,1.74,240,3850,623,3896,464,0,Fall,4136,4314,623,True
2016,09/11,Charlotte,1.75,251,4140,724,4326,139,0,Fall,4577,4279,724,True
2016,09/04,Charlotte,1.81,205,4068,881,3416,10,0,Fall,3621,4078,881,True
2016,08/28,Charlotte,1.78,338,3830,738,3656,53,0,Summer,3994,3883,738,True
2016,08/21,Charlotte,1.78,457,3917,999,4245,23,0,Summer,4702,3940,999,True
2016,08/14,Charlotte,1.82,409,4531,1158,3602,20,0,Summer,4011,4551,1158,True
2016,08/07,Charlotte,1.65,405,5999,1492,2422,56,0,Summer,2827,6055,1492,True
2016,07/31,Charlotte,1.64,422,4190,1150,2242,43,0,Summer,2664,4233,1150,True
2016,07/24,Charlotte,1.62,388,4288,1242,2383,3,0,Summer,2771,4291,1242,True
2016,07/17,Charlotte,1.58,342,3579,1379,2625,13,0,Summer,2967,3592,1379,True
2016,07/10,Charlotte,1.81,312,2726,991,1614,20,0,Summer,1926,2746,991,True
2016,07/03,Charlotte,1.72,278,2594,929,1856,3,0,Summer,2134,2597,929,True
2016,06/26,Charlotte,1.59,420,2574,834,3198,6,0,Summer,3618,2580,834,True
2016,06/19,Charlotte,1.72,325,2602,663,1475,6,0,Summer,1800,2608,663,True
2016,06/12,Charlotte,1.76,381,2418,726,1082,3,0,Summer,1463,2421,726,True
2016,06/05,Charlotte,1.6,343,2507,694,2513,3,0,Summer,2856,2510,694,True
2016,05/29,Charlotte,1.66,301,2647,702,2015,10,0,Spring,2316,2657,702,True
2016,05/22,Charlotte,1.71,437,2422,544,2021,6,0,Spring,2458,2428,544,True
2016,05/15,Charlotte,1.69,320,2628,554,2500,3,0,Spring,2820,2631,554,True
2016,05/08,Charlotte,1.79,299,3030,767,1483,0,0,Spring,1782,3030,767,True
2016,05/01,Charlotte,1.68,268,2921,718,1827,0,0,Spring,2095,2921,718,True
2016,04/24,Charlotte,1.67,369,2721,639,2759,0,0,Spring,3128,2721,639,True
2016,04/17,Charlotte,1.77,400,2383,505,1170,0,0,Spring,1570,2383,505,True
2016,04/10,Charlotte,1.6,351,2597,625,2159,0,0,Spring,2510,2597,625,True
2016,04/03,Charlotte,1.71,318,2844,658,1305,0,0,Spring,1623,2844,658,True
2016,03/27,Charlotte,1.69,311,2333,615,1291,0,0,Spring,1602,2333,615,True
2016,03/20,Charlotte,1.57,370,2022,490,1829,0,0,Spring,2199,2022,490,True
2016,03/13,Charlotte,1.7,280,2080,625,1144,0,0,Spring,1424,2080,625,True
2016,03/06,Charlotte,1.79,342,2122,621,896,20,0,Spring,1238,2142,621,True
2016,02/28,Charlotte,1.83,290,2007,559,727,0,0,Winter,1017,2007,559,True
2016,02/21,Charlotte,1.81,315,1836,556,813,0,0,Winter,1128,1836,556,True
2016,02/14,Charlotte,1.75,307,1674,502,1126,0,0,Winter,1433,1674,502,True
2016,02/07,Charlotte,1.82,385,1740,640,763,0,0,Winter,1148,1740,640,True
2016,01/31,Charlotte,1.75,354,1734,630,1110,0,0,Winter,1464,1734,630,True
2016,01/24,Charlotte,1.76,332,1649,603,1150,0,0,Winter,1482,1649,603,True
2016,01/17,Charlotte,1.92,469,1659,587,276,3,0,Winter,745,1662,587,True
2016,01/10,Charlotte,1.77,313,2207,842,1425,26,0,Winter,1738,2233,842,True
2016,01/03,Charlotte,1.78,749,1979,705,821,29,0,Winter,1570,2008,705,True
2016,12/25,Chicago,1.34,52,30236,0,3122,0,0,Winter,3174,30236,0,True
2016,12/18,Chicago,1.34,59,37133,0,2923,0,0,Winter,2982,37133,0,True
2016,12/11,Chicago,1.32,63,50779,0,3270,0,0,Winter,3333,50779,0,True
2016,12/04,Chicago,1.71,87,31941,0,3127,0,0,Winter,3214,31941,0,True
2016,11/27,Chicago,2.3,57,16648,0,3315,0,0,Fall,3372,16648,0,True
2016,11/20,Chicago,2.3,49,22005,0,2869,0,0,Fall,2918,22005,0,True
2016,11/13,Chicago,2.25,56,25011,0,3414,0,0,Fall,3470,25011,0,True
2016,11/06,Chicago,2.24,38,24966,0,3813,0,0,Fall,3851,24966,0,True
2016,10/30,Chicago,2.23,88,29520,0,2998,0,0,Fall,3086,29520,0,True
2016,10/23,Chicago,2.2,84,25376,0,3276,4,0,Fall,3360,25380,0,True
2016,10/16,Chicago,2.11,72,26383,0,3972,0,0,Fall,4044,26383,0,True
2016,10/09,Chicago,2.04,79,23403,0,3512,0,0,Fall,3591,23403,0,True
2016,10/02,Chicago,2.05,100,24049,0,2997,0,0,Fall,3097,24049,0,True
2016,09/25,Chicago,2.05,93,24273,0,2363,0,0,Fall,2456,24273,0,True
2016,09/18,Chicago,2.06,98,19190,0,2588,0,0,Fall,2686,19190,0,True
2016,09/11,Chicago,2.07,92,27851,0,2202,0,0,Fall,2294,27851,0,True
2016,09/04,Chicago,2.08,91,27757,0,2043,0,0,Fall,2134,27757,0,True
2016,08/28,Chicago,2.09,699,25426,0,1511,0,0,Summer,2210,25426,0,True
2016,08/21,Chicago,2.08,69,29470,0,1712,0,0,Summer,1781,29470,0,True
2016,08/14,Chicago,2.09,84,26189,0,1381,0,0,Summer,1465,26189,0,True
2016,08/07,Chicago,2.13,75,25684,0,960,0,0,Summer,1035,25684,0,True
2016,07/31,Chicago,2.11,80,27361,0,1526,0,0,Summer,1606,27361,0,True
2016,07/24,Chicago,1.93,107,20034,0,4753,0,0,Summer,4860,20034,0,True
2016,07/17,Chicago,1.89,60,23561,0,2627,0,0,Summer,2687,23561,0,True
2016,07/10,Chicago,2.01,40,10422,0,2184,4,0,Summer,2224,10426,0,True
2016,07/03,Chicago,1.5,85,13515,0,2206,0,0,Summer,2291,13515,0,True
2016,06/26,Chicago,1.8,60,25630,0,2081,0,0,Summer,2141,25630,0,True
2016,06/19,Chicago,1.53,122,35503,0,2025,0,0,Summer,2147,35503,0,True
2016,06/12,Chicago,1.53,162,38677,0,1695,0,0,Summer,1857,38677,0,True
2016,06/05,Chicago,1.24,105,41327,0,1146,0,0,Summer,1251,41327,0,True
2016,05/29,Chicago,1.08,186,64298,0,841,0,0,Spring,1027,64298,0,True
2016,05/22,Chicago,1.33,77,44459,0,1231,0,0,Spring,1308,44459,0,True
2016,05/15,Chicago,1.61,37,30432,0,1985,0,0,Spring,2022,30432,0,True
2016,05/08,Chicago,1.62,83,33146,0,970,0,0,Spring,1053,33146,0,True
2016,05/01,Chicago,1.61,102,30785,0,569,0,0,Spring,671,30785,0,True
2016,04/24,Chicago,1.63,66,34696,0,430,0,0,Spring,496,34696,0,True
2016,04/17,Chicago,1.55,97,24629,0,678,0,0,Spring,775,24629,0,True
2016,04/10,Chicago,1.68,70,35212,0,191,0,0,Spring,261,35212,0,True
2016,04/03,Chicago,1.66,95,35272,0,234,0,0,Spring,329,35272,0,True
2016,03/27,Chicago,1.5,171,34565,0,349,0,0,Spring,520,34565,0,True
2016,03/20,Chicago,1.5,152,31926,0,377,0,0,Spring,529,31926,0,True
2016,03/13,Chicago,1.5,110,28997,0,475,0,0,Spring,585,28997,0,True
2016,03/06,Chicago,1.49,736,35610,0,427,0,0,Spring,1163,35610,0,True
2016,02/28,Chicago,1.6,918,32243,0,1002,0,0,Winter,1920,32243,0,True
2016,02/21,Chicago,1.55,945,28552,0,2993,0,0,Winter,3938,28552,0,True
2016,02/14,Chicago,1.58,751,25968,0,1936,0,0,Winter,2687,25968,0,True
2016,02/07,Chicago,1.6,872,29897,0,230,0,0,Winter,1102,29897,0,True
2016,01/31,Chicago,1.61,814,27719,0,280,0,0,Winter,1094,27719,0,True
2016,01/24,Chicago,1.62,976,23728,0,300,0,0,Winter,1276,23728,0,True
2016,01/17,Chicago,1.52,777,24636,0,160,0,0,Winter,937,24636,0,True
2016,01/10,Chicago,1.62,1437,34064,0,333,0,0,Winter,1770,34064,0,True
2016,01/03,Chicago,1.62,931,23415,0,113,0,0,Winter,1044,23415,0,True
2016,12/25,CincinnatiDayton,1.73,235,5062,0,504,790,0,Winter,739,5852,0,True
2016,12/18,CincinnatiDayton,0.82,216,4930,0,346,12427,0,Winter,562,17357,0,True
2016,12/11,CincinnatiDayton,0.64,268,4743,0,698,21778,0,Winter,966,26521,0,True
2016,12/04,CincinnatiDayton,1.07,269,5925,0,201,9261,0,Winter,470,15186,0,True
2016,11/27,CincinnatiDayton,0.79,198,4476,0,506,12161,0,Fall,704,16637,0,True
2016,11/20,CincinnatiDayton,0.96,333,5458,0,306,9471,0,Fall,639,14929,0,True
2016,11/13,CincinnatiDayton,1.52,366,6058,0,252,2838,0,Fall,618,8896,0,True
2016,11/06,CincinnatiDayton,0.9,390,8582,0,673,17698,0,Fall,1063,26280,0,True
2016,10/30,CincinnatiDayton,1.52,453,10104,0,262,4702,0,Fall,715,14806,0,True
2016,10/23,CincinnatiDayton,1.2,488,7531,0,629,8414,0,Fall,1117,15945,0,True
2016,10/16,CincinnatiDayton,1.23,660,6583,0,1830,7131,0,Fall,2490,13714,0,True
2016,10/09,CincinnatiDayton,1.51,562,9696,0,625,4334,0,Fall,1187,14030,0,True
2016,10/02,CincinnatiDayton,1.44,458,8070,0,507,5939,0,Fall,965,14009,0,True
2016,09/25,CincinnatiDayton,1.35,468,7138,0,781,7642,0,Fall,1249,14780,0,True
2016,09/18,CincinnatiDayton,1.32,577,8538,0,736,5923,0,Fall,1313,14461,0,True
2016,09/11,CincinnatiDayton,1.13,531,9471,0,875,10831,0,Fall,1406,20302,0,True
2016,09/04,CincinnatiDayton,1.34,535,10564,0,764,10210,0,Fall,1299,20774,0,True
2016,08/28,CincinnatiDayton,0.77,637,7566,0,569,25946,0,Summer,1206,33512,0,True
2016,08/21,CincinnatiDayton,1.13,453,7152,0,1046,10047,0,Summer,1499,17199,0,True
2016,08/14,CincinnatiDayton,1.3,581,8369,0,603,7509,0,Summer,1184,15878,0,True
2016,08/07,CincinnatiDayton,1.09,470,7721,0,666,13914,0,Summer,1136,21635,0,True
2016,07/31,CincinnatiDayton,1.51,554,8694,0,1047,2622,0,Summer,1601,11316,0,True
2016,07/24,CincinnatiDayton,1.65,538,10669,0,827,2553,0,Summer,1365,13222,0,True
2016,07/17,CincinnatiDayton,1.04,541,8960,0,725,12350,0,Summer,1266,21310,0,True
2016,07/10,CincinnatiDayton,0.98,481,11267,0,862,11815,0,Summer,1343,23082,0,True
2016,07/03,CincinnatiDayton,1.05,482,10370,0,746,7528,0,Summer,1228,17898,0,True
2016,06/26,CincinnatiDayton,1.02,482,9041,0,767,8951,0,Summer,1249,17992,0,True
2016,06/19,CincinnatiDayton,1.04,699,10546,0,710,9954,0,Summer,1409,20500,0,True
2016,06/12,CincinnatiDayton,1.09,545,10293,0,691,9736,0,Summer,1236,20029,0,True
2016,06/05,CincinnatiDayton,1.2,374,8709,0,759,6477,0,Summer,1133,15186,0,True
2016,05/29,CincinnatiDayton,1.24,459,8442,0,923,4869,0,Spring,1382,13311,0,True
2016,05/22,CincinnatiDayton,1.39,408,9071,0,1062,4178,0,Spring,1470,13249,0,True
2016,05/15,CincinnatiDayton,1.4,359,8892,0,1681,4272,0,Spring,2040,13164,0,True
2016,05/08,CincinnatiDayton,1.43,383,8838,0,2905,2497,0,Spring,3288,11335,0,True
2016,05/01,CincinnatiDayton,1.13,308,9102,0,1403,9645,0,Spring,1711,18747,0,True
2016,04/24,CincinnatiDayton,1.44,460,9677,0,2457,2800,0,Spring,2917,12477,0,True
2016,04/17,CincinnatiDayton,1.4,417,9447,0,1598,4457,0,Spring,2015,13904,0,True
2016,04/10,CincinnatiDayton,1.12,394,9103,0,5473,1805,0,Spring,5867,10908,0,True
2016,04/03,CincinnatiDayton,1.3,348,8344,0,580,2867,0,Spring,928,11211,0,True
2016,03/27,CincinnatiDayton,1.17,347,9168,0,533,7701,0,Spring,880,16869,0,True
2016,03/20,CincinnatiDayton,1.21,319,8546,0,496,7103,0,Spring,815,15649,0,True
2016,03/13,CincinnatiDayton,1.25,308,8663,0,540,3740,0,Spring,848,12403,0,True
2016,03/06,CincinnatiDayton,1.34,487,9078,0,136,2924,0,Spring,623,12002,0,True
2016,02/28,CincinnatiDayton,1.47,414,8307,0,280,123,0,Winter,694,8430,0,True
2016,02/21,CincinnatiDayton,1.33,529,7783,0,348,1903,0,Winter,877,9686,0,True
2016,02/14,CincinnatiDayton,1.01,545,9088,0,294,7409,0,Winter,839,16497,0,True
2016,02/07,CincinnatiDayton,1.11,443,8905,0,203,4521,0,Winter,646,13426,0,True
2016,01/31,CincinnatiDayton,1.3,335,6835,0,166,3770,0,Winter,501,10605,0,True
2016,01/24,CincinnatiDayton,1.42,411,7551,0,186,3724,0,Winter,597,11275,0,True
2016,01/17,CincinnatiDayton,1.4,573,7597,0,400,1385,0,Winter,973,8982,0,True
2016,01/10,CincinnatiDayton,1.31,689,8880,0,624,3286,0,Winter,1313,12166,0,True
2016,01/03,CincinnatiDayton,1.34,309,7637,0,363,2242,0,Winter,672,9879,0,True
2016,12/25,Columbus,1.75,543,2287,0,1588,142,0,Winter,2131,2429,0,True
2016,12/18,Columbus,1.64,504,1858,0,1254,631,0,Winter,1758,2489,0,True
2016,12/11,Columbus,1.02,448,1413,0,2531,4289,0,Winter,2979,5702,0,True
2016,12/04,Columbus,1.36,485,1639,0,3074,139,0,Winter,3559,1778,0,True
2016,11/27,Columbus,1.47,494,1889,0,2049,1070,0,Fall,2543,2959,0,True
2016,11/20,Columbus,1.31,661,2218,0,1467,2908,0,Fall,2128,5126,0,True
2016,11/13,Columbus,1.18,778,2727,0,1486,5493,0,Fall,2264,8220,0,True
2016,11/06,Columbus,0.89,537,2897,0,2262,10904,0,Fall,2799,13801,0,True
2016,10/30,Columbus,1.8,712,2810,0,1769,598,0,Fall,2481,3408,0,True
2016,10/23,Columbus,1.18,673,3073,0,1765,5061,0,Fall,2438,8134,0,True
2016,10/16,Columbus,1.01,725,3749,0,2823,8863,0,Fall,3548,12612,0,True
2016,10/09,Columbus,1.03,685,4176,1,2686,8319,0,Fall,3371,12495,1,True
2016,10/02,Columbus,1.77,570,4396,0,3048,266,0,Fall,3618,4662,0,True
2016,09/25,Columbus,1.3,789,3352,0,2538,6296,0,Fall,3327,9648,0,True
2016,09/18,Columbus,1.58,769,2564,0,1028,1163,0,Fall,1797,3727,0,True
2016,09/11,Columbus,1.12,815,3267,0,877,4473,0,Fall,1692,7740,0,True
2016,09/04,Columbus,1.17,962,4496,0,712,5698,0,Fall,1674,10194,0,True
2016,08/28,Columbus,1.32,868,4898,0,352,4067,0,Summer,1220,8965,0,True
2016,08/21,Columbus,1.67,629,4017,0,1129,1446,0,Summer,1758,5463,0,True
2016,08/14,Columbus,1.54,652,3940,0,602,2502,0,Summer,1254,6442,0,True
2016,08/07,Columbus,1.47,667,4129,0,501,3682,0,Summer,1168,7811,0,True
2016,07/31,Columbus,1.4,558,3796,0,1087,3902,0,Summer,1645,7698,0,True
2016,07/24,Columbus,1.58,642,4610,0,554,2335,0,Summer,1196,6945,0,True
2016,07/17,Columbus,1.2,713,4467,0,730,5655,0,Summer,1443,10122,0,True
2016,07/10,Columbus,1.0,570,4290,0,551,6159,0,Summer,1121,10449,0,True
2016,07/03,Columbus,1.02,583,3321,0,559,3084,0,Summer,1142,6405,0,True
2016,06/26,Columbus,1.1,492,3910,0,698,3388,0,Summer,1190,7298,0,True
2016,06/19,Columbus,0.99,632,5496,36,750,6147,0,Summer,1382,11643,36,True
2016,06/12,Columbus,1.3,574,5539,40,682,3402,0,Summer,1256,8941,40,True
2016,06/05,Columbus,1.43,527,4916,50,698,3223,0,Summer,1225,8139,50,True
2016,05/29,Columbus,1.39,371,4348,54,590,2142,0,Spring,961,6490,54,True
2016,05/22,Columbus,1.31,389,3323,18,1037,1941,0,Spring,1426,5264,18,True
2016,05/15,Columbus,1.22,346,3729,5,754,2181,0,Spring,1100,5910,5,True
2016,05/08,Columbus,1.14,372,4350,3,994,2746,0,Spring,1366,7096,3,True
2016,05/01,Columbus,1.29,358,3028,9,940,1535,0,Spring,1298,4563,9,True
2016,04/24,Columbus,0.99,1135,4546,19,1169,5003,0,Spring,2304,9549,19,True
2016,04/17,Columbus,1.17,377,5491,2,689,2947,0,Spring,1066,8438,2,True
2016,04/10,Columbus,1.52,360,4906,0,550,507,0,Spring,910,5413,0,True
2016,04/03,Columbus,1.69,317,3569,0,566,928,0,Spring,883,4497,0,True
2016,03/27,Columbus,1.54,272,4060,16,437,1877,0,Spring,709,5937,16,True
2016,03/20,Columbus,1.23,315,3453,4,408,3276,0,Spring,723,6729,4,True
2016,03/13,Columbus,1.37,376,3722,4,619,2435,0,Spring,995,6157,4,True
2016,03/06,Columbus,1.42,387,3606,0,51,809,0,Spring,438,4415,0,True
2016,02/28,Columbus,1.43,451,4249,0,239,241,0,Winter,690,4490,0,True
2016,02/21,Columbus,1.39,590,2960,0,249,581,0,Winter,839,3541,0,True
2016,02/14,Columbus,1.25,499,2710,0,210,1186,0,Winter,709,3896,0,True
2016,02/07,Columbus,1.31,499,2482,2,161,853,0,Winter,660,3335,2,True
2016,01/31,Columbus,1.28,392,2600,0,154,1142,0,Winter,546,3742,0,True
2016,01/24,Columbus,0.96,421,2812,1,328,2958,0,Winter,749,5770,1,True
2016,01/17,Columbus,1.44,796,3813,0,223,412,0,Winter,1019,4225,0,True
2016,01/10,Columbus,1.37,969,3558,0,456,678,0,Winter,1425,4236,0,True
2016,01/03,Columbus,1.51,452,2937,2,229,413,0,Winter,681,3350,2,True
2016,12/25,DallasFtWorth,1.12,4747,428,0,14829,94,0,Winter,19576,522,0,True
2016,12/18,DallasFtWorth,1.11,5025,286,0,15746,13,0,Winter,20771,299,0,True
2016,12/11,DallasFtWorth,1.14,4812,204,0,15556,45,0,Winter,20368,249,0,True
2016,12/04,DallasFtWorth,1.25,6160,124,0,14743,19,0,Winter,20903,143,0,True
2016,11/27,DallasFtWorth,1.34,5730,120,0,15328,133,0,Fall,21058,253,0,True
2016,11/20,DallasFtWorth,1.37,5461,130,0,13745,296,0,Fall,19206,426,0,True
2016,11/13,DallasFtWorth,1.32,7052,162,0,17526,279,0,Fall,24578,441,0,True
2016,11/06,DallasFtWorth,1.36,7183,95,0,17866,323,0,Fall,25049,418,0,True
2016,10/30,DallasFtWorth,1.34,4885,120,0,11802,289,0,Fall,16687,409,0,True
2016,10/23,DallasFtWorth,1.37,10832,128,0,8549,580,0,Fall,19381,708,0,True
2016,10/16,DallasFtWorth,1.27,11563,89,0,2710,6141,0,Fall,14273,6230,0,True
2016,10/09,DallasFtWorth,1.25,13182,267,0,6930,8458,0,Fall,20112,8725,0,True
2016,10/02,DallasFtWorth,1.42,14245,441,0,5673,335,0,Fall,19918,776,0,True
2016,09/25,DallasFtWorth,1.35,11604,1486,0,4964,1924,0,Fall,16568,3410,0,True
2016,09/18,DallasFtWorth,1.31,7605,1010,0,7228,2485,0,Fall,14833,3495,0,True
2016,09/11,DallasFtWorth,1.16,10022,247,0,16072,315,0,Fall,26094,562,0,True
2016,09/04,DallasFtWorth,1.05,9117,327,0,21031,239,0,Fall,30148,566,0,True
2016,08/28,DallasFtWorth,1.02,9948,259,0,23775,316,0,Summer,33723,575,0,True
2016,08/21,DallasFtWorth,0.86,21679,269,0,51921,455,0,Summer,73600,724,0,True
2016,08/14,DallasFtWorth,0.86,25938,334,0,62542,1685,0,Summer,88480,2019,0,True
2016,08/07,DallasFtWorth,1.12,11017,424,0,8515,12729,0,Summer,19532,13153,0,True
2016,07/31,DallasFtWorth,1.03,11152,584,0,20744,5727,0,Summer,31896,6311,0,True
2016,07/24,DallasFtWorth,0.99,10629,455,0,19642,4837,0,Summer,30271,5292,0,True
2016,07/17,DallasFtWorth,1.05,7602,388,0,12860,6729,0,Summer,20462,7117,0,True
2016,07/10,DallasFtWorth,1.04,6584,491,0,10175,538,0,Summer,16759,1029,0,True
2016,07/03,DallasFtWorth,0.99,12757,1067,0,18951,69,0,Summer,31708,1136,0,True
2016,06/26,DallasFtWorth,1.04,11200,580,0,18776,218,0,Summer,29976,798,0,True
2016,06/19,DallasFtWorth,1.05,10059,668,0,17132,416,0,Summer,27191,1084,0,True
2016,06/12,DallasFtWorth,1.08,11728,671,0,18194,677,0,Summer,29922,1348,0,True
2016,06/05,DallasFtWorth,1.05,9412,640,0,13879,2426,0,Summer,23291,3066,0,True
2016,05/29,DallasFtWorth,1.0,10016,341,0,12248,4974,0,Spring,22264,5315,0,True
2016,05/22,DallasFtWorth,1.0,8434,437,0,11584,3753,0,Spring,20018,4190,0,True
2016,05/15,DallasFtWorth,1.06,8541,830,0,13365,4107,0,Spring,21906,4937,0,True
2016,05/08,DallasFtWorth,1.04,8147,601,0,12168,5920,0,Spring,20315,6521,0,True
2016,05/01,DallasFtWorth,1.09,7176,965,0,11158,2368,0,Spring,18334,3333,0,True
2016,04/24,DallasFtWorth,1.0,7481,2070,0,9987,4436,0,Spring,17468,6506,0,True
2016,04/17,DallasFtWorth,1.11,9048,722,0,14278,1567,0,Spring,23326,2289,0,True
2016,04/10,DallasFtWorth,1.16,8391,644,0,8238,2797,0,Spring,16629,3441,0,True
2016,04/03,DallasFtWorth,1.18,7643,788,0,8902,1608,0,Spring,16545,2396,0,True
2016,03/27,DallasFtWorth,1.25,8355,658,0,7234,1160,0,Spring,15589,1818,0,True
2016,03/20,DallasFtWorth,1.16,7780,1096,0,6471,1502,0,Spring,14251,2598,0,True
2016,03/13,DallasFtWorth,1.2,8425,786,0,7918,1302,0,Spring,16343,2088,0,True
2016,03/06,DallasFtWorth,1.15,7164,560,0,9961,1778,0,Spring,17125,2338,0,True
2016,02/28,DallasFtWorth,1.19,7338,695,0,8702,1153,0,Winter,16040,1848,0,True
2016,02/21,DallasFtWorth,1.18,7305,614,0,6311,3000,0,Winter,13616,3614,0,True
2016,02/14,DallasFtWorth,1.27,6386,573,0,7072,1640,0,Winter,13458,2213,0,True
2016,02/07,DallasFtWorth,1.27,7123,778,0,6954,76,0,Winter,14077,854,0,True
2016,01/31,DallasFtWorth,1.36,7396,626,1,7084,6,0,Winter,14480,632,1,True
2016,01/24,DallasFtWorth,1.35,6168,453,0,7534,0,0,Winter,13702,453,0,True
2016,01/17,DallasFtWorth,1.25,7988,617,0,6016,25,0,Winter,14004,642,0,True
2016,01/10,DallasFtWorth,1.34,5332,389,0,5843,57,0,Winter,11175,446,0,True
2016,01/03,DallasFtWorth,1.26,4802,397,0,5384,192,0,Winter,10186,589,0,True
2016,12/25,Denver,0.93,5412,884,75,14897,2155,0,Winter,20309,3039,75,True
2016,12/18,Denver,1.47,9935,1781,100,675,1594,0,Winter,10610,3375,100,True
2016,12/11,Denver,0.98,14092,1601,16,379,18813,0,Winter,14471,20414,16,True
2016,12/04,Denver,0.85,12165,1971,23,713,30451,0,Winter,12878,32422,23,True
2016,11/27,Denver,1.34,11121,1566,21,4045,6612,0,Fall,15166,8178,21,True
2016,11/20,Denver,1.72,14123,1492,5,320,2368,0,Fall,14443,3860,5,True
2016,11/13,Denver,1.29,8091,1338,12,1493,13177,0,Fall,9584,14515,12,True
2016,11/06,Denver,1.74,11564,1279,24,2,877,0,Fall,11566,2156,24,True
2016,10/30,Denver,1.81,21484,2146,15,0,86,0,Fall,21484,2232,15,True
2016,10/23,Denver,1.71,15715,1952,35,0,2177,0,Fall,15715,4129,35,True
2016,10/16,Denver,1.19,6147,1283,13,572,12037,0,Fall,6719,13320,13,True
2016,10/09,Denver,1.49,11578,2259,12,4160,1639,0,Fall,15738,3898,12,True
2016,10/02,Denver,1.79,11038,1697,15,100,235,0,Fall,11138,1932,15,True
2016,09/25,Denver,1.72,9350,1694,8,1191,83,0,Fall,10541,1777,8,True
2016,09/18,Denver,1.37,10442,2216,5,9071,300,0,Fall,19513,2516,5,True
2016,09/11,Denver,1.4,10019,2407,13,8044,256,0,Fall,18063,2663,13,True
2016,09/04,Denver,1.15,8810,2263,275,11408,2268,0,Fall,20218,4531,275,True
2016,08/28,Denver,1.47,5597,1246,286,3165,1121,0,Summer,8762,2367,286,True
2016,08/21,Denver,1.78,8262,1735,15,439,198,0,Summer,8701,1933,15,True
2016,08/14,Denver,1.19,8487,1648,12,16302,206,0,Summer,24789,1854,12,True
2016,08/07,Denver,1.52,12876,2651,8,6538,207,0,Summer,19414,2858,8,True
2016,07/31,Denver,1.79,14012,2828,35,618,196,0,Summer,14630,3024,35,True
2016,07/24,Denver,1.47,14466,3103,53,10778,50,0,Summer,25244,3153,53,True
2016,07/17,Denver,1.6,15310,3457,20,2665,30,0,Summer,17975,3487,20,True
2016,07/10,Denver,1.0,10122,2278,18,24562,54,0,Summer,34684,2332,18,True
2016,07/03,Denver,1.2,13460,3315,58,11019,59,0,Summer,24479,3374,58,True
2016,06/26,Denver,1.52,14921,4022,76,94,16,0,Summer,15015,4038,76,True
2016,06/19,Denver,1.52,20528,3777,100,83,34,0,Summer,20611,3811,100,True
2016,06/12,Denver,1.46,19720,3959,29,2065,86,0,Summer,21785,4045,29,True
2016,06/05,Denver,1.32,12810,3097,21,5681,87,0,Summer,18491,3184,21,True
2016,05/29,Denver,0.96,8555,1938,22,22884,671,0,Spring,31439,2609,22,True
2016,05/22,Denver,0.92,25268,1852,33,21660,328,0,Spring,46928,2180,33,True
2016,05/15,Denver,0.99,11220,3023,23,6425,3393,0,Spring,17645,6416,23,True
2016,05/08,Denver,0.7,14280,6750,51,5921,23555,0,Spring,20201,30305,51,True
2016,05/01,Denver,0.86,85418,40808,142,25142,30554,0,Spring,110560,71362,142,True
2016,04/24,Denver,0.74,62551,37420,124,121358,8190,0,Spring,183909,45610,124,True
2016,04/17,Denver,1.0,6855,2138,28,30902,13529,0,Spring,37757,15667,28,True
2016,04/10,Denver,0.94,5150,1545,25,26493,7313,0,Spring,31643,8858,25,True
2016,04/03,Denver,1.15,6435,2257,15,11673,6867,0,Spring,18108,9124,15,True
2016,03/27,Denver,1.24,8689,2179,25,659,18872,0,Spring,9348,21051,25,True
2016,03/20,Denver,0.98,4709,3674,26,1224,27162,0,Spring,5933,30836,26,True
2016,03/13,Denver,0.74,17624,12791,53,16189,53913,0,Spring,33813,66704,53,True
2016,03/06,Denver,0.66,10700,10988,59,41656,57923,0,Spring,52356,68911,59,True
2016,02/28,Denver,1.06,4713,1955,23,15001,8391,0,Winter,19714,10346,23,True
2016,02/21,Denver,1.07,5720,2259,4,15546,10336,0,Winter,21266,12595,4,True
2016,02/14,Denver,1.18,6478,3527,27,1928,18574,0,Winter,8406,22101,27,True
2016,02/07,Denver,1.08,4205,3815,32,4198,23442,0,Winter,8403,27257,32,True
2016,01/31,Denver,0.95,6587,6336,40,14951,27455,0,Winter,21538,33791,40,True
2016,01/24,Denver,0.86,7581,5040,29,15028,17447,0,Winter,22609,22487,29,True
2016,01/17,Denver,1.15,6052,3670,23,1737,10576,0,Winter,7789,14246,23,True
2016,01/10,Denver,0.77,4369,10784,55,980,47341,0,Winter,5349,58125,55,True
2016,01/03,Denver,1.05,7003,4240,51,368,18850,0,Winter,7371,23090,51,True
2016,12/25,Detroit,1.46,1008,7376,0,634,522,0,Winter,1642,7898,0,True
2016,12/18,Detroit,1.5,835,5733,0,611,1170,0,Winter,1446,6903,0,True
2016,12/11,Detroit,0.89,477,4371,0,1010,10607,0,Winter,1487,14978,0,True
2016,12/04,Detroit,1.36,529,4890,0,6310,521,0,Winter,6839,5411,0,True
2016,11/27,Detroit,1.29,366,4158,0,2883,2711,0,Fall,3249,6869,0,True
2016,11/20,Detroit,1.05,596,4877,0,692,9083,0,Fall,1288,13960,0,True
2016,11/13,Detroit,1.08,623,7197,0,1054,13367,0,Fall,1677,20564,0,True
2016,11/06,Detroit,0.79,636,7665,0,1155,25125,0,Fall,1791,32790,0,True
2016,10/30,Detroit,1.77,687,10103,0,826,2169,0,Fall,1513,12272,0,True
2016,10/23,Detroit,1.06,683,8487,0,483,13958,0,Fall,1166,22445,0,True
2016,10/16,Detroit,0.88,820,6757,0,592,15855,0,Fall,1412,22612,0,True
2016,10/09,Detroit,0.91,678,8511,0,1015,16846,0,Fall,1693,25357,0,True
2016,10/02,Detroit,1.74,788,7978,0,746,962,0,Fall,1534,8940,0,True
2016,09/25,Detroit,1.08,786,6839,0,518,13419,0,Fall,1304,20258,0,True
2016,09/18,Detroit,1.37,858,6615,0,1142,4378,0,Fall,2000,10993,0,True
2016,09/11,Detroit,0.93,1160,7929,0,1302,13541,0,Fall,2462,21470,0,True
2016,09/04,Detroit,1.03,657,7977,0,748,11394,0,Fall,1405,19371,0,True
2016,08/28,Detroit,1.14,855,7611,0,854,9041,0,Summer,1709,16652,0,True
2016,08/21,Detroit,1.4,751,7547,0,802,4560,0,Summer,1553,12107,0,True
2016,08/14,Detroit,1.45,780,8921,0,830,4660,0,Summer,1610,13581,0,True
2016,08/07,Detroit,1.33,848,8894,0,768,8325,0,Summer,1616,17219,0,True
2016,07/31,Detroit,1.35,837,8580,0,969,7479,0,Summer,1806,16059,0,True
2016,07/24,Detroit,1.54,969,9420,0,690,5205,0,Summer,1659,14625,0,True
2016,07/17,Detroit,1.14,889,8699,0,1092,11388,0,Summer,1981,20087,0,True
2016,07/10,Detroit,0.98,768,8606,0,890,14256,0,Summer,1658,22862,0,True
2016,07/03,Detroit,1.05,778,9330,0,857,10378,0,Summer,1635,19708,0,True
2016,06/26,Detroit,1.26,716,8879,0,1000,7710,0,Summer,1716,16589,0,True
2016,06/19,Detroit,1.03,879,9121,0,880,13547,0,Summer,1759,22668,0,True
2016,06/12,Detroit,1.25,822,8482,0,1020,8925,0,Summer,1842,17407,0,True
2016,06/05,Detroit,0.73,665,9719,0,948,27351,0,Summer,1613,37070,0,True
2016,05/29,Detroit,1.41,634,11896,0,622,6258,0,Spring,1256,18154,0,True
2016,05/22,Detroit,0.88,479,8182,0,697,15573,0,Spring,1176,23755,0,True
2016,05/15,Detroit,1.33,321,7201,0,854,5628,0,Spring,1175,12829,0,True
2016,05/08,Detroit,1.28,292,8066,0,1453,6297,0,Spring,1745,14363,0,True
2016,05/01,Detroit,1.55,357,7877,0,927,4279,0,Spring,1284,12156,0,True
2016,04/24,Detroit,1.12,503,10249,0,2798,9092,0,Spring,3301,19341,0,True
2016,04/17,Detroit,1.19,437,9782,0,1637,6500,0,Spring,2074,16282,0,True
2016,04/10,Detroit,1.42,757,6902,0,743,707,0,Spring,1500,7609,0,True
2016,04/03,Detroit,1.27,597,6688,0,760,2941,0,Spring,1357,9629,0,True
2016,03/27,Detroit,1.31,481,7529,0,866,5836,0,Spring,1347,13365,0,True
2016,03/20,Detroit,0.95,689,7061,0,723,11038,0,Spring,1412,18099,0,True
2016,03/13,Detroit,1.26,728,6293,0,725,4328,0,Spring,1453,10621,0,True
2016,03/06,Detroit,1.45,853,6477,0,365,1265,0,Spring,1218,7742,0,True
2016,02/28,Detroit,1.45,2183,7092,0,290,1434,0,Winter,2473,8526,0,True
2016,02/21,Detroit,1.31,2285,5350,0,389,2615,0,Winter,2674,7965,0,True
2016,02/14,Detroit,1.31,2185,5667,0,346,2719,0,Winter,2531,8386,0,True
2016,02/07,Detroit,1.33,1808,5778,0,406,2478,0,Winter,2214,8256,0,True
2016,01/31,Detroit,1.46,1820,5379,0,466,2637,0,Winter,2286,8016,0,True
2016,01/24,Detroit,1.24,1591,5173,0,736,5549,0,Winter,2327,10722,0,True
2016,01/17,Detroit,1.73,2686,6590,0,455,1195,0,Winter,3141,7785,0,True
2016,01/10,Detroit,1.48,4763,6356,0,615,1362,0,Winter,5378,7718,0,True
2016,01/03,Detroit,1.57,1673,5173,0,196,989,0,Winter,1869,6162,0,True
2016,12/25,GrandRapids,2.04,84,813,0,463,0,0,Winter,547,813,0,True
2016,12/18,GrandRapids,2.11,37,873,0,223,46,0,Winter,260,919,0,True
2016,12/11,GrandRapids,1.97,29,855,0,160,168,0,Winter,189,1023,0,True
2016,12/04,GrandRapids,1.32,232,3063,0,710,0,0,Winter,942,3063,0,True
2016,11/27,GrandRapids,2.08,58,714,0,150,55,0,Fall,208,769,0,True
2016,11/20,GrandRapids,2.26,43,481,0,317,0,0,Fall,360,481,0,True
2016,11/13,GrandRapids,2.28,69,822,0,393,0,0,Fall,462,822,0,True
2016,11/06,GrandRapids,2.17,66,648,0,583,0,0,Fall,649,648,0,True
2016,10/30,GrandRapids,2.11,17,379,0,343,0,0,Fall,360,379,0,True
2016,10/23,GrandRapids,2.17,104,743,0,373,21,0,Fall,477,764,0,True
2016,10/16,GrandRapids,2.07,117,856,0,143,84,0,Fall,260,940,0,True
2016,10/09,GrandRapids,1.99,83,770,0,580,0,0,Fall,663,770,0,True
2016,10/02,GrandRapids,2.1,97,738,0,286,0,0,Fall,383,738,0,True
2016,09/25,GrandRapids,2.16,104,691,0,173,11,0,Fall,277,702,0,True
2016,09/18,GrandRapids,1.82,60,581,0,630,13,0,Fall,690,594,0,True
2016,09/11,GrandRapids,1.91,203,861,0,700,0,0,Fall,903,861,0,True
2016,09/04,GrandRapids,1.96,436,784,0,526,34,0,Fall,962,818,0,True
2016,08/28,GrandRapids,1.8,577,790,0,726,84,0,Summer,1303,874,0,True
2016,08/21,GrandRapids,1.94,1016,378,0,600,101,0,Summer,1616,479,0,True
2016,08/14,GrandRapids,1.93,1112,207,0,456,181,0,Summer,1568,388,0,True
2016,08/07,GrandRapids,2.03,1069,187,0,500,37,0,Summer,1569,224,0,True
2016,07/31,GrandRapids,1.86,885,214,0,753,0,0,Summer,1638,214,0,True
2016,07/24,GrandRapids,1.98,781,199,0,516,12,0,Summer,1297,211,0,True
2016,07/17,GrandRapids,1.82,345,308,0,513,54,0,Summer,858,362,0,True
2016,07/10,GrandRapids,1.73,38,1293,0,546,31,0,Summer,584,1324,0,True
2016,07/03,GrandRapids,1.8,15,1297,0,366,0,0,Summer,381,1297,0,True
2016,06/26,GrandRapids,1.38,27,2001,0,440,47,0,Summer,467,2048,0,True
2016,06/19,GrandRapids,1.67,41,1883,0,330,46,0,Summer,371,1929,0,True
2016,06/12,GrandRapids,1.51,49,3699,0,556,23,0,Summer,605,3722,0,True
2016,06/05,GrandRapids,1.28,55,2281,0,526,147,0,Summer,581,2428,0,True
2016,05/29,GrandRapids,1.69,19,1245,0,486,27,0,Spring,505,1272,0,True
2016,05/22,GrandRapids,1.75,19,1178,0,380,32,0,Spring,399,1210,0,True
2016,05/15,GrandRapids,1.6,42,1296,0,537,14,0,Spring,579,1310,0,True
2016,05/08,GrandRapids,1.56,50,1364,0,335,0,0,Spring,385,1364,0,True
2016,05/01,GrandRapids,1.36,72,1721,0,604,8,0,Spring,676,1729,0,True
2016,04/24,GrandRapids,1.47,61,2746,0,595,0,0,Spring,656,2746,0,True
2016,04/17,GrandRapids,1.57,102,788,0,720,9,0,Spring,822,797,0,True
2016,04/10,GrandRapids,1.34,62,1118,0,480,29,0,Spring,542,1147,0,True
2016,04/03,GrandRapids,1.56,78,868,0,450,12,0,Spring,528,880,0,True
2016,03/27,GrandRapids,1.53,73,1274,0,453,15,0,Spring,526,1289,0,True
2016,03/20,GrandRapids,1.33,122,3441,0,473,27,0,Spring,595,3468,0,True
2016,03/13,GrandRapids,1.33,258,916,0,450,18,0,Spring,708,934,0,True
2016,03/06,GrandRapids,1.1,351,3320,0,286,18,0,Spring,637,3338,0,True
2016,02/28,GrandRapids,1.43,1212,1566,0,203,0,0,Winter,1415,1566,0,True
2016,02/21,GrandRapids,1.58,1437,715,0,220,0,0,Winter,1657,715,0,True
2016,02/14,GrandRapids,1.36,919,981,0,266,0,0,Winter,1185,981,0,True
2016,02/07,GrandRapids,1.46,1353,561,0,196,0,0,Winter,1549,561,0,True
2016,01/31,GrandRapids,1.54,1297,733,0,236,0,0,Winter,1533,733,0,True
2016,01/24,GrandRapids,1.49,1140,665,0,533,25,0,Winter,1673,690,0,True
2016,01/17,GrandRapids,1.53,1295,471,0,326,6,0,Winter,1621,477,0,True
2016,01/10,GrandRapids,1.4,2821,939,0,366,7,0,Winter,3187,946,0,True
2016,01/03,GrandRapids,1.45,1173,1325,0,126,0,0,Winter,1299,1325,0,True
2016,12/25,HarrisburgScranton,1.81,257,163,19,8215,0,0,Winter,8472,163,19,True
2016,12/18,HarrisburgScranton,1.82,325,257,4,6034,33,0,Winter,6359,290,4,True
2016,12/11,HarrisburgScranton,1.91,193,131,15,6552,0,0,Winter,6745,131,15,True
2016,12/04,HarrisburgScranton,2.01,276,184,11,5483,0,0,Winter,5759,184,11,True
2016,11/27,HarrisburgScranton,2.07,252,162,23,4868,0,0,Fall,5120,162,23,True
2016,11/20,HarrisburgScranton,1.85,418,235,17,5718,55,0,Fall,6136,290,17,True
2016,11/13,HarrisburgScranton,1.74,252,249,10,3089,0,0,Fall,3341,249,10,True
2016,11/06,HarrisburgScranton,1.9,161,118,24,5374,0,0,Fall,5535,118,24,True
2016,10/30,HarrisburgScranton,1.82,252,202,16,3529,34,0,Fall,3781,236,16,True
2016,10/23,HarrisburgScranton,1.44,40,154,17,3297,0,0,Fall,3337,154,17,True
2016,10/16,HarrisburgScranton,1.79,135,192,11,4853,0,0,Fall,4988,192,11,True
2016,10/09,HarrisburgScranton,1.72,114,193,12,4357,8,0,Fall,4471,201,12,True
2016,10/02,HarrisburgScranton,1.86,199,142,18,4282,8,0,Fall,4481,150,18,True
2016,09/25,HarrisburgScranton,1.91,175,157,24,6473,8,0,Fall,6648,165,24,True
2016,09/18,HarrisburgScranton,2.06,220,194,22,9220,4,0,Fall,9440,198,22,True
2016,09/11,HarrisburgScranton,2.03,414,340,17,8646,249,0,Fall,9060,589,17,True
2016,09/04,HarrisburgScranton,1.85,276,260,21,6530,375,0,Fall,6806,635,21,True
2016,08/28,HarrisburgScranton,1.69,214,298,18,2752,0,0,Summer,2966,298,18,True
2016,08/21,HarrisburgScranton,1.56,376,300,10,6771,11,0,Summer,7147,311,10,True
2016,08/14,HarrisburgScranton,1.62,269,336,13,2954,16,0,Summer,3223,352,13,True
2016,08/07,HarrisburgScranton,1.72,250,286,16,5514,12,0,Summer,5764,298,16,True
2016,07/31,HarrisburgScranton,1.68,165,200,32,5191,0,0,Summer,5356,200,32,True
2016,07/24,HarrisburgScranton,1.62,154,319,138,4513,263,0,Summer,4667,582,138,True
2016,07/17,HarrisburgScranton,2.04,236,185,536,9574,1751,0,Summer,9810,1936,536,True
2016,07/10,HarrisburgScranton,1.88,302,199,203,6723,145,0,Summer,7025,344,203,True
2016,07/03,HarrisburgScranton,1.81,290,289,308,5908,546,0,Summer,6198,835,308,True
2016,06/26,HarrisburgScranton,1.9,205,168,186,5439,795,0,Summer,5644,963,186,True
2016,06/19,HarrisburgScranton,1.9,124,170,180,7112,587,0,Summer,7236,757,180,True
2016,06/12,HarrisburgScranton,1.91,284,168,1273,5204,943,0,Summer,5488,1111,1273,True
2016,06/05,HarrisburgScranton,1.59,151,127,16,7145,877,0,Summer,7296,1004,16,True
2016,05/29,HarrisburgScranton,1.75,191,190,22,7698,1014,0,Spring,7889,1204,22,True
2016,05/22,HarrisburgScranton,1.81,402,145,20,7642,301,0,Spring,8044,446,20,True
2016,05/15,HarrisburgScranton,1.79,328,146,21,7718,871,0,Spring,8046,1017,21,True
2016,05/08,HarrisburgScranton,1.6,169,177,17,5685,554,0,Spring,5854,731,17,True
2016,05/01,HarrisburgScranton,1.79,291,165,9,8580,137,0,Spring,8871,302,9,True
2016,04/24,HarrisburgScranton,1.92,179,254,10,9412,1237,0,Spring,9591,1491,10,True
2016,04/17,HarrisburgScranton,1.79,201,205,12,7950,416,0,Spring,8151,621,12,True
2016,04/10,HarrisburgScranton,1.83,93,191,11,5468,1200,0,Spring,5561,1391,11,True
2016,04/03,HarrisburgScranton,1.83,238,154,13,7752,995,0,Spring,7990,1149,13,True
2016,03/27,HarrisburgScranton,1.83,116,116,17,7986,451,0,Spring,8102,567,17,True
2016,03/20,HarrisburgScranton,1.51,156,294,9,6110,780,0,Spring,6266,1074,9,True
2016,03/13,HarrisburgScranton,1.57,219,276,18,5850,2235,0,Spring,6069,2511,18,True
2016,03/06,HarrisburgScranton,1.58,156,264,19,3238,5104,0,Spring,3394,5368,19,True
2016,02/28,HarrisburgScranton,1.83,169,204,23,3361,3424,0,Winter,3530,3628,23,True
2016,02/21,HarrisburgScranton,1.87,150,264,23,1915,3596,0,Winter,2065,3860,23,True
2016,02/14,HarrisburgScranton,2.22,208,249,20,1530,2776,0,Winter,1738,3025,20,True
2016,02/07,HarrisburgScranton,1.91,174,253,7,2492,4386,0,Winter,2666,4639,7,True
2016,01/31,HarrisburgScranton,1.49,86,186,15,718,7494,0,Winter,804,7680,15,True
2016,01/24,HarrisburgScranton,1.79,100,193,13,1930,5592,0,Winter,2030,5785,13,True
2016,01/17,HarrisburgScranton,2.0,107,294,12,979,3217,0,Winter,1086,3511,12,True
2016,01/10,HarrisburgScranton,1.32,119,203,16,690,6938,0,Winter,809,7141,16,True
2016,01/03,HarrisburgScranton,1.58,68,195,12,641,6410,0,Winter,709,6605,12,True
2016,12/25,HartfordSpringfield,2.41,64,3552,13,4456,316,0,Winter,4520,3868,13,True
2016,12/18,HartfordSpringfield,2.36,152,3987,4,3904,106,0,Winter,4056,4093,4,True
2016,12/11,HartfordSpringfield,2.54,19,3180,10,4299,3,0,Winter,4318,3183,10,True
2016,12/04,HartfordSpringfield,2.42,103,3639,2,4290,0,0,Winter,4393,3639,2,True
2016,11/27,HartfordSpringfield,2.67,46,3046,2,4006,45,0,Fall,4052,3091,2,True
2016,11/20,HartfordSpringfield,2.3,186,5910,0,3372,219,0,Fall,3558,6129,0,True
2016,11/13,HartfordSpringfield,2.68,15,3074,20,2142,7,0,Fall,2157,3081,20,True
2016,11/06,HartfordSpringfield,2.57,73,3159,2,3331,107,0,Fall,3404,3266,2,True
2016,10/30,HartfordSpringfield,2.34,275,2734,1,1080,180,0,Fall,1355,2914,1,True
2016,10/23,HartfordSpringfield,1.98,65,897,1,472,57,0,Fall,537,954,1,True
2016,10/16,HartfordSpringfield,2.33,35,3657,12,1237,188,0,Fall,1272,3845,12,True
2016,10/09,HartfordSpringfield,2.34,48,3841,2,2854,88,0,Fall,2902,3929,2,True
2016,10/02,HartfordSpringfield,2.33,61,3168,6,3937,153,0,Fall,3998,3321,6,True
2016,09/25,HartfordSpringfield,2.34,188,3116,13,6491,95,0,Fall,6679,3211,13,True
2016,09/18,HartfordSpringfield,2.36,83,3101,5,7427,26,0,Fall,7510,3127,5,True
2016,09/11,HartfordSpringfield,2.27,218,5314,10,6847,118,0,Fall,7065,5432,10,True
2016,09/04,HartfordSpringfield,2.34,167,4191,9,4653,0,0,Fall,4820,4191,9,True
2016,08/28,HartfordSpringfield,2.23,51,3719,0,833,83,0,Summer,884,3802,0,True
2016,08/21,HartfordSpringfield,2.09,151,4182,2,1676,167,0,Summer,1827,4349,2,True
2016,08/14,HartfordSpringfield,2.19,65,3573,9,1189,294,0,Summer,1254,3867,9,True
2016,08/07,HartfordSpringfield,2.36,35,3832,2,1531,0,0,Summer,1566,3832,2,True
2016,07/31,HartfordSpringfield,2.19,134,3695,1,1693,0,0,Summer,1827,3695,1,True
2016,07/24,HartfordSpringfield,2.3,28,3330,2,4130,0,0,Summer,4158,3330,2,True
2016,07/17,HartfordSpringfield,2.39,19,3863,8,8319,0,0,Summer,8338,3863,8,True
2016,07/10,HartfordSpringfield,2.33,202,3689,1,5684,0,0,Summer,5886,3689,1,True
2016,07/03,HartfordSpringfield,2.33,167,3744,8,5248,0,0,Summer,5415,3744,8,True
2016,06/26,HartfordSpringfield,2.32,37,3299,4,4014,0,0,Summer,4051,3299,4,True
2016,06/19,HartfordSpringfield,2.31,53,3159,0,3870,0,0,Summer,3923,3159,0,True
2016,06/12,HartfordSpringfield,2.31,121,3428,14,2234,0,0,Summer,2355,3428,14,True
2016,06/05,HartfordSpringfield,2.27,20,3652,0,4219,14,0,Summer,4239,3666,0,True
2016,05/29,HartfordSpringfield,2.36,108,4143,4,4437,38,0,Spring,4545,4181,4,True
2016,05/22,HartfordSpringfield,2.36,29,3535,0,6925,11,0,Spring,6954,3546,0,True
2016,05/15,HartfordSpringfield,2.34,22,3504,14,3865,53,0,Spring,3887,3557,14,True
2016,05/08,HartfordSpringfield,2.16,25,3861,5,4470,260,0,Spring,4495,4121,5,True
2016,05/01,HartfordSpringfield,2.4,105,6947,0,6560,227,0,Spring,6665,7174,0,True
2016,04/24,HartfordSpringfield,2.24,134,3140,1,7324,76,0,Spring,7458,3216,1,True
2016,04/17,HartfordSpringfield,2.2,79,3363,0,4044,633,0,Spring,4123,3996,0,True
2016,04/10,HartfordSpringfield,2.31,33,2817,0,5144,44,0,Spring,5177,2861,0,True
2016,04/03,HartfordSpringfield,2.33,219,2777,0,5737,0,0,Spring,5956,2777,0,True
2016,03/27,HartfordSpringfield,2.18,117,2754,0,5470,0,0,Spring,5587,2754,0,True
2016,03/20,HartfordSpringfield,2.3,160,3228,2,3015,0,0,Spring,3175,3228,2,True
2016,03/13,HartfordSpringfield,2.18,716,2830,10,3050,11,0,Spring,3766,2841,10,True
2016,03/06,HartfordSpringfield,2.18,657,3388,0,2313,8,0,Spring,2970,3396,0,True
2016,02/28,HartfordSpringfield,2.28,88,5929,0,3354,0,0,Winter,3442,5929,0,True
2016,02/21,HartfordSpringfield,2.24,127,2709,6,1892,0,0,Winter,2019,2709,6,True
2016,02/14,HartfordSpringfield,2.31,149,3103,0,1697,17,0,Winter,1846,3120,0,True
2016,02/07,HartfordSpringfield,2.32,190,5285,13,1900,146,0,Winter,2090,5431,13,True
2016,01/31,HartfordSpringfield,2.27,126,2375,16,1886,180,0,Winter,2012,2555,16,True
2016,01/24,HartfordSpringfield,2.28,98,2428,4,1970,6,0,Winter,2068,2434,4,True
2016,01/17,HartfordSpringfield,2.21,384,3048,4,376,21,0,Winter,760,3069,4,True
2016,01/10,HartfordSpringfield,2.08,149,2769,6,504,554,0,Winter,653,3323,6,True
2016,01/03,HartfordSpringfield,1.51,95,4683,9,624,483,0,Winter,719,5166,9,True
2016,12/25,Houston,1.21,10951,88,0,9783,3,0,Winter,20734,91,0,True
2016,12/18,Houston,1.0,7508,48,0,15811,0,0,Winter,23319,48,0,True
2016,12/11,Houston,1.02,6744,46,0,15859,0,0,Winter,22603,46,0,True
2016,12/04,Houston,1.0,7476,37,0,16243,3,0,Winter,23719,40,0,True
2016,11/27,Houston,0.98,11547,19,0,26544,3,0,Fall,38091,22,0,True
2016,11/20,Houston,0.99,11095,37,0,24950,6,0,Fall,36045,43,0,True
2016,11/13,Houston,1.1,13849,25,0,24786,23,0,Fall,38635,48,0,True
2016,11/06,Houston,1.43,14208,29,0,19912,13,0,Fall,34120,42,0,True
2016,10/30,Houston,1.46,18490,11,0,9623,3,0,Fall,28113,14,0,True
2016,10/23,Houston,1.43,26196,31,0,2701,0,0,Fall,28897,31,0,True
2016,10/16,Houston,0.89,16501,19,0,32358,10,0,Fall,48859,29,0,True
2016,10/09,Houston,0.84,14845,41,0,26330,6,0,Fall,41175,47,0,True
2016,10/02,Houston,0.81,14646,17,0,28666,10,0,Fall,43312,27,0,True
2016,09/25,Houston,0.87,13792,93,0,26875,23,0,Fall,40667,116,0,True
2016,09/18,Houston,0.9,14726,44,0,27347,40,0,Fall,42073,84,0,True
2016,09/11,Houston,0.87,14889,28,0,32087,70,0,Fall,46976,98,0,True
2016,09/04,Houston,0.91,13279,34,0,31008,46,0,Fall,44287,80,0,True
2016,08/28,Houston,0.91,15291,28,0,31611,36,0,Summer,46902,64,0,True
2016,08/21,Houston,0.98,11016,40,0,23303,60,0,Summer,34319,100,0,True
2016,08/14,Houston,1.1,10822,30,0,20700,70,0,Summer,31522,100,0,True
2016,08/07,Houston,1.36,11937,20,0,9475,126,0,Summer,21412,146,0,True
2016,07/31,Houston,1.45,15274,20,0,6036,83,0,Summer,21310,103,0,True
2016,07/24,Houston,1.45,17407,22,0,4701,46,0,Summer,22108,68,0,True
2016,07/17,Houston,1.39,16079,30,0,4578,40,0,Summer,20657,70,0,True
2016,07/10,Houston,1.2,14763,41,0,10769,68,0,Summer,25532,109,0,True
2016,07/03,Houston,1.29,9887,49,0,5392,122,0,Summer,15279,171,0,True
2016,06/26,Houston,1.32,9384,39,0,4949,594,0,Summer,14333,633,0,True
2016,06/19,Houston,1.13,9746,55,0,4002,4044,0,Summer,13748,4099,0,True
2016,06/12,Houston,1.05,8780,51,0,9910,656,0,Summer,18690,707,0,True
2016,06/05,Houston,1.05,9052,84,0,9907,1870,0,Summer,18959,1954,0,True
2016,05/29,Houston,0.96,12198,72,0,14854,1592,0,Spring,27052,1664,0,True
2016,05/22,Houston,0.97,10630,66,0,14837,3036,0,Spring,25467,3102,0,True
2016,05/15,Houston,1.0,7829,40,0,10087,4943,0,Spring,17916,4983,0,True
2016,05/08,Houston,1.04,7355,26,0,6977,6098,0,Spring,14332,6124,0,True
2016,05/01,Houston,1.1,5949,32,0,9033,1282,0,Spring,14982,1314,0,True
2016,04/24,Houston,1.07,5900,68,0,5786,3968,0,Spring,11686,4036,0,True
2016,04/17,Houston,1.11,5531,51,0,7146,3956,0,Spring,12677,4007,0,True
2016,04/10,Houston,1.2,6289,37,0,5796,1802,0,Spring,12085,1839,0,True
2016,04/03,Houston,1.18,6048,46,0,4963,1907,0,Spring,11011,1953,0,True
2016,03/27,Houston,1.24,5639,450,0,4669,2151,0,Spring,10308,2601,0,True
2016,03/20,Houston,1.29,5689,77,7,4171,1314,0,Spring,9860,1391,7,True
2016,03/13,Houston,1.25,7387,79,0,4624,911,0,Spring,12011,990,0,True
2016,03/06,Houston,1.17,7377,60,0,6085,797,0,Spring,13462,857,0,True
2016,02/28,Houston,1.28,6347,149,0,6231,55,0,Winter,12578,204,0,True
2016,02/21,Houston,1.28,7088,52,0,5175,1083,0,Winter,12263,1135,0,True
2016,02/14,Houston,1.24,6478,52,0,5084,2581,0,Winter,11562,2633,0,True
2016,02/07,Houston,1.37,7098,77,0,4146,727,0,Winter,11244,804,0,True
2016,01/31,Houston,1.44,7059,63,0,3528,6,0,Winter,10587,69,0,True
2016,01/24,Houston,1.38,5289,111,0,5096,6,0,Winter,10385,117,0,True
2016,01/17,Houston,1.31,6398,99,0,4808,0,0,Winter,11206,99,0,True
2016,01/10,Houston,1.33,4217,38,0,5837,7,0,Winter,10054,45,0,True
2016,01/03,Houston,1.36,4233,53,0,5288,67,0,Winter,9521,120,0,True
2016,12/25,Indianapolis,1.62,114,1052,0,1027,389,0,Winter,1141,1441,0,True
2016,12/18,Indianapolis,1.45,110,1166,0,704,1220,0,Winter,814,2386,0,True
2016,12/11,Indianapolis,1.09,112,1368,0,881,3886,0,Winter,993,5254,0,True
2016,12/04,Indianapolis,1.63,143,1277,0,631,1294,0,Winter,774,2571,0,True
2016,11/27,Indianapolis,1.66,120,984,0,614,1142,0,Fall,734,2126,0,True
2016,11/20,Indianapolis,1.59,149,1228,0,883,1116,0,Fall,1032,2344,0,True
2016,11/13,Indianapolis,1.71,202,1130,0,1034,1024,0,Fall,1236,2154,0,True
2016,11/06,Indianapolis,1.81,203,1663,0,1264,926,0,Fall,1467,2589,0,True
2016,10/30,Indianapolis,2.1,150,1634,0,1054,285,0,Fall,1204,1919,0,True
2016,10/23,Indianapolis,1.58,145,1419,0,581,1782,0,Fall,726,3201,0,True
2016,10/16,Indianapolis,1.48,161,1522,0,737,1071,0,Fall,898,2593,0,True
2016,10/09,Indianapolis,1.48,133,1800,0,677,867,0,Fall,810,2667,0,True
2016,10/02,Indianapolis,1.9,149,1570,0,842,426,0,Fall,991,1996,0,True
2016,09/25,Indianapolis,1.97,177,1376,0,793,659,0,Fall,970,2035,0,True
2016,09/18,Indianapolis,1.96,242,1484,0,514,632,0,Fall,756,2116,0,True
2016,09/11,Indianapolis,1.59,425,1395,0,1494,1549,0,Fall,1919,2944,0,True
2016,09/04,Indianapolis,1.56,714,1827,0,1221,1471,0,Fall,1935,3298,0,True
2016,08/28,Indianapolis,1.25,528,1507,0,1002,2993,0,Summer,1530,4500,0,True
2016,08/21,Indianapolis,1.59,454,1589,0,1321,1168,0,Summer,1775,2757,0,True
2016,08/14,Indianapolis,1.67,390,1704,0,1353,1143,0,Summer,1743,2847,0,True
2016,08/07,Indianapolis,1.7,466,1188,0,1296,1478,0,Summer,1762,2666,0,True
2016,07/31,Indianapolis,1.8,303,1335,0,1386,238,0,Summer,1689,1573,0,True
2016,07/24,Indianapolis,1.71,368,1438,0,1444,400,0,Summer,1812,1838,0,True
2016,07/17,Indianapolis,1.19,440,1496,0,1304,1773,0,Summer,1744,3269,0,True
2016,07/10,Indianapolis,1.11,429,1722,0,1233,1984,0,Summer,1662,3706,0,True
2016,07/03,Indianapolis,1.39,432,1678,0,1171,962,0,Summer,1603,2640,0,True
2016,06/26,Indianapolis,1.39,414,1463,0,1288,998,0,Summer,1702,2461,0,True
2016,06/19,Indianapolis,1.37,248,1839,0,1186,1235,0,Summer,1434,3074,0,True
2016,06/12,Indianapolis,1.34,183,1784,0,1032,1357,0,Summer,1215,3141,0,True
2016,06/05,Indianapolis,1.25,141,1769,0,1003,1083,0,Summer,1144,2852,0,True
2016,05/29,Indianapolis,1.33,166,1890,0,1428,640,0,Spring,1594,2530,0,True
2016,05/22,Indianapolis,1.36,106,1841,0,864,908,0,Spring,970,2749,0,True
2016,05/15,Indianapolis,1.26,72,1915,0,1416,1368,0,Spring,1488,3283,0,True
2016,05/08,Indianapolis,1.3,120,1964,26,772,936,0,Spring,892,2900,26,True
2016,05/01,Indianapolis,1.38,144,1825,0,1424,1020,0,Spring,1568,2845,0,True
2016,04/24,Indianapolis,1.27,131,1812,0,1236,1063,0,Spring,1367,2875,0,True
2016,04/17,Indianapolis,1.36,105,1517,2,1540,968,0,Spring,1645,2485,2,True
2016,04/10,Indianapolis,1.15,91,1291,0,970,1212,0,Spring,1061,2503,0,True
2016,04/03,Indianapolis,1.54,105,1178,0,650,344,0,Spring,755,1522,0,True
2016,03/27,Indianapolis,1.4,101,1477,0,663,973,0,Spring,764,2450,0,True
2016,03/20,Indianapolis,1.26,124,1194,0,856,1048,0,Spring,980,2242,0,True
2016,03/13,Indianapolis,1.39,134,1110,0,813,497,0,Spring,947,1607,0,True
2016,03/06,Indianapolis,1.48,250,1046,0,260,274,0,Spring,510,1320,0,True
2016,02/28,Indianapolis,1.6,347,1077,0,433,43,0,Winter,780,1120,0,True
2016,02/21,Indianapolis,1.53,320,1193,0,470,251,0,Winter,790,1444,0,True
2016,02/14,Indianapolis,1.24,368,1277,0,590,946,0,Winter,958,2223,0,True
2016,02/07,Indianapolis,1.37,363,1459,3,533,665,0,Winter,896,2124,3,True
2016,01/31,Indianapolis,1.38,281,1119,0,516,533,0,Winter,797,1652,0,True
2016,01/24,Indianapolis,1.13,334,1406,9,553,1281,0,Winter,887,2687,9,True
2016,01/17,Indianapolis,1.51,315,1240,8,283,321,0,Winter,598,1561,8,True
2016,01/10,Indianapolis,1.51,458,1268,0,646,442,0,Winter,1104,1710,0,True
2016,01/03,Indianapolis,1.53,229,1187,0,304,336,0,Winter,533,1523,0,True
2016,12/25,Jacksonville,1.27,259,79,11,1003,2084,0,Winter,1262,2163,11,True
2016,12/18,Jacksonville,1.27,257,57,2,596,2052,0,Winter,853,2109,2,True
2016,12/11,Jacksonville,1.34,346,35,4,1173,2542,0,Winter,1519,2577,4,True
2016,12/04,Jacksonville,1.35,286,33,10,836,2524,0,Winter,1122,2557,10,True
2016,11/27,Jacksonville,1.43,287,55,18,1016,1834,0,Fall,1303,1889,18,True
2016,11/20,Jacksonville,1.49,400,88,5,1536,2621,0,Fall,1936,2709,5,True
2016,11/13,Jacksonville,1.47,446,65,11,1503,2863,0,Fall,1949,2928,11,True
2016,11/06,Jacksonville,1.43,312,69,4,650,2752,0,Fall,962,2821,4,True
2016,10/30,Jacksonville,1.41,450,133,3,250,3517,0,Fall,700,3650,3,True
2016,10/23,Jacksonville,1.4,352,95,1,0,2549,0,Fall,352,2644,1,True
2016,10/16,Jacksonville,1.36,435,83,5,166,2331,0,Fall,601,2414,5,True
2016,10/09,Jacksonville,1.98,1278,60,1,180,667,0,Fall,1458,727,1,True
2016,10/02,Jacksonville,2.24,1454,92,8,390,45,0,Fall,1844,137,8,True
2016,09/25,Jacksonville,1.46,803,73,0,860,2514,0,Fall,1663,2587,0,True
2016,09/18,Jacksonville,1.36,690,77,3,713,3630,0,Fall,1403,3707,3,True
2016,09/11,Jacksonville,1.87,1225,71,3,923,390,0,Fall,2148,461,3,True
2016,09/04,Jacksonville,1.87,1152,97,0,1416,3,0,Fall,2568,100,0,True
2016,08/28,Jacksonville,1.73,750,90,5,1550,3,0,Summer,2300,93,5,True
2016,08/21,Jacksonville,2.0,1860,108,9,1370,30,0,Summer,3230,138,9,True
2016,08/14,Jacksonville,2.1,2096,184,23,1156,10,0,Summer,3252,194,23,True
2016,08/07,Jacksonville,2.01,2307,134,62,1620,16,0,Summer,3927,150,62,True
2016,07/31,Jacksonville,1.92,1943,112,37,1593,20,0,Summer,3536,132,37,True
2016,07/24,Jacksonville,2.17,2932,193,33,940,10,0,Summer,3872,203,33,True
2016,07/17,Jacksonville,2.11,2538,191,41,1023,0,0,Summer,3561,191,41,True
2016,07/10,Jacksonville,1.68,1452,79,8,2302,0,0,Summer,3754,79,8,True
2016,07/03,Jacksonville,1.26,1794,126,8,4472,0,0,Summer,6266,126,8,True
2016,06/26,Jacksonville,1.72,2437,118,25,1213,0,0,Summer,3650,118,25,True
2016,06/19,Jacksonville,1.71,2375,118,20,1233,0,0,Summer,3608,118,20,True
2016,06/12,Jacksonville,1.73,2461,117,9,1183,0,0,Summer,3644,117,9,True
2016,06/05,Jacksonville,1.64,1979,135,2,1486,0,0,Summer,3465,135,2,True
2016,05/29,Jacksonville,1.63,2183,164,9,1753,0,0,Spring,3936,164,9,True
2016,05/22,Jacksonville,1.66,2130,142,13,1576,0,0,Spring,3706,142,13,True
2016,05/15,Jacksonville,1.76,2042,140,0,896,0,0,Spring,2938,140,0,True
2016,05/08,Jacksonville,1.7,1850,155,4,1163,0,0,Spring,3013,155,4,True
2016,05/01,Jacksonville,1.65,2476,224,13,870,0,0,Spring,3346,224,13,True
2016,04/24,Jacksonville,1.64,1906,95,14,1633,0,0,Spring,3539,95,14,True
2016,04/17,Jacksonville,1.73,2174,170,7,1100,0,0,Spring,3274,170,7,True
2016,04/10,Jacksonville,1.62,1917,102,14,1343,0,0,Spring,3260,102,14,True
2016,04/03,Jacksonville,1.66,2203,123,12,1293,0,0,Spring,3496,123,12,True
2016,03/27,Jacksonville,1.73,1827,131,26,793,0,0,Spring,2620,131,26,True
2016,03/20,Jacksonville,1.58,2000,119,7,1656,0,0,Spring,3656,119,7,True
2016,03/13,Jacksonville,1.7,2038,126,9,976,0,0,Spring,3014,126,9,True
2016,03/06,Jacksonville,1.83,1984,111,17,533,3,0,Spring,2517,114,17,True
2016,02/28,Jacksonville,1.8,1675,82,20,583,0,0,Winter,2258,82,20,True
2016,02/21,Jacksonville,1.76,1793,76,6,803,0,0,Winter,2596,76,6,True
2016,02/14,Jacksonville,1.73,1696,51,13,790,0,0,Winter,2486,51,13,True
2016,02/07,Jacksonville,1.7,1370,59,12,850,0,0,Winter,2220,59,12,True
2016,01/31,Jacksonville,1.74,1724,84,10,876,0,0,Winter,2600,84,10,True
2016,01/24,Jacksonville,1.66,1638,59,9,1226,0,0,Winter,2864,59,9,True
2016,01/17,Jacksonville,1.8,1828,113,10,660,0,0,Winter,2488,113,10,True
2016,01/10,Jacksonville,1.76,1732,78,24,903,0,0,Winter,2635,78,24,True
2016,01/03,Jacksonville,1.51,4852,163,16,860,0,0,Winter,5712,163,16,True
2016,12/25,LasVegas,1.35,1090,2506,0,5810,111,0,Winter,6900,2617,0,True
2016,12/18,LasVegas,1.42,913,2218,0,4088,11,0,Winter,5001,2229,0,True
2016,12/11,LasVegas,1.76,750,2889,0,2584,32,0,Winter,3334,2921,0,True
2016,12/04,LasVegas,2.17,937,2371,0,1360,116,0,Winter,2297,2487,0,True
2016,11/27,LasVegas,1.74,838,2060,0,3634,6,0,Fall,4472,2066,0,True
2016,11/20,LasVegas,1.83,885,2371,0,3460,0,0,Fall,4345,2371,0,True
2016,11/13,LasVegas,1.51,1608,3103,0,6353,51,0,Fall,7961,3154,0,True
2016,11/06,LasVegas,1.94,1815,3164,0,1827,8,0,Fall,3642,3172,0,True
2016,10/30,LasVegas,2.76,378,2652,0,177,29,0,Fall,555,2681,0,True
2016,10/23,LasVegas,2.3,267,2457,0,264,0,0,Fall,531,2457,0,True
2016,10/16,LasVegas,2.85,707,2855,0,732,21,0,Fall,1439,2876,0,True
2016,10/09,LasVegas,2.09,1016,2518,0,2219,16,0,Fall,3235,2534,0,True
2016,10/02,LasVegas,3.03,296,2699,0,718,0,0,Fall,1014,2699,0,True
2016,09/25,LasVegas,2.91,409,2810,0,884,0,0,Fall,1293,2810,0,True
2016,09/18,LasVegas,2.04,1493,2657,0,2279,63,0,Fall,3772,2720,0,True
2016,09/11,LasVegas,2.2,2324,3252,0,613,1472,0,Fall,2937,4724,0,True
2016,09/04,LasVegas,2.02,2868,3199,0,709,2488,0,Fall,3577,5687,0,True
2016,08/28,LasVegas,2.02,2503,2823,0,411,2394,0,Summer,2914,5217,0,True
2016,08/21,LasVegas,1.99,2876,2719,0,458,2806,0,Summer,3334,5525,0,True
2016,08/14,LasVegas,2.14,2592,2647,0,455,2572,0,Summer,3047,5219,0,True
2016,08/07,LasVegas,2.16,3176,3095,0,348,2971,0,Summer,3524,6066,0,True
2016,07/31,LasVegas,2.27,2964,3659,0,420,2908,0,Summer,3384,6567,0,True
2016,07/24,LasVegas,2.3,3346,3970,0,591,2390,0,Summer,3937,6360,0,True
2016,07/17,LasVegas,2.25,3690,3871,0,766,2456,0,Summer,4456,6327,0,True
2016,07/10,LasVegas,1.9,4462,4630,0,676,3464,0,Summer,5138,8094,0,True
2016,07/03,LasVegas,1.59,5586,5478,0,438,4104,0,Summer,6024,9582,0,True
2016,06/26,LasVegas,1.56,4663,5947,0,669,2587,0,Summer,5332,8534,0,True
2016,06/19,LasVegas,1.52,5180,6593,0,563,754,0,Summer,5743,7347,0,True
2016,06/12,LasVegas,1.42,7218,5873,0,470,642,0,Summer,7688,6515,0,True
2016,06/05,LasVegas,1.41,5353,6571,0,765,1534,0,Summer,6118,8105,0,True
2016,05/29,LasVegas,1.35,3737,16569,0,695,1979,0,Spring,4432,18548,0,True
2016,05/22,LasVegas,1.38,4850,8099,0,496,4264,0,Spring,5346,12363,0,True
2016,05/15,LasVegas,1.2,6186,15446,0,433,6035,0,Spring,6619,21481,0,True
2016,05/08,LasVegas,1.31,4543,5592,0,416,3128,0,Spring,4959,8720,0,True
2016,05/01,LasVegas,1.51,4463,6588,0,786,1390,0,Spring,5249,7978,0,True
2016,04/24,LasVegas,1.36,2546,13800,0,744,2606,0,Spring,3290,16406,0,True
2016,04/17,LasVegas,1.34,2830,13556,0,347,3267,0,Spring,3177,16823,0,True
2016,04/10,LasVegas,1.22,3233,4726,0,4028,1485,0,Spring,7261,6211,0,True
2016,04/03,LasVegas,1.25,3094,4671,0,3985,674,0,Spring,7079,5345,0,True
2016,03/27,LasVegas,1.41,3062,4885,0,1906,333,0,Spring,4968,5218,0,True
2016,03/20,LasVegas,1.35,3101,4112,0,2185,63,0,Spring,5286,4175,0,True
2016,03/13,LasVegas,1.33,1955,4330,0,3192,50,0,Spring,5147,4380,0,True
2016,03/06,LasVegas,1.3,2926,3544,0,5100,286,0,Spring,8026,3830,0,True
2016,02/28,LasVegas,1.29,2077,3518,0,5374,27,0,Winter,7451,3545,0,True
2016,02/21,LasVegas,1.44,1481,3293,0,2833,628,0,Winter,4314,3921,0,True
2016,02/14,LasVegas,1.28,1481,3314,0,3443,1355,0,Winter,4924,4669,0,True
2016,02/07,LasVegas,1.41,1466,2881,0,2968,403,0,Winter,4434,3284,0,True
2016,01/31,LasVegas,1.68,1776,3076,0,1880,64,0,Winter,3656,3140,0,True
2016,01/24,LasVegas,1.47,1706,4796,0,2788,6,0,Winter,4494,4802,0,True
2016,01/17,LasVegas,1.47,2067,4156,0,2611,19,0,Winter,4678,4175,0,True
2016,01/10,LasVegas,1.41,1630,3858,0,2984,6,0,Winter,4614,3864,0,True
2016,01/03,LasVegas,1.69,1709,3384,0,2435,22,0,Winter,4144,3406,0,True
2016,12/25,LosAngeles,1.17,11324,25698,0,37064,7369,0,Winter,48388,33067,0,True
2016,12/18,LosAngeles,1.29,8328,30745,101,31983,4204,0,Winter,40311,34949,101,True
2016,12/11,LosAngeles,1.31,8725,29110,45,31526,8284,0,Winter,40251,37394,45,True
2016,12/04,LosAngeles,1.52,9917,25081,10,30856,2634,0,Winter,40773,27715,10,True
2016,11/27,LosAngeles,1.64,7949,22176,6,28969,4633,0,Fall,36918,26809,6,True
2016,11/20,LosAngeles,1.67,6503,18671,9,30815,4250,0,Fall,37318,22921,9,True
2016,11/13,LosAngeles,1.7,8552,21195,7,29706,7271,0,Fall,38258,28466,7,True
2016,11/06,LosAngeles,1.94,9018,23288,0,21367,10714,0,Fall,30385,34002,0,True
2016,10/30,LosAngeles,2.1,9327,19918,1,11425,8176,0,Fall,20752,28094,1,True
2016,10/23,LosAngeles,2.44,5614,22373,0,7620,39,0,Fall,13234,22412,0,True
2016,10/16,LosAngeles,1.85,8637,27140,0,20720,169,0,Fall,29357,27309,0,True
2016,10/09,LosAngeles,1.58,10127,23301,12,38000,632,0,Fall,48127,23933,12,True
2016,10/02,LosAngeles,1.52,10357,22863,3,37434,5455,0,Fall,47791,28318,3,True
2016,09/25,LosAngeles,1.62,7132,25173,0,25361,4487,0,Fall,32493,29660,0,True
2016,09/18,LosAngeles,1.47,13098,24958,0,31194,5195,0,Fall,44292,30153,0,True
2016,09/11,LosAngeles,1.2,14941,36981,23,56410,1397,0,Fall,71351,38378,23,True
2016,09/04,LosAngeles,1.29,13910,28437,0,62061,2434,0,Fall,75971,30871,0,True
2016,08/28,LosAngeles,1.26,14056,25916,6,63624,666,0,Summer,77680,26582,6,True
2016,08/21,LosAngeles,1.19,19567,23068,3,71174,541,0,Summer,90741,23609,3,True
2016,08/14,LosAngeles,1.2,18708,27837,28,79648,4942,0,Summer,98356,32779,28,True
2016,08/07,LosAngeles,1.14,13657,25621,0,72770,18564,0,Summer,86427,44185,0,True
2016,07/31,LosAngeles,1.21,14654,28278,1,70166,2213,0,Summer,84820,30491,1,True
2016,07/24,LosAngeles,1.21,14249,27897,20,61674,7238,0,Summer,75923,35135,20,True
2016,07/17,LosAngeles,1.23,14443,30091,3,69782,22,0,Summer,84225,30113,3,True
2016,07/10,LosAngeles,1.15,21301,27011,9,77225,142,0,Summer,98526,27153,9,True
2016,07/03,LosAngeles,1.23,16982,37943,6,59745,1619,0,Summer,76727,39562,6,True
2016,06/26,LosAngeles,1.18,23280,34516,6,54443,57,0,Summer,77723,34573,6,True
2016,06/19,LosAngeles,1.23,15800,36039,11,58189,47,0,Summer,73989,36086,11,True
2016,06/12,LosAngeles,1.15,16790,34443,0,55248,32,0,Summer,72038,34475,0,True
2016,06/05,LosAngeles,1.18,17642,26736,7,54949,382,0,Summer,72591,27118,7,True
2016,05/29,LosAngeles,1.11,14878,30381,0,66031,422,0,Spring,80909,30803,0,True
2016,05/22,LosAngeles,0.98,14507,32012,0,69453,4,0,Spring,83960,32016,0,True
2016,05/15,LosAngeles,1.14,15403,30675,0,61935,17,0,Spring,77338,30692,0,True
2016,05/08,LosAngeles,1.13,11723,34690,0,72600,109,0,Spring,84323,34799,0,True
2016,05/01,LosAngeles,1.11,9913,29545,0,62529,13,0,Spring,72442,29558,0,True
2016,04/24,LosAngeles,1.04,11729,31942,0,73262,76,0,Spring,84991,32018,0,True
2016,04/17,LosAngeles,1.01,10528,24399,0,70842,458,0,Spring,81370,24857,0,True
2016,04/10,LosAngeles,1.05,10479,31798,0,63788,2732,0,Spring,74267,34530,0,True
2016,04/03,LosAngeles,1.08,11577,45515,0,53603,7269,0,Spring,65180,52784,0,True
2016,03/27,LosAngeles,1.07,8848,30213,3,53904,11389,0,Spring,62752,41602,3,True
2016,03/20,LosAngeles,1.1,9650,29926,3,51792,5232,0,Spring,61442,35158,3,True
2016,03/13,LosAngeles,1.09,11588,37583,0,59198,8875,0,Spring,70786,46458,0,True
2016,03/06,LosAngeles,0.96,10846,27074,3,76838,381,0,Spring,87684,27455,3,True
2016,02/28,LosAngeles,0.96,10893,32404,4,84672,513,0,Winter,95565,32917,4,True
2016,02/21,LosAngeles,1.07,9483,27925,7,53008,1239,0,Winter,62491,29164,7,True
2016,02/14,LosAngeles,1.09,7138,29178,90,45117,7897,0,Winter,52255,37075,90,True
2016,02/07,LosAngeles,1.07,7720,22562,37,38739,11885,0,Winter,46459,34447,37,True
2016,01/31,LosAngeles,1.02,9874,21594,80,39705,10178,0,Winter,49579,31772,80,True
2016,01/24,LosAngeles,1.06,8070,27332,0,14074,30229,0,Winter,22144,57561,0,True
2016,01/17,LosAngeles,1.18,10218,19372,0,19708,16565,0,Winter,29926,35937,0,True
2016,01/10,LosAngeles,1.08,11524,17132,0,41151,10218,0,Winter,52675,27350,0,True
2016,01/03,LosAngeles,1.15,11697,18392,0,26300,4505,0,Winter,37997,22897,0,True
2016,12/25,Louisville,1.53,16,910,0,406,286,0,Winter,422,1196,0,True
2016,12/18,Louisville,1.23,2,928,0,433,872,0,Winter,435,1800,0,True
2016,12/11,Louisville,1.16,0,710,0,363,814,0,Winter,363,1524,0,True
2016,12/04,Louisville,1.28,4,997,0,396,993,0,Winter,400,1990,0,True
2016,11/27,Louisville,1.26,1,987,0,566,1574,0,Fall,567,2561,0,True
2016,11/20,Louisville,0.93,6,1278,0,613,2981,0,Fall,619,4259,0,True
2016,11/13,Louisville,0.94,0,1210,0,410,2938,0,Fall,410,4148,0,True
2016,11/06,Louisville,1.17,0,1735,0,343,2064,0,Fall,343,3799,0,True
2016,10/30,Louisville,1.82,1,1696,0,196,143,0,Fall,197,1839,0,True
2016,10/23,Louisville,1.03,5,1408,0,126,1882,0,Fall,131,3290,0,True
2016,10/16,Louisville,1.24,12,1256,0,170,1030,0,Fall,182,2286,0,True
2016,10/09,Louisville,1.08,0,1676,0,273,2068,0,Fall,273,3744,0,True
2016,10/02,Louisville,1.87,4,1353,0,226,26,0,Fall,230,1379,0,True
2016,09/25,Louisville,1.81,0,1385,0,263,78,0,Fall,263,1463,0,True
2016,09/18,Louisville,1.31,5,1254,0,80,854,0,Fall,85,2108,0,True
2016,09/11,Louisville,1.07,1,1380,0,310,2087,0,Fall,311,3467,0,True
2016,09/04,Louisville,1.04,1,1791,0,353,2657,0,Fall,354,4448,0,True
2016,08/28,Louisville,1.23,7,2027,0,460,1502,0,Summer,467,3529,0,True
2016,08/21,Louisville,1.53,18,2366,0,443,303,0,Summer,461,2669,0,True
2016,08/14,Louisville,1.59,0,2276,0,300,441,0,Summer,300,2717,0,True
2016,08/07,Louisville,1.32,1,1449,0,866,1296,0,Summer,867,2745,0,True
2016,07/31,Louisville,1.3,2,1677,0,676,1531,0,Summer,678,3208,0,True
2016,07/24,Louisville,1.8,2,1508,0,336,261,0,Summer,338,1769,0,True
2016,07/17,Louisville,1.26,6,1366,0,210,1335,0,Summer,216,2701,0,True
2016,07/10,Louisville,1.25,5,1700,0,166,1153,0,Summer,171,2853,0,True
2016,07/03,Louisville,1.05,0,1644,0,133,1702,0,Summer,133,3346,0,True
2016,06/26,Louisville,1.24,0,1754,0,123,1366,0,Summer,123,3120,0,True
2016,06/19,Louisville,0.85,3,2053,0,150,3532,0,Summer,153,5585,0,True
2016,06/12,Louisville,1.31,0,2215,0,160,1217,0,Summer,160,3432,0,True
2016,06/05,Louisville,1.19,0,1339,0,111,1577,0,Summer,111,2916,0,True
2016,05/29,Louisville,1.5,0,1239,0,203,530,0,Spring,203,1769,0,True
2016,05/22,Louisville,1.28,0,1117,0,190,870,0,Spring,190,1987,0,True
2016,05/15,Louisville,1.48,0,1268,0,357,851,0,Spring,357,2119,0,True
2016,05/08,Louisville,1.47,1,1161,0,115,547,0,Spring,116,1708,0,True
2016,05/01,Louisville,1.35,4,1190,0,324,870,0,Spring,328,2060,0,True
2016,04/24,Louisville,1.22,15,1609,0,339,1021,0,Spring,354,2630,0,True
2016,04/17,Louisville,1.4,0,2212,0,280,371,0,Spring,280,2583,0,True
2016,04/10,Louisville,1.41,4,1398,0,123,359,0,Spring,127,1757,0,True
2016,04/03,Louisville,1.43,4,1207,0,103,367,0,Spring,107,1574,0,True
2016,03/27,Louisville,1.32,4,1423,0,116,591,0,Spring,120,2014,0,True
2016,03/20,Louisville,1.51,0,1585,0,166,132,0,Spring,166,1717,0,True
2016,03/13,Louisville,1.08,0,1890,0,200,1601,0,Spring,200,3491,0,True
2016,03/06,Louisville,0.96,23,1555,0,70,1385,0,Spring,93,2940,0,True
2016,02/28,Louisville,1.69,15,1009,0,40,16,0,Winter,55,1025,0,True
2016,02/21,Louisville,1.64,27,646,0,53,170,0,Winter,80,816,0,True
2016,02/14,Louisville,1.72,31,831,0,16,143,0,Winter,47,974,0,True
2016,02/07,Louisville,1.59,7,890,0,83,277,0,Winter,90,1167,0,True
2016,01/31,Louisville,1.55,6,781,0,186,319,0,Winter,192,1100,0,True
2016,01/24,Louisville,1.49,24,1229,0,216,458,0,Winter,240,1687,0,True
2016,01/17,Louisville,1.85,67,1037,0,0,135,0,Winter,67,1172,0,True
2016,01/10,Louisville,1.68,44,1039,0,0,376,0,Winter,44,1415,0,True
2016,01/03,Louisville,1.74,19,858,0,6,172,0,Winter,25,1030,0,True
2016,12/25,MiamiFtLauderdale,1.17,18,24,0,3286,0,0,Winter,3304,24,0,True
2016,12/18,MiamiFtLauderdale,1.17,3,16,0,4146,0,0,Winter,4149,16,0,True
2016,12/11,MiamiFtLauderdale,1.37,13,28,0,3430,0,0,Winter,3443,28,0,True
2016,12/04,MiamiFtLauderdale,1.52,2,16,0,4010,0,0,Winter,4012,16,0,True
2016,11/27,MiamiFtLauderdale,1.6,15,2,0,2036,30,0,Fall,2051,32,0,True
2016,11/20,MiamiFtLauderdale,1.6,6,17,0,2113,20,0,Fall,2119,37,0,True
2016,11/13,MiamiFtLauderdale,1.55,6,13,0,3800,26,0,Fall,3806,39,0,True
2016,11/06,MiamiFtLauderdale,1.64,10,29,0,3243,13,0,Fall,3253,42,0,True
2016,10/30,MiamiFtLauderdale,1.58,8,47,0,330,0,0,Fall,338,47,0,True
2016,10/23,MiamiFtLauderdale,1.58,8,81,0,450,3,0,Fall,458,84,0,True
2016,10/16,MiamiFtLauderdale,1.52,9,40,0,941,0,0,Fall,950,40,0,True
2016,10/09,MiamiFtLauderdale,1.45,8,35,0,1566,3,0,Fall,1574,38,0,True
2016,10/02,MiamiFtLauderdale,1.49,10,18,0,440,3,0,Fall,450,21,0,True
2016,09/25,MiamiFtLauderdale,1.43,16,20,0,987,16,0,Fall,1003,36,0,True
2016,09/18,MiamiFtLauderdale,1.36,40,14,0,3533,43,0,Fall,3573,57,0,True
2016,09/11,MiamiFtLauderdale,1.36,52,25,0,3893,23,0,Fall,3945,48,0,True
2016,09/04,MiamiFtLauderdale,1.36,59,49,0,5986,53,0,Fall,6045,102,0,True
2016,08/28,MiamiFtLauderdale,1.36,37,38,0,3496,30,0,Summer,3533,68,0,True
2016,08/21,MiamiFtLauderdale,1.34,38,22,0,5260,60,0,Summer,5298,82,0,True
2016,08/14,MiamiFtLauderdale,1.34,4,42,0,6613,60,0,Summer,6617,102,0,True
2016,08/07,MiamiFtLauderdale,1.33,13,3,0,3433,63,0,Summer,3446,66,0,True
2016,07/31,MiamiFtLauderdale,1.22,2,22,0,4260,76,0,Summer,4262,98,0,True
2016,07/24,MiamiFtLauderdale,1.19,1,11,0,5980,26,0,Summer,5981,37,0,True
2016,07/17,MiamiFtLauderdale,1.33,495,39,0,4153,26,0,Summer,4648,65,0,True
2016,07/10,MiamiFtLauderdale,1.49,1223,28,0,3616,50,0,Summer,4839,78,0,True
2016,07/03,MiamiFtLauderdale,1.24,1109,55,0,5321,40,0,Summer,6430,95,0,True
2016,06/26,MiamiFtLauderdale,1.39,1526,62,0,3226,20,0,Summer,4752,82,0,True
2016,06/19,MiamiFtLauderdale,1.29,977,48,0,4144,10,0,Summer,5121,58,0,True
2016,06/12,MiamiFtLauderdale,1.3,948,25,0,3536,13,0,Summer,4484,38,0,True
2016,06/05,MiamiFtLauderdale,1.29,952,6,0,3880,20,0,Summer,4832,26,0,True
2016,05/29,MiamiFtLauderdale,1.27,851,16,0,5043,20,0,Spring,5894,36,0,True
2016,05/22,MiamiFtLauderdale,1.4,843,33,0,4486,3,0,Spring,5329,36,0,True
2016,05/15,MiamiFtLauderdale,1.42,757,34,0,5548,6,0,Spring,6305,40,0,True
2016,05/08,MiamiFtLauderdale,1.48,932,14,0,3363,6,0,Spring,4295,20,0,True
2016,05/01,MiamiFtLauderdale,1.43,667,6,0,3430,3,0,Spring,4097,9,0,True
2016,04/24,MiamiFtLauderdale,1.39,1393,52,0,5048,3,0,Spring,6441,55,0,True
2016,04/17,MiamiFtLauderdale,1.57,1072,11,0,1464,0,0,Spring,2536,11,0,True
2016,04/10,MiamiFtLauderdale,1.33,1229,6,0,2939,3,0,Spring,4168,9,0,True
2016,04/03,MiamiFtLauderdale,1.32,1191,18,0,2923,3,0,Spring,4114,21,0,True
2016,03/27,MiamiFtLauderdale,1.33,1196,7,0,2777,0,0,Spring,3973,7,0,True
2016,03/20,MiamiFtLauderdale,1.33,1044,11,0,2390,0,0,Spring,3434,11,0,True
2016,03/13,MiamiFtLauderdale,1.3,935,9,0,2726,6,0,Spring,3661,15,0,True
2016,03/06,MiamiFtLauderdale,1.49,980,7,0,1401,13,0,Spring,2381,20,0,True
2016,02/28,MiamiFtLauderdale,1.51,845,11,0,1305,36,0,Winter,2150,47,0,True
2016,02/21,MiamiFtLauderdale,1.4,726,2,0,2042,3,0,Winter,2768,5,0,True
2016,02/14,MiamiFtLauderdale,1.45,1074,5,0,2253,3,0,Winter,3327,8,0,True
2016,02/07,MiamiFtLauderdale,1.44,950,11,0,2186,3,0,Winter,3136,14,0,True
2016,01/31,MiamiFtLauderdale,1.54,804,0,0,1040,0,0,Winter,1844,0,0,True
2016,01/24,MiamiFtLauderdale,1.42,843,9,0,2167,0,0,Winter,3010,9,0,True
2016,01/17,MiamiFtLauderdale,1.49,903,6,0,1613,5,0,Winter,2516,11,0,True
2016,01/10,MiamiFtLauderdale,1.52,2068,32,0,1341,1222,0,Winter,3409,1254,0,True
2016,01/03,MiamiFtLauderdale,1.24,7202,76,0,4887,3045,0,Winter,12089,3121,0,True
2016,12/25,Nashville,1.5,173,2567,0,31,451,0,Winter,204,3018,0,True
2016,12/18,Nashville,1.05,209,2077,0,27,2220,0,Winter,236,4297,0,True
2016,12/11,Nashville,1.02,224,2060,0,73,2681,0,Winter,297,4741,0,True
2016,12/04,Nashville,0.83,242,2547,0,77,5634,0,Winter,319,8181,0,True
2016,11/27,Nashville,1.44,259,2894,0,198,2472,0,Fall,457,5366,0,True
2016,11/20,Nashville,0.8,244,3494,0,1253,9855,0,Fall,1497,13349,0,True
2016,11/13,Nashville,0.98,349,3637,0,767,7109,0,Fall,1116,10746,0,True
2016,11/06,Nashville,0.88,391,5050,0,35,9067,0,Fall,426,14117,0,True
2016,10/30,Nashville,1.68,294,5438,0,38,521,0,Fall,332,5959,0,True
2016,10/23,Nashville,0.82,282,3978,0,58,8899,0,Fall,340,12877,0,True
2016,10/16,Nashville,1.05,386,3596,0,58,3965,0,Fall,444,7561,0,True
2016,10/09,Nashville,0.68,494,3792,0,108,12243,0,Fall,602,16035,0,True
2016,10/02,Nashville,1.74,546,3826,0,31,231,0,Fall,577,4057,0,True
2016,09/25,Nashville,1.72,501,3532,0,33,344,0,Fall,534,3876,0,True
2016,09/18,Nashville,1.5,477,3478,0,1242,1110,0,Fall,1719,4588,0,True
2016,09/11,Nashville,0.93,553,3278,0,2812,8142,0,Fall,3365,11420,0,True
2016,09/04,Nashville,0.93,534,4442,0,2177,8954,0,Fall,2711,13396,0,True
2016,08/28,Nashville,1.3,474,4139,0,2013,2853,0,Summer,2487,6992,0,True
2016,08/21,Nashville,1.48,643,4627,0,2242,1810,0,Summer,2885,6437,0,True
2016,08/14,Nashville,1.48,899,4522,0,2277,2278,0,Summer,3176,6800,0,True
2016,08/07,Nashville,1.19,777,5234,0,1804,5869,0,Summer,2581,11103,0,True
2016,07/31,Nashville,1.11,1053,4460,0,881,5941,0,Summer,1934,10401,0,True
2016,07/24,Nashville,1.77,958,4955,0,51,1196,0,Summer,1009,6151,0,True
2016,07/17,Nashville,1.2,891,4624,0,350,5668,0,Summer,1241,10292,0,True
2016,07/10,Nashville,1.35,728,5646,0,137,3500,0,Summer,865,9146,0,True
2016,07/03,Nashville,0.89,615,5239,0,431,9319,0,Summer,1046,14558,0,True
2016,06/26,Nashville,1.18,698,4749,0,82,4254,0,Summer,780,9003,0,True
2016,06/19,Nashville,0.86,729,4863,0,648,8126,0,Summer,1377,12989,0,True
2016,06/12,Nashville,1.31,832,5730,0,2030,2835,0,Summer,2862,8565,0,True
2016,06/05,Nashville,1.08,740,4637,0,2111,5644,0,Summer,2851,10281,0,True
2016,05/29,Nashville,1.16,845,5055,0,1665,4043,0,Spring,2510,9098,0,True
2016,05/22,Nashville,1.16,1043,4484,0,1970,4236,0,Spring,3013,8720,0,True
2016,05/15,Nashville,1.26,734,5261,0,2141,6063,0,Spring,2875,11324,0,True
2016,05/08,Nashville,0.94,812,4914,0,1743,8579,0,Spring,2555,13493,0,True
2016,05/01,Nashville,1.45,715,4309,0,1476,2046,0,Spring,2191,6355,0,True
2016,04/24,Nashville,1.18,895,4774,0,1964,4137,0,Spring,2859,8911,0,True
2016,04/17,Nashville,0.86,912,14896,0,1533,10898,0,Spring,2445,25794,0,True
2016,04/10,Nashville,0.85,873,16913,0,3908,8753,0,Spring,4781,25666,0,True
2016,04/03,Nashville,1.59,1157,4117,0,303,1103,0,Spring,1460,5220,0,True
2016,03/27,Nashville,1.46,795,4082,0,1350,1685,0,Spring,2145,5767,0,True
2016,03/20,Nashville,1.53,821,3668,0,1823,613,0,Spring,2644,4281,0,True
2016,03/13,Nashville,1.32,705,7430,0,2220,2463,0,Spring,2925,9893,0,True
2016,03/06,Nashville,1.32,840,7515,0,1416,2177,0,Spring,2256,9692,0,True
2016,02/28,Nashville,1.53,645,3099,0,1530,13,0,Winter,2175,3112,0,True
2016,02/21,Nashville,1.49,753,2433,0,1363,307,0,Winter,2116,2740,0,True
2016,02/14,Nashville,1.42,593,2791,0,1606,599,0,Winter,2199,3390,0,True
2016,02/07,Nashville,1.4,579,2809,0,1650,767,0,Winter,2229,3576,0,True
2016,01/31,Nashville,1.39,750,2879,0,973,1164,0,Winter,1723,4043,0,True
2016,01/24,Nashville,1.37,572,3389,0,1536,1055,0,Winter,2108,4444,0,True
2016,01/17,Nashville,1.51,699,3333,0,1190,527,0,Winter,1889,3860,0,True
2016,01/10,Nashville,1.53,684,2558,0,594,909,0,Winter,1278,3467,0,True
2016,01/03,Nashville,1.42,939,2479,0,1508,814,0,Winter,2447,3293,0,True
2016,12/25,NewOrleansMobile,1.41,82,23,0,3050,762,0,Winter,3132,785,0,True
2016,12/18,NewOrleansMobile,1.43,77,0,0,1755,727,0,Winter,1832,727,0,True
2016,12/11,NewOrleansMobile,1.51,104,5,0,1660,745,0,Winter,1764,750,0,True
2016,12/04,NewOrleansMobile,1.55,102,5,0,2061,775,0,Winter,2163,780,0,True
2016,11/27,NewOrleansMobile,1.48,104,0,0,1277,1043,0,Fall,1381,1043,0,True
2016,11/20,NewOrleansMobile,1.55,73,0,0,2620,1019,0,Fall,2693,1019,0,True
2016,11/13,NewOrleansMobile,1.51,99,0,0,3940,997,0,Fall,4039,997,0,True
2016,11/06,NewOrleansMobile,1.66,118,11,0,2595,1243,0,Fall,2713,1254,0,True
2016,10/30,NewOrleansMobile,1.59,166,0,0,2030,1452,0,Fall,2196,1452,0,True
2016,10/23,NewOrleansMobile,1.51,32,0,0,1339,929,0,Fall,1371,929,0,True
2016,10/16,NewOrleansMobile,1.68,302,17,0,2056,509,0,Fall,2358,526,0,True
2016,10/09,NewOrleansMobile,1.91,311,2,0,659,20,0,Fall,970,22,0,True
2016,10/02,NewOrleansMobile,1.72,144,0,0,1071,46,0,Fall,1215,46,0,True
2016,09/25,NewOrleansMobile,1.5,147,0,0,2107,1126,0,Fall,2254,1126,0,True
2016,09/18,NewOrleansMobile,1.4,191,0,0,1481,1416,0,Fall,1672,1416,0,True
2016,09/11,NewOrleansMobile,1.42,169,26,0,3481,26,0,Fall,3650,52,0,True
2016,09/04,NewOrleansMobile,1.52,257,23,0,3883,43,0,Fall,4140,66,0,True
2016,08/28,NewOrleansMobile,1.49,184,0,0,3515,43,0,Summer,3699,43,0,True
2016,08/21,NewOrleansMobile,1.56,394,5,0,3140,63,0,Summer,3534,68,0,True
2016,08/14,NewOrleansMobile,1.55,610,0,0,4436,150,0,Summer,5046,150,0,True
2016,08/07,NewOrleansMobile,1.55,682,0,0,4159,126,0,Summer,4841,126,0,True
2016,07/31,NewOrleansMobile,1.41,553,5,0,4514,113,0,Summer,5067,118,0,True
2016,07/24,NewOrleansMobile,1.41,588,0,0,3458,60,0,Summer,4046,60,0,True
2016,07/17,NewOrleansMobile,1.34,686,0,0,4437,66,0,Summer,5123,66,0,True
2016,07/10,NewOrleansMobile,1.3,554,0,0,3677,26,0,Summer,4231,26,0,True
2016,07/03,NewOrleansMobile,1.18,421,11,0,2830,26,0,Summer,3251,37,0,True
2016,06/26,NewOrleansMobile,1.3,700,0,0,4118,23,0,Summer,4818,23,0,True
2016,06/19,NewOrleansMobile,1.25,507,5,0,4093,16,0,Summer,4600,21,0,True
2016,06/12,NewOrleansMobile,1.73,882,0,0,423,20,0,Summer,1305,20,0,True
2016,06/05,NewOrleansMobile,1.68,737,0,0,641,10,0,Summer,1378,10,0,True
2016,05/29,NewOrleansMobile,1.8,693,0,0,338,3,0,Spring,1031,3,0,True
2016,05/22,NewOrleansMobile,1.58,564,5,0,1007,3,0,Spring,1571,8,0,True
2016,05/15,NewOrleansMobile,1.44,442,0,0,2616,16,0,Spring,3058,16,0,True
2016,05/08,NewOrleansMobile,1.47,950,14,0,3856,6,0,Spring,4806,20,0,True
2016,05/01,NewOrleansMobile,1.44,824,29,0,4391,16,0,Spring,5215,45,0,True
2016,04/24,NewOrleansMobile,1.44,662,20,0,3772,6,0,Spring,4434,26,0,True
2016,04/17,NewOrleansMobile,1.45,655,8,0,3221,0,0,Spring,3876,8,0,True
2016,04/10,NewOrleansMobile,1.27,622,20,0,3365,0,0,Spring,3987,20,0,True
2016,04/03,NewOrleansMobile,1.31,633,5,0,2500,0,0,Spring,3133,5,0,True
2016,03/27,NewOrleansMobile,1.26,516,9,0,2943,0,0,Spring,3459,9,0,True
2016,03/20,NewOrleansMobile,1.26,648,3,0,2901,0,0,Spring,3549,3,0,True
2016,03/13,NewOrleansMobile,1.27,617,24,0,3619,0,0,Spring,4236,24,0,True
2016,03/06,NewOrleansMobile,1.37,493,6,0,2112,0,0,Spring,2605,6,0,True
2016,02/28,NewOrleansMobile,1.44,580,3,0,2224,0,0,Winter,2804,3,0,True
2016,02/21,NewOrleansMobile,1.54,636,0,0,1864,0,0,Winter,2500,0,0,True
2016,02/14,NewOrleansMobile,1.46,549,0,0,2863,3,0,Winter,3412,3,0,True
2016,02/07,NewOrleansMobile,1.41,305,0,0,2367,0,0,Winter,2672,0,0,True
2016,01/31,NewOrleansMobile,1.43,623,18,0,2569,0,0,Winter,3192,18,0,True
2016,01/24,NewOrleansMobile,1.34,502,0,0,3400,0,0,Winter,3902,0,0,True
2016,01/17,NewOrleansMobile,1.48,679,8,0,2491,0,0,Winter,3170,8,0,True
2016,01/10,NewOrleansMobile,1.52,407,5,0,2360,0,0,Winter,2767,5,0,True
2016,01/03,NewOrleansMobile,1.52,755,2,0,2147,0,0,Winter,2902,2,0,True
2016,12/25,NewYork,2.17,5592,15901,772,14698,473,0,Winter,20290,16374,772,True
2016,12/18,NewYork,1.99,11645,22852,190,16086,554,0,Winter,27731,23406,190,True
2016,12/11,NewYork,2.22,4690,13912,529,13521,4,0,Winter,18211,13916,529,True
2016,12/04,NewYork,2.04,9061,24011,482,11823,4,0,Winter,20884,24015,482,True
2016,11/27,NewYork,2.38,4165,14257,238,10376,80,0,Fall,14541,14337,238,True
2016,11/20,NewYork,2.04,8938,28672,195,10325,232,0,Fall,19263,28904,195,True
2016,11/13,NewYork,2.65,3701,19604,96,4922,81,0,Fall,8623,19685,96,True
2016,11/06,NewYork,2.46,3242,19599,138,2220,45,0,Fall,5462,19644,138,True
2016,10/30,NewYork,2.25,5223,18866,57,777,525,0,Fall,6000,19391,57,True
2016,10/23,NewYork,2.1,1932,4815,33,1661,0,0,Fall,3593,4815,33,True
2016,10/16,NewYork,2.33,3985,11359,88,1942,461,0,Fall,5927,11820,88,True
2016,10/09,NewYork,2.3,4174,11904,791,9213,379,0,Fall,13387,12283,791,True
2016,10/02,NewYork,2.41,3506,11530,1515,18656,332,0,Fall,22162,11862,1515,True
2016,09/25,NewYork,2.34,3786,10296,600,16887,145,0,Fall,20673,10441,600,True
2016,09/18,NewYork,2.36,4207,13327,1497,26583,85,0,Fall,30790,13412,1497,True
2016,09/11,NewYork,2.06,9238,31314,492,28384,689,0,Fall,37622,32003,492,True
2016,09/04,NewYork,2.15,5169,18565,545,20924,0,0,Fall,26093,18565,545,True
2016,08/28,NewYork,2.32,3097,12760,1275,2179,62,0,Summer,5276,12822,1275,True
2016,08/21,NewYork,2.16,5398,16529,1352,6945,358,0,Summer,12343,16887,1352,True
2016,08/14,NewYork,2.27,5199,15226,1468,3059,355,0,Summer,8258,15581,1468,True
2016,08/07,NewYork,2.37,4520,16430,1881,4249,73,0,Summer,8769,16503,1881,True
2016,07/31,NewYork,2.41,3526,14455,1723,4337,4,0,Summer,7863,14459,1723,True
2016,07/24,NewYork,2.32,3376,15393,2405,7608,515,0,Summer,10984,15908,2405,True
2016,07/17,NewYork,2.4,4034,16488,2929,31257,897,0,Summer,35291,17385,2929,True
2016,07/10,NewYork,2.33,4834,19429,2346,23056,632,0,Summer,27890,20061,2346,True
2016,07/03,NewYork,2.28,4225,20280,1935,19365,507,0,Summer,23590,20787,1935,True
2016,06/26,NewYork,2.23,3521,14622,389,18563,1549,0,Summer,22084,16171,389,True
2016,06/19,NewYork,2.26,3233,14646,174,18633,714,0,Summer,21866,15360,174,True
2016,06/12,NewYork,1.94,3909,14358,177,9034,1278,0,Summer,12943,15636,177,True
2016,06/05,NewYork,2.15,2285,11252,322,16812,1134,0,Summer,19097,12386,322,True
2016,05/29,NewYork,2.15,4303,13793,2706,11496,2205,0,Spring,15799,15998,2706,True
2016,05/22,NewYork,2.01,5435,21065,2695,15280,318,0,Spring,20715,21383,2695,True
2016,05/15,NewYork,2.02,4328,15961,2631,11026,840,0,Spring,15354,16801,2631,True
2016,05/08,NewYork,2.0,3876,11969,2361,20040,1391,0,Spring,23916,13360,2361,True
2016,05/01,NewYork,2.16,5556,17185,2672,27008,2054,0,Spring,32564,19239,2672,True
2016,04/24,NewYork,2.11,4483,15498,2803,27093,456,0,Spring,31576,15954,2803,True
2016,04/17,NewYork,1.98,4725,18018,2509,13176,1851,0,Spring,17901,19869,2509,True
2016,04/10,NewYork,2.2,3080,11181,2403,12723,1072,0,Spring,15803,12253,2403,True
2016,04/03,NewYork,2.08,5327,16420,2448,21876,1235,0,Spring,27203,17655,2448,True
2016,03/27,NewYork,2.12,2964,12312,2498,17606,526,0,Spring,20570,12838,2498,True
2016,03/20,NewYork,1.92,5059,14570,2250,9224,810,0,Spring,14283,15380,2250,True
2016,03/13,NewYork,1.96,7270,12040,2080,10528,1490,0,Spring,17798,13530,2080,True
2016,03/06,NewYork,1.86,8104,16993,2071,9996,4381,0,Spring,18100,21374,2071,True
2016,02/28,NewYork,1.96,4923,13005,1706,9947,3026,0,Winter,14870,16031,1706,True
2016,02/21,NewYork,1.9,5043,10101,1489,5209,4387,0,Winter,10252,14488,1489,True
2016,02/14,NewYork,2.11,4689,9473,1200,10463,2463,0,Winter,15152,11936,1200,True
2016,02/07,NewYork,1.95,4811,9963,1515,8387,5804,0,Winter,13198,15767,1515,True
2016,01/31,NewYork,1.83,2126,7493,1235,3842,10051,0,Winter,5968,17544,1235,True
2016,01/24,NewYork,2.09,2289,9484,2221,7033,7092,0,Winter,9322,16576,2221,True
2016,01/17,NewYork,1.93,4864,8524,1706,1491,3889,0,Winter,6355,12413,1706,True
2016,01/10,NewYork,1.54,3897,11770,1689,401,16870,0,Winter,4298,28640,1689,True
2016,01/03,NewYork,1.61,1302,4127,1756,869,13016,0,Winter,2171,17143,1756,True
2016,12/25,NorthernNewEngland,1.9,9,301,0,10657,0,0,Winter,10666,301,0,True
2016,12/18,NorthernNewEngland,1.95,6,215,0,7228,0,0,Winter,7234,215,0,True
2016,12/11,NorthernNewEngland,1.85,6,172,0,10347,0,0,Winter,10353,172,0,True
2016,12/04,NorthernNewEngland,1.96,15,159,0,8566,0,0,Winter,8581,159,0,True
2016,11/27,NorthernNewEngland,1.84,46,226,0,8451,0,0,Fall,8497,226,0,True
2016,11/20,NorthernNewEngland,1.81,20,244,0,9274,0,0,Fall,9294,244,0,True
2016,11/13,NorthernNewEngland,1.79,3,231,0,10490,0,0,Fall,10493,231,0,True
2016,11/06,NorthernNewEngland,1.84,6,335,0,12233,0,0,Fall,12239,335,0,True
2016,10/30,NorthernNewEngland,1.65,1,180,0,7223,0,0,Fall,7224,180,0,True
2016,10/23,NorthernNewEngland,1.75,0,153,0,11170,0,0,Fall,11170,153,0,True
2016,10/16,NorthernNewEngland,1.49,3,202,0,8758,0,0,Fall,8761,202,0,True
2016,10/09,NorthernNewEngland,1.56,0,123,0,10166,0,0,Fall,10166,123,0,True
2016,10/02,NorthernNewEngland,1.58,0,173,0,12227,0,0,Fall,12227,173,0,True
2016,09/25,NorthernNewEngland,1.51,2,320,0,14077,0,0,Fall,14079,320,0,True
2016,09/18,NorthernNewEngland,1.66,0,227,0,11608,0,0,Fall,11608,227,0,True
2016,09/11,NorthernNewEngland,1.65,6,270,0,17284,0,0,Fall,17290,270,0,True
2016,09/04,NorthernNewEngland,1.58,1,231,0,12807,0,0,Fall,12808,231,0,True
2016,08/28,NorthernNewEngland,1.51,1,235,0,8629,0,0,Summer,8630,235,0,True
2016,08/21,NorthernNewEngland,1.43,2,240,0,11583,0,0,Summer,11585,240,0,True
2016,08/14,NorthernNewEngland,1.4,1,310,0,8207,0,0,Summer,8208,310,0,True
2016,08/07,NorthernNewEngland,1.28,1,245,0,5438,0,0,Summer,5439,245,0,True
2016,07/31,NorthernNewEngland,1.1,0,214,0,4631,0,0,Summer,4631,214,0,True
2016,07/24,NorthernNewEngland,1.13,0,287,0,5589,5,0,Summer,5589,292,0,True
2016,07/17,NorthernNewEngland,1.47,0,199,0,12321,0,0,Summer,12321,199,0,True
2016,07/10,NorthernNewEngland,1.45,5,145,0,14332,0,0,Summer,14337,145,0,True
2016,07/03,NorthernNewEngland,1.33,1,335,0,28794,0,0,Summer,28795,335,0,True
2016,06/26,NorthernNewEngland,1.46,1,149,0,12321,0,0,Summer,12322,149,0,True
2016,06/19,NorthernNewEngland,1.42,3,144,0,10699,0,0,Summer,10702,144,0,True
2016,06/12,NorthernNewEngland,0.99,0,105,0,4468,0,0,Summer,4468,105,0,True
2016,06/05,NorthernNewEngland,1.04,0,184,0,4945,0,0,Summer,4945,184,0,True
2016,05/29,NorthernNewEngland,1.19,2,353,0,4545,0,0,Spring,4547,353,0,True
2016,05/22,NorthernNewEngland,1.26,3,249,0,7391,0,0,Spring,7394,249,0,True
2016,05/15,NorthernNewEngland,1.22,0,220,0,5557,0,0,Spring,5557,220,0,True
2016,05/08,NorthernNewEngland,1.63,0,298,0,11502,0,0,Spring,11502,298,0,True
2016,05/01,NorthernNewEngland,1.62,0,128,0,11498,0,0,Spring,11498,128,0,True
2016,04/24,NorthernNewEngland,1.69,1,356,0,12868,0,0,Spring,12869,356,0,True
2016,04/17,NorthernNewEngland,1.6,0,263,0,12078,0,0,Spring,12078,263,0,True
2016,04/10,NorthernNewEngland,1.5,3,276,0,13344,0,0,Spring,13347,276,0,True
2016,04/03,NorthernNewEngland,1.61,0,215,0,7960,0,0,Spring,7960,215,0,True
2016,03/27,NorthernNewEngland,1.61,11,307,0,12536,0,0,Spring,12547,307,0,True
2016,03/20,NorthernNewEngland,1.67,5,423,0,10908,0,0,Spring,10913,423,0,True
2016,03/13,NorthernNewEngland,1.63,5,222,0,10758,0,0,Spring,10763,222,0,True
2016,03/06,NorthernNewEngland,1.68,8,442,0,9732,0,0,Spring,9740,442,0,True
2016,02/28,NorthernNewEngland,1.64,1,357,0,9558,3,0,Winter,9559,360,0,True
2016,02/21,NorthernNewEngland,1.64,1,174,0,9051,0,0,Winter,9052,174,0,True
2016,02/14,NorthernNewEngland,1.66,5,169,0,9984,0,0,Winter,9989,169,0,True
2016,02/07,NorthernNewEngland,1.67,6,200,0,9583,0,0,Winter,9589,200,0,True
2016,01/31,NorthernNewEngland,1.65,2,154,0,8984,0,0,Winter,8986,154,0,True
2016,01/24,NorthernNewEngland,1.67,12,210,0,10991,0,0,Winter,11003,210,0,True
2016,01/17,NorthernNewEngland,1.55,6,248,0,10204,0,0,Winter,10210,248,0,True
2016,01/10,NorthernNewEngland,1.66,15,246,0,10259,3,0,Winter,10274,249,0,True
2016,01/03,NorthernNewEngland,1.63,13,248,0,8674,0,0,Winter,8687,248,0,True
2016,12/25,Orlando,1.27,475,37,0,2863,2225,0,Winter,3338,2262,0,True
2016,12/18,Orlando,1.26,457,50,0,3026,2136,0,Winter,3483,2186,0,True
2016,12/11,Orlando,1.4,519,32,0,2820,2487,0,Winter,3339,2519,0,True
2016,12/04,Orlando,1.46,529,41,0,2106,2643,0,Winter,2635,2684,0,True
2016,11/27,Orlando,1.47,470,40,0,1926,2105,0,Fall,2396,2145,0,True
2016,11/20,Orlando,1.53,603,44,0,2076,2757,0,Fall,2679,2801,0,True
2016,11/13,Orlando,1.53,691,47,0,3136,2916,0,Fall,3827,2963,0,True
2016,11/06,Orlando,1.56,850,90,0,1776,3359,0,Fall,2626,3449,0,True
2016,10/30,Orlando,1.56,692,201,0,303,2561,0,Fall,995,2762,0,True
2016,10/23,Orlando,1.5,740,53,0,10,3220,0,Fall,750,3273,0,True
2016,10/16,Orlando,1.44,478,51,0,533,1867,0,Fall,1011,1918,0,True
2016,10/09,Orlando,2.0,1877,136,0,686,681,0,Fall,2563,817,0,True
2016,10/02,Orlando,2.3,2847,212,0,706,5,0,Fall,3553,217,0,True
2016,09/25,Orlando,2.03,2263,179,0,1010,531,0,Fall,3273,710,0,True
2016,09/18,Orlando,1.4,1163,72,0,2156,4440,0,Fall,3319,4512,0,True
2016,09/11,Orlando,1.47,1321,108,0,2990,3145,0,Fall,4311,3253,0,True
2016,09/04,Orlando,1.85,2496,245,0,3500,23,0,Fall,5996,268,0,True
2016,08/28,Orlando,1.8,2353,141,0,3756,43,0,Summer,6109,184,0,True
2016,08/21,Orlando,1.85,2642,176,0,3503,36,0,Summer,6145,212,0,True
2016,08/14,Orlando,1.88,3004,159,0,3530,43,0,Summer,6534,202,0,True
2016,08/07,Orlando,1.9,3067,186,0,3453,33,0,Summer,6520,219,0,True
2016,07/31,Orlando,1.84,3289,134,0,3543,46,0,Summer,6832,180,0,True
2016,07/24,Orlando,1.81,3787,211,0,4380,33,0,Summer,8167,244,0,True
2016,07/17,Orlando,1.9,3281,175,0,2875,13,0,Summer,6156,188,0,True
2016,07/10,Orlando,1.53,2719,221,0,6941,30,0,Summer,9660,251,0,True
2016,07/03,Orlando,1.32,2606,228,0,6170,23,0,Summer,8776,251,0,True
2016,06/26,Orlando,1.64,3803,275,0,2863,13,0,Summer,6666,288,0,True
2016,06/19,Orlando,1.51,2669,340,0,3703,13,0,Summer,6372,353,0,True
2016,06/12,Orlando,1.58,3022,154,0,2880,26,0,Summer,5902,180,0,True
2016,06/05,Orlando,1.51,2654,135,0,3570,16,0,Summer,6224,151,0,True
2016,05/29,Orlando,1.47,2743,98,0,4433,3,0,Spring,7176,101,0,True
2016,05/22,Orlando,1.59,2685,132,0,3824,0,0,Spring,6509,132,0,True
2016,05/15,Orlando,1.64,2354,122,0,2941,0,0,Spring,5295,122,0,True
2016,05/08,Orlando,1.68,2770,153,0,2674,0,0,Spring,5444,153,0,True
2016,05/01,Orlando,1.6,2123,145,0,3431,0,0,Spring,5554,145,0,True
2016,04/24,Orlando,1.61,2375,98,0,3540,0,0,Spring,5915,98,0,True
2016,04/17,Orlando,1.64,2538,159,0,2905,0,0,Spring,5443,159,0,True
2016,04/10,Orlando,1.51,2427,124,0,2638,0,0,Spring,5065,124,0,True
2016,04/03,Orlando,1.56,2988,132,0,2634,0,0,Spring,5622,132,0,True
2016,03/27,Orlando,1.6,2980,110,0,2206,0,0,Spring,5186,110,0,True
2016,03/20,Orlando,1.57,2282,101,0,1972,0,0,Spring,4254,101,0,True
2016,03/13,Orlando,1.52,2735,99,0,2816,0,0,Spring,5551,99,0,True
2016,03/06,Orlando,1.74,2526,84,0,1167,10,0,Spring,3693,94,0,True
2016,02/28,Orlando,1.78,2916,110,0,1110,6,0,Winter,4026,116,0,True
2016,02/21,Orlando,1.67,2172,61,0,1487,3,0,Winter,3659,64,0,True
2016,02/14,Orlando,1.69,2474,47,0,1557,0,0,Winter,4031,47,0,True
2016,02/07,Orlando,1.7,2384,72,0,1430,0,0,Winter,3814,72,0,True
2016,01/31,Orlando,1.76,2811,67,0,1173,6,0,Winter,3984,73,0,True
2016,01/24,Orlando,1.59,2300,57,0,2410,0,0,Winter,4710,57,0,True
2016,01/17,Orlando,1.77,2447,72,0,966,3,0,Winter,3413,75,0,True
2016,01/10,Orlando,1.75,2417,59,0,1363,16,0,Winter,3780,75,0,True
2016,01/03,Orlando,1.33,5709,99,0,1436,2142,0,Winter,7145,2241,0,True
2016,12/25,Philadelphia,1.9,981,3177,14,7053,148,0,Winter,8034,3325,14,True
2016,12/18,Philadelphia,1.87,1455,4382,0,4794,179,0,Winter,6249,4561,0,True
2016,12/11,Philadelphia,2.04,565,2881,2,5214,0,0,Winter,5779,2881,2,True
2016,12/04,Philadelphia,2.01,1178,5084,3,4119,0,0,Winter,5297,5084,3,True
2016,11/27,Philadelphia,2.18,704,3572,8,3509,100,0,Fall,4213,3672,8,True
2016,11/20,Philadelphia,1.9,1865,4781,14,4760,199,0,Fall,6625,4980,14,True
2016,11/13,Philadelphia,2.45,930,3349,3,1991,11,0,Fall,2921,3360,3,True
2016,11/06,Philadelphia,2.32,869,2632,0,4214,19,0,Fall,5083,2651,0,True
2016,10/30,Philadelphia,2.39,1020,3824,0,1633,53,0,Fall,2653,3877,0,True
2016,10/23,Philadelphia,2.06,677,2325,0,1554,22,0,Fall,2231,2347,0,True
2016,10/16,Philadelphia,2.26,824,2624,0,2717,110,0,Fall,3541,2734,0,True
2016,10/09,Philadelphia,2.17,868,2914,4,2785,128,0,Fall,3653,3042,4,True
2016,10/02,Philadelphia,2.23,854,2658,0,3228,124,0,Fall,4082,2782,0,True
2016,09/25,Philadelphia,2.24,781,3274,19,5418,26,0,Fall,6199,3300,19,True
2016,09/18,Philadelphia,2.18,765,2809,0,8856,104,0,Fall,9621,2913,0,True
2016,09/11,Philadelphia,2.08,1346,4722,8,9244,81,0,Fall,10590,4803,8,True
2016,09/04,Philadelphia,2.04,1240,4534,39,6312,0,0,Fall,7552,4534,39,True
2016,08/28,Philadelphia,2.06,573,3403,22,2289,33,0,Summer,2862,3436,22,True
2016,08/21,Philadelphia,1.87,882,4181,6,5365,168,0,Summer,6247,4349,6,True
2016,08/14,Philadelphia,2.06,863,3718,15,2239,132,0,Summer,3102,3850,15,True
2016,08/07,Philadelphia,2.04,729,3821,3,4646,68,0,Summer,5375,3889,3,True
2016,07/31,Philadelphia,2.2,666,3284,14,3467,0,0,Summer,4133,3284,14,True
2016,07/24,Philadelphia,2.07,625,3547,16,3586,181,0,Summer,4211,3728,16,True
2016,07/17,Philadelphia,2.16,855,4251,20,6665,1454,0,Summer,7520,5705,20,True
2016,07/10,Philadelphia,2.15,1248,4556,24,4062,409,0,Summer,5310,4965,24,True
2016,07/03,Philadelphia,2.16,1027,4846,15,3592,955,0,Summer,4619,5801,15,True
2016,06/26,Philadelphia,2.16,579,3964,28,3661,1220,0,Summer,4240,5184,28,True
2016,06/19,Philadelphia,2.19,594,4220,0,5110,852,0,Summer,5704,5072,0,True
2016,06/12,Philadelphia,1.85,938,4044,0,3296,778,0,Summer,4234,4822,0,True
2016,06/05,Philadelphia,1.91,401,3388,12,5183,915,0,Summer,5584,4303,12,True
2016,05/29,Philadelphia,2.07,622,3962,5,5229,918,0,Spring,5851,4880,5,True
2016,05/22,Philadelphia,1.97,750,4399,8,6250,107,0,Spring,7000,4506,8,True
2016,05/15,Philadelphia,1.98,548,3732,166,5472,1003,0,Spring,6020,4735,166,True
2016,05/08,Philadelphia,1.86,479,3608,7,3417,1002,0,Spring,3896,4610,7,True
2016,05/01,Philadelphia,1.87,1713,3814,2,7400,170,0,Spring,9113,3984,2,True
2016,04/24,Philadelphia,1.9,1686,3105,13,9178,666,0,Spring,10864,3771,13,True
2016,04/17,Philadelphia,1.89,933,3820,12,6601,595,0,Spring,7534,4415,12,True
2016,04/10,Philadelphia,1.95,459,2809,12,5674,1831,0,Spring,6133,4640,12,True
2016,04/03,Philadelphia,1.81,831,3207,8,8652,919,0,Spring,9483,4126,8,True
2016,03/27,Philadelphia,1.95,465,2658,17,6054,1400,0,Spring,6519,4058,17,True
2016,03/20,Philadelphia,1.75,745,3110,14,3437,1112,0,Spring,4182,4222,14,True
2016,03/13,Philadelphia,1.59,2152,2872,0,2743,3571,0,Spring,4895,6443,0,True
2016,03/06,Philadelphia,1.53,2516,5105,9,1462,7368,0,Spring,3978,12473,9,True
2016,02/28,Philadelphia,1.62,1136,4947,3,2276,5440,0,Winter,3412,10387,3,True
2016,02/21,Philadelphia,1.79,715,2560,6,1527,4358,0,Winter,2242,6918,6,True
2016,02/14,Philadelphia,2.07,686,2615,23,1144,1483,0,Winter,1830,4098,23,True
2016,02/07,Philadelphia,1.86,793,2576,10,1132,4874,0,Winter,1925,7450,10,True
2016,01/31,Philadelphia,1.53,438,1843,18,230,8866,0,Winter,668,10709,18,True
2016,01/24,Philadelphia,1.81,372,2325,5,1264,7753,0,Winter,1636,10078,5,True
2016,01/17,Philadelphia,1.68,805,1997,33,565,4980,0,Winter,1370,6977,33,True
2016,01/10,Philadelphia,1.37,457,2759,8,114,9995,0,Winter,571,12754,8,True
2016,01/03,Philadelphia,1.53,150,1457,0,169,7011,0,Winter,319,8468,0,True
2016,12/25,PhoenixTucson,1.85,2182,3344,0,3116,14,0,Winter,5298,3358,0,True
2016,12/18,PhoenixTucson,1.83,1652,2712,0,2609,2,0,Winter,4261,2714,0,True
2016,12/11,PhoenixTucson,1.83,1880,3240,0,2915,51,0,Winter,4795,3291,0,True
2016,12/04,PhoenixTucson,1.96,2315,3214,0,1469,10,0,Winter,3784,3224,0,True
2016,11/27,PhoenixTucson,2.01,2026,2529,0,1848,66,0,Fall,3874,2595,0,True
2016,11/20,PhoenixTucson,2.01,2129,3053,0,2789,104,0,Fall,4918,3157,0,True
2016,11/13,PhoenixTucson,1.86,3176,3129,0,4928,211,0,Fall,8104,3340,0,True
2016,11/06,PhoenixTucson,2.35,3221,3921,0,1048,113,0,Fall,4269,4034,0,True
2016,10/30,PhoenixTucson,2.62,1436,3458,0,485,13,0,Fall,1921,3471,0,True
2016,10/23,PhoenixTucson,2.22,2044,2692,0,1219,62,0,Fall,3263,2754,0,True
2016,10/16,PhoenixTucson,2.04,2904,3741,0,1845,59,0,Fall,4749,3800,0,True
2016,10/09,PhoenixTucson,2.4,1749,2997,0,1109,106,0,Fall,2858,3103,0,True
2016,10/02,PhoenixTucson,2.62,1149,3519,0,488,221,0,Fall,1637,3740,0,True
2016,09/25,PhoenixTucson,2.47,1536,3147,0,843,50,0,Fall,2379,3197,0,True
2016,09/18,PhoenixTucson,2.13,2974,3091,0,1494,326,0,Fall,4468,3417,0,True
2016,09/11,PhoenixTucson,2.16,3683,3191,0,584,1379,0,Fall,4267,4570,0,True
2016,09/04,PhoenixTucson,2.15,3684,3163,0,561,1503,0,Fall,4245,4666,0,True
2016,08/28,PhoenixTucson,2.18,3373,3328,0,443,1380,0,Summer,3816,4708,0,True
2016,08/21,PhoenixTucson,2.08,4111,2936,0,523,1611,0,Summer,4634,4547,0,True
2016,08/14,PhoenixTucson,2.13,3417,3561,0,580,1661,0,Summer,3997,5222,0,True
2016,08/07,PhoenixTucson,2.13,3640,3890,0,434,1684,0,Summer,4074,5574,0,True
2016,07/31,PhoenixTucson,2.19,4126,3944,0,472,1820,0,Summer,4598,5764,0,True
2016,07/24,PhoenixTucson,2.08,4721,4139,0,462,2134,0,Summer,5183,6273,0,True
2016,07/17,PhoenixTucson,1.77,6636,4590,0,432,2557,0,Summer,7068,7147,0,True
2016,07/10,PhoenixTucson,1.82,6134,4632,0,420,2805,0,Summer,6554,7437,0,True
2016,07/03,PhoenixTucson,1.65,6214,4300,0,454,3085,0,Summer,6668,7385,0,True
2016,06/26,PhoenixTucson,1.66,6127,4823,0,647,2267,0,Summer,6774,7090,0,True
2016,06/19,PhoenixTucson,1.69,5593,9679,0,483,1339,0,Summer,6076,11018,0,True
2016,06/12,PhoenixTucson,1.51,7296,5158,0,1184,708,0,Summer,8480,5866,0,True
2016,06/05,PhoenixTucson,1.52,5651,4638,0,574,1836,0,Summer,6225,6474,0,True
2016,05/29,PhoenixTucson,1.47,5317,11017,0,415,2437,0,Spring,5732,13454,0,True
2016,05/22,PhoenixTucson,1.52,5249,6143,0,304,2966,0,Spring,5553,9109,0,True
2016,05/15,PhoenixTucson,1.37,6930,11799,0,418,3926,0,Spring,7348,15725,0,True
2016,05/08,PhoenixTucson,1.41,6946,3839,0,524,2877,0,Spring,7470,6716,0,True
2016,05/01,PhoenixTucson,1.3,10862,3558,0,1555,3540,0,Spring,12417,7098,0,True
2016,04/24,PhoenixTucson,1.39,19534,9311,0,1072,3579,0,Spring,20606,12890,0,True
2016,04/17,PhoenixTucson,1.53,7150,8259,0,729,2256,0,Spring,7879,10515,0,True
2016,04/10,PhoenixTucson,1.38,6553,2194,0,4130,1040,0,Spring,10683,3234,0,True
2016,04/03,PhoenixTucson,1.25,7693,1683,0,3146,758,0,Spring,10839,2441,0,True
2016,03/27,PhoenixTucson,1.54,6596,2100,0,2259,364,0,Spring,8855,2464,0,True
2016,03/20,PhoenixTucson,1.57,5963,1870,0,2071,192,0,Spring,8034,2062,0,True
2016,03/13,PhoenixTucson,1.47,5809,1767,0,3586,39,0,Spring,9395,1806,0,True
2016,03/06,PhoenixTucson,1.48,5686,1413,0,4871,464,0,Spring,10557,1877,0,True
2016,02/28,PhoenixTucson,1.52,5123,1445,0,3987,109,0,Winter,9110,1554,0,True
2016,02/21,PhoenixTucson,1.63,4295,1488,0,2820,618,0,Winter,7115,2106,0,True
2016,02/14,PhoenixTucson,1.34,6179,1601,0,3026,1252,0,Winter,9205,2853,0,True
2016,02/07,PhoenixTucson,1.6,5808,991,0,2400,272,0,Winter,8208,1263,0,True
2016,01/31,PhoenixTucson,1.53,5035,1072,0,1949,77,0,Winter,6984,1149,0,True
2016,01/24,PhoenixTucson,1.61,5138,1669,0,2187,63,0,Winter,7325,1732,0,True
2016,01/17,PhoenixTucson,1.46,6758,1863,0,2242,62,0,Winter,9000,1925,0,True
2016,01/10,PhoenixTucson,1.35,7104,1765,0,4178,97,0,Winter,11282,1862,0,True
2016,01/03,PhoenixTucson,1.61,6889,1037,0,2618,105,0,Winter,9507,1142,0,True
2016,12/25,Pittsburgh,1.48,708,3,0,6823,248,0,Winter,7531,251,0,True
2016,12/18,Pittsburgh,1.48,693,13,0,5309,413,0,Winter,6002,426,0,True
2016,12/11,Pittsburgh,1.52,755,17,0,6515,484,0,Winter,7270,501,0,True
2016,12/04,Pittsburgh,1.53,893,8,0,6547,459,0,Winter,7440,467,0,True
2016,11/27,Pittsburgh,1.53,659,7,1,5637,417,0,Fall,6296,424,1,True
2016,11/20,Pittsburgh,1.53,832,17,0,6228,420,0,Fall,7060,437,0,True
2016,11/13,Pittsburgh,1.53,873,7,0,6548,435,0,Fall,7421,442,0,True
2016,11/06,Pittsburgh,1.53,891,73,0,6634,422,0,Fall,7525,495,0,True
2016,10/30,Pittsburgh,1.54,949,59,0,7249,448,0,Fall,8198,507,0,True
2016,10/23,Pittsburgh,1.52,1009,87,0,7224,574,0,Fall,8233,661,0,True
2016,10/16,Pittsburgh,1.53,968,133,0,7685,425,0,Fall,8653,558,0,True
2016,10/09,Pittsburgh,1.51,1003,103,0,7951,540,0,Fall,8954,643,0,True
2016,10/02,Pittsburgh,1.53,796,104,0,8682,422,0,Fall,9478,526,0,True
2016,09/25,Pittsburgh,1.53,1032,128,0,7151,501,0,Fall,8183,629,0,True
2016,09/18,Pittsburgh,1.51,1152,156,0,5973,305,0,Fall,7125,461,0,True
2016,09/11,Pittsburgh,1.49,1073,114,0,4522,383,0,Fall,5595,497,0,True
2016,09/04,Pittsburgh,1.53,927,127,0,4183,34,0,Fall,5110,161,0,True
2016,08/28,Pittsburgh,1.52,713,225,0,3503,208,0,Summer,4216,433,0,True
2016,08/21,Pittsburgh,1.54,740,169,0,4522,7,0,Summer,5262,176,0,True
2016,08/14,Pittsburgh,1.54,915,207,0,4671,165,0,Summer,5586,372,0,True
2016,08/07,Pittsburgh,1.54,860,174,0,3939,108,0,Summer,4799,282,0,True
2016,07/31,Pittsburgh,1.49,844,245,3,5062,0,0,Summer,5906,245,3,True
2016,07/24,Pittsburgh,1.46,657,163,0,4666,6,0,Summer,5323,169,0,True
2016,07/17,Pittsburgh,1.44,608,197,0,5069,21,0,Summer,5677,218,0,True
2016,07/10,Pittsburgh,1.49,332,537,0,1698,104,0,Summer,2030,641,0,True
2016,07/03,Pittsburgh,1.47,252,525,0,2617,90,0,Summer,2869,615,0,True
2016,06/26,Pittsburgh,1.48,544,256,0,4769,0,0,Summer,5313,256,0,True
2016,06/19,Pittsburgh,1.43,566,211,11,6552,3,0,Summer,7118,214,11,True
2016,06/12,Pittsburgh,1.47,690,177,32,4905,79,0,Summer,5595,256,32,True
2016,06/05,Pittsburgh,1.49,840,200,6,4576,14,0,Summer,5416,214,6,True
2016,05/29,Pittsburgh,1.49,1007,247,6,5927,0,0,Spring,6934,247,6,True
2016,05/22,Pittsburgh,1.42,378,149,31,1418,0,0,Spring,1796,149,31,True
2016,05/15,Pittsburgh,1.41,181,240,14,1702,0,0,Spring,1883,240,14,True
2016,05/08,Pittsburgh,1.31,238,388,35,1460,0,0,Spring,1698,388,35,True
2016,05/01,Pittsburgh,1.42,139,268,16,1694,0,0,Spring,1833,268,16,True
2016,04/24,Pittsburgh,1.48,139,154,56,1188,3,0,Spring,1327,157,56,True
2016,04/17,Pittsburgh,1.48,88,322,3,1200,0,0,Spring,1288,322,3,True
2016,04/10,Pittsburgh,1.35,91,301,0,766,0,0,Spring,857,301,0,True
2016,04/03,Pittsburgh,1.43,99,322,0,590,3,0,Spring,689,325,0,True
2016,03/27,Pittsburgh,1.18,96,220,26,1356,3,0,Spring,1452,223,26,True
2016,03/20,Pittsburgh,1.2,69,145,12,975,34,0,Spring,1044,179,12,True
2016,03/13,Pittsburgh,1.15,108,84,9,1274,3,0,Spring,1382,87,9,True
2016,03/06,Pittsburgh,1.37,136,127,4,588,10,0,Spring,724,137,4,True
2016,02/28,Pittsburgh,1.54,135,275,0,386,82,0,Winter,521,357,0,True
2016,02/21,Pittsburgh,1.33,314,32,0,614,295,0,Winter,928,327,0,True
2016,02/14,Pittsburgh,1.38,195,164,0,687,190,0,Winter,882,354,0,True
2016,02/07,Pittsburgh,1.45,161,191,0,538,100,0,Winter,699,291,0,True
2016,01/31,Pittsburgh,1.3,292,137,0,749,63,0,Winter,1041,200,0,True
2016,01/24,Pittsburgh,1.16,235,132,0,1526,45,0,Winter,1761,177,0,True
2016,01/17,Pittsburgh,1.45,454,41,0,559,164,0,Winter,1013,205,0,True
2016,01/10,Pittsburgh,1.4,373,21,0,815,104,0,Winter,1188,125,0,True
2016,01/03,Pittsburgh,1.44,291,13,0,461,145,0,Winter,752,158,0,True
2016,12/25,Portland,0.68,2888,7043,9,638,61580,0,Winter,3526,68623,9,True
2016,12/18,Portland,0.99,4212,3819,1,1071,26220,0,Winter,5283,30039,1,True
2016,12/11,Portland,1.45,3529,3218,6,167,12833,0,Winter,3696,16051,6,True
2016,12/04,Portland,1.46,3404,4487,9,232,17928,0,Winter,3636,22415,9,True
2016,11/27,Portland,1.39,2771,3371,8,129,20588,0,Fall,2900,23959,8,True
2016,11/20,Portland,1.41,2457,4595,6,775,23418,0,Fall,3232,28013,6,True
2016,11/13,Portland,2.16,2802,8416,4,704,6864,0,Fall,3506,15280,4,True
2016,11/06,Portland,1.79,3622,7495,5,344,13764,0,Fall,3966,21259,5,True
2016,10/30,Portland,2.55,1910,4597,0,172,455,0,Fall,2082,5052,0,True
2016,10/23,Portland,2.1,1806,3687,18,386,1918,0,Fall,2192,5605,18,True
2016,10/16,Portland,1.4,3780,4114,4,2640,15702,0,Fall,6420,19816,4,True
2016,10/09,Portland,1.39,2824,2772,3,527,12138,0,Fall,3351,14910,3,True
2016,10/02,Portland,1.21,2843,2404,0,2390,18806,0,Fall,5233,21210,0,True
2016,09/25,Portland,1.57,2981,2886,0,4026,5668,0,Fall,7007,8554,0,True
2016,09/18,Portland,1.46,4166,3430,0,9866,7352,0,Fall,14032,10782,0,True
2016,09/11,Portland,1.22,4820,5901,0,6677,25685,0,Fall,11497,31586,0,True
2016,09/04,Portland,1.34,4754,13713,0,872,19012,0,Fall,5626,32725,0,True
2016,08/28,Portland,2.06,5636,15479,0,259,253,0,Summer,5895,15732,0,True
2016,08/21,Portland,1.67,4776,9485,4,2931,8515,0,Summer,7707,18000,4,True
2016,08/14,Portland,1.74,6587,11769,0,3625,7544,0,Summer,10212,19313,0,True
2016,08/07,Portland,1.58,5514,9962,0,3073,10273,0,Summer,8587,20235,0,True
2016,07/31,Portland,1.64,5706,11094,0,6847,6388,0,Summer,12553,17482,0,True
2016,07/24,Portland,2.25,5280,13778,9,1037,377,0,Summer,6317,14155,9,True
2016,07/17,Portland,1.86,4204,15792,26,113,8881,0,Summer,4317,24673,26,True
2016,07/10,Portland,1.66,5420,11123,19,130,10554,0,Summer,5550,21677,19,True
2016,07/03,Portland,1.33,6123,12522,0,66,26668,0,Summer,6189,39190,0,True
2016,06/26,Portland,1.42,5889,17271,25,109,12982,0,Summer,5998,30253,25,True
2016,06/19,Portland,1.23,7923,26690,18,1979,13230,0,Summer,9902,39920,18,True
2016,06/12,Portland,1.67,6921,15536,15,273,2393,0,Summer,7194,17929,15,True
2016,06/05,Portland,1.66,7923,20355,11,90,790,0,Summer,8013,21145,11,True
2016,05/29,Portland,1.44,2627,21156,0,150,10963,0,Spring,2777,32119,0,True
2016,05/22,Portland,1.22,1810,32672,6,123,22329,0,Spring,1933,55001,6,True
2016,05/15,Portland,1.61,1973,24271,3,96,2401,0,Spring,2069,26672,3,True
2016,05/08,Portland,1.19,2072,19665,3,103,18260,0,Spring,2175,37925,3,True
2016,05/01,Portland,1.03,2158,14037,0,98,28220,0,Spring,2256,42257,0,True
2016,04/24,Portland,1.39,1874,29434,3,199,6675,0,Spring,2073,36109,3,True
2016,04/17,Portland,1.64,2203,14267,1,92,3259,0,Spring,2295,17526,1,True
2016,04/10,Portland,0.96,2125,32426,0,321,46349,0,Spring,2446,78775,0,True
2016,04/03,Portland,1.3,2240,16386,4,296,16518,0,Spring,2536,32904,4,True
2016,03/27,Portland,1.33,1420,16074,1,88,13240,0,Spring,1508,29314,1,True
2016,03/20,Portland,0.87,1402,26703,0,257,67807,0,Spring,1659,94510,0,True
2016,03/13,Portland,1.13,1465,10758,0,35,26630,0,Spring,1500,37388,0,True
2016,03/06,Portland,1.29,1471,11528,1,0,16349,0,Spring,1471,27877,1,True
2016,02/28,Portland,1.89,1352,10793,1,25,140,0,Winter,1377,10933,1,True
2016,02/21,Portland,1.76,786,9953,4,190,2273,0,Winter,976,12226,4,True
2016,02/14,Portland,0.9,1154,18425,3,1433,42665,0,Winter,2587,61090,3,True
2016,02/07,Portland,1.12,1306,12257,0,12385,4072,0,Winter,13691,16329,0,True
2016,01/31,Portland,1.35,1049,9316,13,42,14149,0,Winter,1091,23465,13,True
2016,01/24,Portland,1.6,1555,8077,15,0,8076,0,Winter,1555,16153,15,True
2016,01/17,Portland,1.22,1345,11419,0,27,16654,0,Winter,1372,28073,0,True
2016,01/10,Portland,1.25,1551,12122,15,22,16869,0,Winter,1573,28991,15,True
2016,01/03,Portland,1.44,2016,10072,6,133,16021,0,Winter,2149,26093,6,True
2016,12/25,RaleighGreensboro,1.6,169,3060,369,4526,72,0,Winter,4695,3132,369,True
2016,12/18,RaleighGreensboro,1.6,209,2560,291,3393,148,0,Winter,3602,2708,291,True
2016,12/11,RaleighGreensboro,1.63,129,3172,298,3332,752,0,Winter,3461,3924,298,True
2016,12/04,RaleighGreensboro,2.01,154,2819,259,4028,370,0,Winter,4182,3189,259,True
2016,11/27,RaleighGreensboro,2.01,194,2960,331,5708,659,0,Fall,5902,3619,331,True
2016,11/20,RaleighGreensboro,1.87,145,3001,444,7327,1102,0,Fall,7472,4103,444,True
2016,11/13,RaleighGreensboro,1.85,180,3018,418,5476,1183,0,Fall,5656,4201,418,True
2016,11/06,RaleighGreensboro,1.85,181,3574,446,8399,1050,0,Fall,8580,4624,446,True
2016,10/30,RaleighGreensboro,1.83,181,5746,603,6482,182,0,Fall,6663,5928,603,True
2016,10/23,RaleighGreensboro,1.69,171,6245,615,6163,1547,0,Fall,6334,7792,615,True
2016,10/16,RaleighGreensboro,1.69,168,5344,579,6432,596,0,Fall,6600,5940,579,True
2016,10/09,RaleighGreensboro,1.65,252,6045,665,6449,869,0,Fall,6701,6914,665,True
2016,10/02,RaleighGreensboro,1.87,190,4744,452,4848,229,0,Fall,5038,4973,452,True
2016,09/25,RaleighGreensboro,1.81,226,4839,424,6302,1015,0,Fall,6528,5854,424,True
2016,09/18,RaleighGreensboro,1.85,209,5138,450,5827,506,0,Fall,6036,5644,450,True
2016,09/11,RaleighGreensboro,1.77,217,5379,518,8919,875,0,Fall,9136,6254,518,True
2016,09/04,RaleighGreensboro,1.83,202,5615,591,7280,1262,0,Fall,7482,6877,591,True
2016,08/28,RaleighGreensboro,1.79,433,5340,561,6859,1557,0,Summer,7292,6897,561,True
2016,08/21,RaleighGreensboro,1.83,392,5555,665,7972,457,0,Summer,8364,6012,665,True
2016,08/14,RaleighGreensboro,1.84,265,5472,699,4511,605,0,Summer,4776,6077,699,True
2016,08/07,RaleighGreensboro,1.65,278,9029,1380,3957,1153,0,Summer,4235,10182,1380,True
2016,07/31,RaleighGreensboro,1.68,326,7146,1131,6307,339,0,Summer,6633,7485,1131,True
2016,07/24,RaleighGreensboro,1.72,285,6934,1420,5946,425,0,Summer,6231,7359,1420,True
2016,07/17,RaleighGreensboro,1.76,340,4953,1036,5924,532,0,Summer,6264,5485,1036,True
2016,07/10,RaleighGreensboro,1.87,331,3715,647,5254,213,0,Summer,5585,3928,647,True
2016,07/03,RaleighGreensboro,1.88,241,3230,722,4771,186,0,Summer,5012,3416,722,True
2016,06/26,RaleighGreensboro,1.72,262,3228,598,4326,804,0,Summer,4588,4032,598,True
2016,06/19,RaleighGreensboro,1.78,250,3228,590,4322,512,0,Summer,4572,3740,590,True
2016,06/12,RaleighGreensboro,1.7,229,3677,468,4380,1026,0,Summer,4609,4703,468,True
2016,06/05,RaleighGreensboro,1.58,222,4199,464,4237,1071,0,Summer,4459,5270,464,True
2016,05/29,RaleighGreensboro,1.8,235,3673,404,3765,501,0,Spring,4000,4174,404,True
2016,05/22,RaleighGreensboro,1.33,197,3105,338,3330,1418,0,Spring,3527,4523,338,True
2016,05/15,RaleighGreensboro,1.66,281,3879,441,1946,78,0,Spring,2227,3957,441,True
2016,05/08,RaleighGreensboro,1.65,322,3842,492,2044,228,0,Spring,2366,4070,492,True
2016,05/01,RaleighGreensboro,1.59,228,3675,494,1923,193,0,Spring,2151,3868,494,True
2016,04/24,RaleighGreensboro,1.61,157,3368,437,1791,99,0,Spring,1948,3467,437,True
2016,04/17,RaleighGreensboro,1.49,211,2959,321,2501,447,0,Spring,2712,3406,321,True
2016,04/10,RaleighGreensboro,1.33,170,2878,336,3421,564,0,Spring,3591,3442,336,True
2016,04/03,RaleighGreensboro,1.73,157,3254,392,850,224,0,Spring,1007,3478,392,True
2016,03/27,RaleighGreensboro,1.43,137,2547,330,2230,657,0,Spring,2367,3204,330,True
2016,03/20,RaleighGreensboro,1.42,191,2696,326,1020,1023,0,Spring,1211,3719,326,True
2016,03/13,RaleighGreensboro,1.54,264,2611,314,1780,371,0,Spring,2044,2982,314,True
2016,03/06,RaleighGreensboro,1.79,155,2740,376,443,4,0,Spring,598,2744,376,True
2016,02/28,RaleighGreensboro,1.71,231,2720,362,901,29,0,Winter,1132,2749,362,True
2016,02/21,RaleighGreensboro,1.76,211,2287,382,660,22,0,Winter,871,2309,382,True
2016,02/14,RaleighGreensboro,1.59,183,1987,397,1297,369,0,Winter,1480,2356,397,True
2016,02/07,RaleighGreensboro,1.54,215,2621,515,1280,929,0,Winter,1495,3550,515,True
2016,01/31,RaleighGreensboro,1.56,188,2631,447,1821,641,0,Winter,2009,3272,447,True
2016,01/24,RaleighGreensboro,1.59,113,2235,416,2409,101,0,Winter,2522,2336,416,True
2016,01/17,RaleighGreensboro,1.66,147,2088,436,1260,204,0,Winter,1407,2292,436,True
2016,01/10,RaleighGreensboro,1.59,144,3048,533,2217,560,0,Winter,2361,3608,533,True
2016,01/03,RaleighGreensboro,1.68,156,2420,558,1386,363,0,Winter,1542,2783,558,True
2016,12/25,RichmondNorfolk,1.66,501,2272,151,2309,0,0,Winter,2810,2272,151,True
2016,12/18,RichmondNorfolk,1.61,373,2227,179,2381,66,0,Winter,2754,2293,179,True
2016,12/11,RichmondNorfolk,1.58,311,2645,170,2668,580,0,Winter,2979,3225,170,True
2016,12/04,RichmondNorfolk,1.3,262,2320,116,1641,2791,0,Winter,1903,5111,116,True
2016,11/27,RichmondNorfolk,1.27,297,1879,170,1538,2740,0,Fall,1835,4619,170,True
2016,11/20,RichmondNorfolk,1.1,320,1919,253,1854,4545,0,Fall,2174,6464,253,True
2016,11/13,RichmondNorfolk,1.61,275,2721,217,2456,1857,0,Fall,2731,4578,217,True
2016,11/06,RichmondNorfolk,1.16,354,3333,224,3285,5723,0,Fall,3639,9056,224,True
2016,10/30,RichmondNorfolk,1.76,211,3878,348,2042,225,0,Fall,2253,4103,348,True
2016,10/23,RichmondNorfolk,1.16,141,4350,358,1949,5355,0,Fall,2090,9705,358,True
2016,10/16,RichmondNorfolk,1.39,202,3729,293,2083,2165,0,Fall,2285,5894,293,True
2016,10/09,RichmondNorfolk,1.25,291,3653,402,3082,3397,0,Fall,3373,7050,402,True
2016,10/02,RichmondNorfolk,1.79,62,3661,301,2195,204,0,Fall,2257,3865,301,True
2016,09/25,RichmondNorfolk,1.54,105,3806,234,3344,2546,0,Fall,3449,6352,234,True
2016,09/18,RichmondNorfolk,1.52,109,3995,251,3302,2046,0,Fall,3411,6041,251,True
2016,09/11,RichmondNorfolk,1.24,95,3700,275,3156,3490,0,Fall,3251,7190,275,True
2016,09/04,RichmondNorfolk,1.29,130,4206,327,2581,3440,0,Fall,2711,7646,327,True
2016,08/28,RichmondNorfolk,1.32,106,3821,345,2639,2444,0,Summer,2745,6265,345,True
2016,08/21,RichmondNorfolk,1.56,101,4189,363,2669,1748,0,Summer,2770,5937,363,True
2016,08/14,RichmondNorfolk,1.43,131,3711,406,2673,2270,0,Summer,2804,5981,406,True
2016,08/07,RichmondNorfolk,1.33,180,4064,535,2870,3733,0,Summer,3050,7797,535,True
2016,07/31,RichmondNorfolk,1.39,181,3715,360,2698,1616,0,Summer,2879,5331,360,True
2016,07/24,RichmondNorfolk,1.44,76,3877,585,2544,1232,0,Summer,2620,5109,585,True
2016,07/17,RichmondNorfolk,1.5,161,4390,500,2761,1814,0,Summer,2922,6204,500,True
2016,07/10,RichmondNorfolk,1.41,190,4922,464,1823,1289,0,Summer,2013,6211,464,True
2016,07/03,RichmondNorfolk,1.44,199,4533,419,1563,776,0,Summer,1762,5309,419,True
2016,06/26,RichmondNorfolk,1.19,343,4176,391,1732,2555,0,Summer,2075,6731,391,True
2016,06/19,RichmondNorfolk,1.2,131,4497,420,1913,2184,0,Summer,2044,6681,420,True
2016,06/12,RichmondNorfolk,1.16,131,4168,395,1665,3207,0,Summer,1796,7375,395,True
2016,06/05,RichmondNorfolk,0.95,135,4707,240,1741,4476,0,Summer,1876,9183,240,True
2016,05/29,RichmondNorfolk,1.05,151,5283,242,2428,3305,0,Spring,2579,8588,242,True
2016,05/22,RichmondNorfolk,1.03,231,4605,232,2186,3875,0,Spring,2417,8480,232,True
2016,05/15,RichmondNorfolk,1.37,193,5552,298,2022,456,0,Spring,2215,6008,298,True
2016,05/08,RichmondNorfolk,1.36,209,5266,341,2301,890,0,Spring,2510,6156,341,True
2016,05/01,RichmondNorfolk,1.37,250,4755,276,2973,577,0,Spring,3223,5332,276,True
2016,04/24,RichmondNorfolk,1.41,299,4036,174,3520,636,0,Spring,3819,4672,174,True
2016,04/17,RichmondNorfolk,1.19,253,3546,205,3257,1856,0,Spring,3510,5402,205,True
2016,04/10,RichmondNorfolk,0.93,255,3842,200,5416,2272,0,Spring,5671,6114,200,True
2016,04/03,RichmondNorfolk,1.35,156,3417,317,1480,1328,0,Spring,1636,4745,317,True
2016,03/27,RichmondNorfolk,1.14,184,3008,224,2487,3123,0,Spring,2671,6131,224,True
2016,03/20,RichmondNorfolk,1.0,308,2675,164,1653,3544,0,Spring,1961,6219,164,True
2016,03/13,RichmondNorfolk,1.23,269,2965,245,1382,1787,0,Spring,1651,4752,245,True
2016,03/06,RichmondNorfolk,1.54,240,2554,209,1079,6,0,Spring,1319,2560,209,True
2016,02/28,RichmondNorfolk,1.41,173,2677,174,1441,323,0,Winter,1614,3000,174,True
2016,02/21,RichmondNorfolk,1.48,140,1961,223,998,200,0,Winter,1138,2161,223,True
2016,02/14,RichmondNorfolk,1.29,177,2574,212,1288,1257,0,Winter,1465,3831,212,True
2016,02/07,RichmondNorfolk,1.34,133,2540,283,1045,902,0,Winter,1178,3442,283,True
2016,01/31,RichmondNorfolk,1.35,170,2962,284,791,1312,0,Winter,961,4274,284,True
2016,01/24,RichmondNorfolk,1.45,114,2524,192,1789,444,0,Winter,1903,2968,192,True
2016,01/17,RichmondNorfolk,1.4,69,2273,253,1033,542,0,Winter,1102,2815,253,True
2016,01/10,RichmondNorfolk,1.35,126,2778,279,1466,1774,0,Winter,1592,4552,279,True
2016,01/03,RichmondNorfolk,1.45,110,2315,326,1223,1118,0,Winter,1333,3433,326,True
2016,12/25,Roanoke,1.68,179,2219,0,1475,36,0,Winter,1654,2255,0,True
2016,12/18,Roanoke,1.5,181,2715,0,1624,293,0,Winter,1805,3008,0,True
2016,12/11,Roanoke,1.39,87,2532,0,1788,1708,0,Winter,1875,4240,0,True
2016,12/04,Roanoke,1.16,70,2425,0,836,3679,0,Winter,906,6104,0,True
2016,11/27,Roanoke,1.1,18,1877,0,1074,3217,0,Fall,1092,5094,0,True
2016,11/20,Roanoke,0.98,75,2398,0,1186,5555,0,Fall,1261,7953,0,True
2016,11/13,Roanoke,1.17,65,2932,0,1297,5204,0,Fall,1362,8136,0,True
2016,11/06,Roanoke,0.96,54,3558,0,2179,8054,0,Fall,2233,11612,0,True
2016,10/30,Roanoke,1.77,52,4203,0,1422,657,0,Fall,1474,4860,0,True
2016,10/23,Roanoke,0.97,89,3435,0,1475,7376,0,Fall,1564,10811,0,True
2016,10/16,Roanoke,1.15,52,3016,0,1582,3672,0,Fall,1634,6688,0,True
2016,10/09,Roanoke,1.02,51,3881,0,2235,6582,0,Fall,2286,10463,0,True
2016,10/02,Roanoke,1.69,59,3548,0,1603,580,0,Fall,1662,4128,0,True
2016,09/25,Roanoke,1.34,50,3432,0,2183,4559,0,Fall,2233,7991,0,True
2016,09/18,Roanoke,1.52,58,3901,0,1893,2387,0,Fall,1951,6288,0,True
2016,09/11,Roanoke,1.08,100,3898,0,1658,6467,0,Fall,1758,10365,0,True
2016,09/04,Roanoke,1.15,97,3795,0,1605,6345,0,Fall,1702,10140,0,True
2016,08/28,Roanoke,1.05,66,3677,0,1541,5769,0,Summer,1607,9446,0,True
2016,08/21,Roanoke,1.41,77,3840,0,1489,4386,0,Summer,1566,8226,0,True
2016,08/14,Roanoke,1.26,100,3811,0,1314,4048,0,Summer,1414,7859,0,True
2016,08/07,Roanoke,1.19,108,3845,0,1416,6119,0,Summer,1524,9964,0,True
2016,07/31,Roanoke,1.2,222,3754,0,1543,3151,0,Summer,1765,6905,0,True
2016,07/24,Roanoke,1.51,149,4086,0,1330,1438,0,Summer,1479,5524,0,True
2016,07/17,Roanoke,1.49,127,4064,0,1521,2232,0,Summer,1648,6296,0,True
2016,07/10,Roanoke,1.33,118,5339,0,1340,2700,0,Summer,1458,8039,0,True
2016,07/03,Roanoke,1.52,118,4615,0,949,1380,0,Summer,1067,5995,0,True
2016,06/26,Roanoke,1.19,72,3824,0,1193,3951,0,Summer,1265,7775,0,True
2016,06/19,Roanoke,1.18,156,4049,0,1223,3900,0,Summer,1379,7949,0,True
2016,06/12,Roanoke,1.21,77,4286,0,1063,5397,0,Summer,1140,9683,0,True
2016,06/05,Roanoke,0.89,112,3494,0,1051,7118,0,Summer,1163,10612,0,True
2016,05/29,Roanoke,0.96,172,4014,0,1341,4405,0,Spring,1513,8419,0,True
2016,05/22,Roanoke,0.79,222,3750,0,1445,6847,0,Spring,1667,10597,0,True
2016,05/15,Roanoke,1.35,83,4760,0,1488,564,0,Spring,1571,5324,0,True
2016,05/08,Roanoke,1.36,68,4191,0,1395,1575,0,Spring,1463,5766,0,True
2016,05/01,Roanoke,1.35,159,3652,0,2042,813,0,Spring,2201,4465,0,True
2016,04/24,Roanoke,1.4,132,3781,0,1995,1063,0,Spring,2127,4844,0,True
2016,04/17,Roanoke,1.06,126,3595,0,1717,3375,0,Spring,1843,6970,0,True
2016,04/10,Roanoke,0.81,100,4237,0,5961,3780,0,Spring,6061,8017,0,True
2016,04/03,Roanoke,1.31,111,3216,0,1129,2371,0,Spring,1240,5587,0,True
2016,03/27,Roanoke,0.99,154,3073,0,1330,5391,0,Spring,1484,8464,0,True
2016,03/20,Roanoke,0.94,233,2971,0,1031,4847,0,Spring,1264,7818,0,True
2016,03/13,Roanoke,1.22,102,3612,0,917,2536,0,Spring,1019,6148,0,True
2016,03/06,Roanoke,1.55,78,3156,0,558,7,0,Spring,636,3163,0,True
2016,02/28,Roanoke,1.29,102,3439,0,759,583,0,Winter,861,4022,0,True
2016,02/21,Roanoke,1.38,111,3060,0,637,471,0,Winter,748,3531,0,True
2016,02/14,Roanoke,1.21,107,2986,0,755,2710,0,Winter,862,5696,0,True
2016,02/07,Roanoke,1.29,80,3366,0,657,1794,0,Winter,737,5160,0,True
2016,01/31,Roanoke,1.33,98,3346,0,794,1779,0,Winter,892,5125,0,True
2016,01/24,Roanoke,1.55,98,2996,0,849,830,0,Winter,947,3826,0,True
2016,01/17,Roanoke,1.37,130,2593,0,622,1163,0,Winter,752,3756,0,True
2016,01/10,Roanoke,1.28,89,2637,0,801,2489,0,Winter,890,5126,0,True
2016,01/03,Roanoke,1.24,81,2303,0,476,2162,0,Winter,557,4465,0,True
2016,12/25,Sacramento,2.41,1449,2867,2,247,0,0,Winter,1696,2867,2,True
2016,12/18,Sacramento,2.36,1376,2177,0,214,0,0,Winter,1590,2177,0,True
2016,12/11,Sacramento,2.46,1283,2305,0,285,0,0,Winter,1568,2305,0,True
2016,12/04,Sacramento,2.52,1687,2234,0,462,0,0,Winter,2149,2234,0,True
2016,11/27,Sacramento,2.61,1531,2161,2,432,15,0,Fall,1963,2176,2,True
2016,11/20,Sacramento,2.54,1621,2602,2,1128,59,0,Fall,2749,2661,2,True
2016,11/13,Sacramento,2.65,1981,3036,0,998,8,0,Fall,2979,3044,0,True
2016,11/06,Sacramento,2.82,1769,3105,0,493,3,0,Fall,2262,3108,0,True
2016,10/30,Sacramento,2.44,1550,3615,0,510,0,0,Fall,2060,3615,0,True
2016,10/23,Sacramento,2.23,1044,3807,5,668,0,0,Fall,1712,3807,5,True
2016,10/16,Sacramento,2.13,1299,2582,0,433,0,0,Fall,1732,2582,0,True
2016,10/09,Sacramento,2.39,1178,4135,0,320,0,0,Fall,1498,4135,0,True
2016,10/02,Sacramento,2.33,1399,4712,7,268,20,0,Fall,1667,4732,7,True
2016,09/25,Sacramento,2.18,1733,4758,9,251,6,0,Fall,1984,4764,9,True
2016,09/18,Sacramento,2.17,1674,5064,2,343,10,0,Fall,2017,5074,2,True
2016,09/11,Sacramento,2.19,1512,5358,3,345,3,0,Fall,1857,5361,3,True
2016,09/04,Sacramento,2.19,1311,5222,0,379,0,0,Fall,1690,5222,0,True
2016,08/28,Sacramento,2.23,1196,5359,2,359,0,0,Summer,1555,5359,2,True
2016,08/21,Sacramento,2.19,1455,4408,0,307,0,0,Summer,1762,4408,0,True
2016,08/14,Sacramento,1.96,1651,5561,0,277,0,0,Summer,1928,5561,0,True
2016,08/07,Sacramento,2.2,1615,5967,0,316,23,0,Summer,1931,5990,0,True
2016,07/31,Sacramento,2.19,1534,5582,2,307,0,0,Summer,1841,5582,2,True
2016,07/24,Sacramento,2.15,1607,5412,2,326,0,0,Summer,1933,5412,2,True
2016,07/17,Sacramento,2.14,1596,5807,0,310,0,0,Summer,1906,5807,0,True
2016,07/10,Sacramento,2.13,1784,6221,0,341,0,0,Summer,2125,6221,0,True
2016,07/03,Sacramento,2.13,1931,6761,0,363,0,0,Summer,2294,6761,0,True
2016,06/26,Sacramento,1.79,2537,6488,0,591,0,0,Summer,3128,6488,0,True
2016,06/19,Sacramento,2.13,1496,5679,0,241,0,0,Summer,1737,5679,0,True
2016,06/12,Sacramento,2.11,1478,5966,0,163,0,0,Summer,1641,5966,0,True
2016,06/05,Sacramento,2.08,1423,6372,0,327,0,0,Summer,1750,6372,0,True
2016,05/29,Sacramento,1.99,1748,7197,0,388,0,0,Spring,2136,7197,0,True
2016,05/22,Sacramento,2.01,1744,6492,0,202,0,0,Spring,1946,6492,0,True
2016,05/15,Sacramento,1.72,3732,7340,0,599,0,0,Spring,4331,7340,0,True
2016,05/08,Sacramento,1.4,1851,10971,0,138,0,0,Spring,1989,10971,0,True
2016,05/01,Sacramento,1.41,1777,10850,0,428,0,0,Spring,2205,10850,0,True
2016,04/24,Sacramento,2.01,1726,6795,0,319,0,0,Spring,2045,6795,0,True
2016,04/17,Sacramento,1.95,1585,6479,0,412,0,0,Spring,1997,6479,0,True
2016,04/10,Sacramento,2.05,1570,5977,0,323,0,0,Spring,1893,5977,0,True
2016,04/03,Sacramento,2.03,1317,6587,0,203,0,0,Spring,1520,6587,0,True
2016,03/27,Sacramento,2.07,1210,6043,0,331,3,0,Spring,1541,6046,0,True
2016,03/20,Sacramento,1.96,1124,6330,0,233,0,0,Spring,1357,6330,0,True
2016,03/13,Sacramento,2.04,1313,5918,0,170,0,0,Spring,1483,5918,0,True
2016,03/06,Sacramento,1.88,1979,7072,0,676,0,0,Spring,2655,7072,0,True
2016,02/28,Sacramento,2.01,1156,6504,0,334,3,0,Winter,1490,6507,0,True
2016,02/21,Sacramento,2.04,1000,5572,0,241,3,0,Winter,1241,5575,0,True
2016,02/14,Sacramento,1.98,1013,6423,0,148,2,0,Winter,1161,6425,0,True
2016,02/07,Sacramento,1.72,1176,6908,0,276,0,0,Winter,1452,6908,0,True
2016,01/31,Sacramento,1.73,1966,7082,0,719,0,0,Winter,2685,7082,0,True
2016,01/24,Sacramento,1.73,1130,5939,0,291,0,0,Winter,1421,5939,0,True
2016,01/17,Sacramento,1.72,1153,5593,0,133,0,0,Winter,1286,5593,0,True
2016,01/10,Sacramento,1.68,1251,5380,0,298,0,0,Winter,1549,5380,0,True
2016,01/03,Sacramento,1.68,1317,6361,0,231,0,0,Winter,1548,6361,0,True
2016,12/25,SanDiego,1.43,715,7537,0,540,3230,0,Winter,1255,10767,0,True
2016,12/18,SanDiego,1.63,829,9348,52,403,1578,0,Winter,1232,10926,52,True
2016,12/11,SanDiego,1.49,1070,9924,4,526,2987,0,Winter,1596,12911,4,True
2016,12/04,SanDiego,2.06,1464,6546,0,540,868,0,Winter,2004,7414,0,True
2016,11/27,SanDiego,2.12,865,7228,0,380,1797,0,Fall,1245,9025,0,True
2016,11/20,SanDiego,2.22,747,6107,0,720,960,0,Fall,1467,7067,0,True
2016,11/13,SanDiego,2.1,914,6460,0,830,2057,0,Fall,1744,8517,0,True
2016,11/06,SanDiego,2.51,1168,7700,0,497,1933,0,Fall,1665,9633,0,True
2016,10/30,SanDiego,2.74,1854,6533,0,545,0,0,Fall,2399,6533,0,True
2016,10/23,SanDiego,2.73,653,6987,0,893,0,0,Fall,1546,6987,0,True
2016,10/16,SanDiego,2.28,1073,9006,0,1176,0,0,Fall,2249,9006,0,True
2016,10/09,SanDiego,2.22,908,7917,0,1673,0,0,Fall,2581,7917,0,True
2016,10/02,SanDiego,1.99,980,7576,0,3658,0,0,Fall,4638,7576,0,True
2016,09/25,SanDiego,2.35,734,8359,0,737,0,0,Fall,1471,8359,0,True
2016,09/18,SanDiego,2.15,1289,8195,0,756,32,0,Fall,2045,8227,0,True
2016,09/11,SanDiego,1.59,2500,13057,0,1950,914,0,Fall,4450,13971,0,True
2016,09/04,SanDiego,1.79,2161,8451,0,4219,898,0,Fall,6380,9349,0,True
2016,08/28,SanDiego,1.89,2605,8258,0,3283,211,0,Summer,5888,8469,0,True
2016,08/21,SanDiego,1.92,3470,6774,0,1757,237,0,Summer,5227,7011,0,True
2016,08/14,SanDiego,1.91,3489,8753,4,511,2825,0,Summer,4000,11578,4,True
2016,08/07,SanDiego,1.48,1971,7907,0,524,9740,0,Summer,2495,17647,0,True
2016,07/31,SanDiego,1.97,1816,9171,6,657,1622,0,Summer,2473,10793,6,True
2016,07/24,SanDiego,1.69,2125,9589,3,2202,3271,0,Summer,4327,12860,3,True
2016,07/17,SanDiego,1.91,1579,10303,0,2981,0,0,Summer,4560,10303,0,True
2016,07/10,SanDiego,1.43,2752,8317,0,9927,0,0,Summer,12679,8317,0,True
2016,07/03,SanDiego,1.49,1895,11972,0,7634,3,0,Summer,9529,11975,0,True
2016,06/26,SanDiego,1.52,3158,11338,0,5690,21,0,Summer,8848,11359,0,True
2016,06/19,SanDiego,1.46,2114,11018,4,7696,7,0,Summer,9810,11025,4,True
2016,06/12,SanDiego,1.45,2863,11757,3,4270,3,0,Summer,7133,11760,3,True
2016,06/05,SanDiego,1.52,3340,8893,0,5022,175,0,Summer,8362,9068,0,True
2016,05/29,SanDiego,1.44,2154,9998,0,6601,89,0,Spring,8755,10087,0,True
2016,05/22,SanDiego,1.15,2091,10494,4,8771,0,0,Spring,10862,10494,4,True
2016,05/15,SanDiego,1.53,2107,9617,0,4667,0,0,Spring,6774,9617,0,True
2016,05/08,SanDiego,1.37,1313,11595,0,9788,54,0,Spring,11101,11649,0,True
2016,05/01,SanDiego,1.37,1184,9050,0,6870,106,0,Spring,8054,9156,0,True
2016,04/24,SanDiego,1.22,1677,9129,3,8543,7,0,Spring,10220,9136,3,True
2016,04/17,SanDiego,1.29,1367,8462,6,6287,35,0,Spring,7654,8497,6,True
2016,04/10,SanDiego,1.23,1574,9821,0,6862,1730,0,Spring,8436,11551,0,True
2016,04/03,SanDiego,1.25,1640,13036,0,3636,3317,0,Spring,5276,16353,0,True
2016,03/27,SanDiego,1.35,1329,9842,4,1289,4435,0,Spring,2618,14277,4,True
2016,03/20,SanDiego,1.4,1809,8607,3,2285,2220,0,Spring,4094,10827,3,True
2016,03/13,SanDiego,1.38,1821,12902,0,1609,4503,0,Spring,3430,17405,0,True
2016,03/06,SanDiego,1.21,1836,8499,0,7772,39,0,Spring,9608,8538,0,True
2016,02/28,SanDiego,1.12,1620,10119,0,12878,74,0,Winter,14498,10193,0,True
2016,02/21,SanDiego,1.25,1307,8403,4,6474,713,0,Winter,7781,9116,4,True
2016,02/14,SanDiego,1.42,667,9489,7,670,3279,0,Winter,1337,12768,7,True
2016,02/07,SanDiego,1.32,883,7162,12,311,5048,0,Winter,1194,12210,12,True
2016,01/31,SanDiego,1.4,1123,7131,12,444,2982,0,Winter,1567,10113,12,True
2016,01/24,SanDiego,1.31,1368,8300,0,756,4890,0,Winter,2124,13190,0,True
2016,01/17,SanDiego,1.46,1919,5839,0,710,3649,0,Winter,2629,9488,0,True
2016,01/10,SanDiego,1.32,1414,5266,0,515,5238,0,Winter,1929,10504,0,True
2016,01/03,SanDiego,1.41,1991,5916,0,614,2453,0,Winter,2605,8369,0,True
2016,12/25,SanFrancisco,2.56,5599,8335,0,2234,0,0,Winter,7833,8335,0,True
2016,12/18,SanFrancisco,2.57,4731,7497,0,2309,0,0,Winter,7040,7497,0,True
2016,12/11,SanFrancisco,2.67,5669,7627,0,3026,0,0,Winter,8695,7627,0,True
2016,12/04,SanFrancisco,2.67,7263,7440,0,3217,12,0,Winter,10480,7452,0,True
2016,11/27,SanFrancisco,2.88,7103,8383,0,2292,84,0,Fall,9395,8467,0,True
2016,11/20,SanFrancisco,2.94,5926,7823,0,3620,66,0,Fall,9546,7889,0,True
2016,11/13,SanFrancisco,2.99,6204,9341,0,3337,46,0,Fall,9541,9387,0,True
2016,11/06,SanFrancisco,3.12,5898,10039,0,3079,26,0,Fall,8977,10065,0,True
2016,10/30,SanFrancisco,3.25,2325,11142,0,3232,0,0,Fall,5557,11142,0,True
2016,10/23,SanFrancisco,2.93,522,7911,0,2818,0,0,Fall,3340,7911,0,True
2016,10/16,SanFrancisco,2.34,696,5316,0,3035,0,0,Fall,3731,5316,0,True
2016,10/09,SanFrancisco,2.72,1173,16842,0,2717,27,0,Fall,3890,16869,0,True
2016,10/02,SanFrancisco,2.64,915,18642,8,2890,43,0,Fall,3805,18685,8,True
2016,09/25,SanFrancisco,2.35,1004,17080,0,3172,23,0,Fall,4176,17103,0,True
2016,09/18,SanFrancisco,2.39,1244,20050,0,2165,53,0,Fall,3409,20103,0,True
2016,09/11,SanFrancisco,2.37,1085,20414,0,2947,26,0,Fall,4032,20440,0,True
2016,09/04,SanFrancisco,2.38,808,20860,0,2771,53,0,Fall,3579,20913,0,True
2016,08/28,SanFrancisco,2.38,879,20543,0,2703,16,0,Summer,3582,20559,0,True
2016,08/21,SanFrancisco,2.37,1618,16299,0,2303,40,0,Summer,3921,16339,0,True
2016,08/14,SanFrancisco,2.02,1769,21501,0,2209,40,0,Summer,3978,21541,0,True
2016,08/07,SanFrancisco,2.33,2253,19463,0,2861,26,0,Summer,5114,19489,0,True
2016,07/31,SanFrancisco,2.29,1680,20024,1,1877,13,0,Summer,3557,20037,1,True
2016,07/24,SanFrancisco,2.37,1599,18771,0,1709,3,0,Summer,3308,18774,0,True
2016,07/17,SanFrancisco,2.3,1394,22261,4,2614,10,0,Summer,4008,22271,4,True
2016,07/10,SanFrancisco,2.32,1759,25145,0,2149,10,0,Summer,3908,25155,0,True
2016,07/03,SanFrancisco,2.31,1423,25739,14,1884,10,0,Summer,3307,25749,14,True
2016,06/26,SanFrancisco,2.21,2214,25310,2,2004,3,0,Summer,4218,25313,2,True
2016,06/19,SanFrancisco,2.31,1610,23719,0,1658,3,0,Summer,3268,23722,0,True
2016,06/12,SanFrancisco,2.25,1204,24024,0,2116,3,0,Summer,3320,24027,0,True
2016,06/05,SanFrancisco,2.3,1444,23217,0,2182,6,0,Summer,3626,23223,0,True
2016,05/29,SanFrancisco,2.34,1397,25119,0,2186,3,0,Spring,3583,25122,0,True
2016,05/22,SanFrancisco,2.34,1453,27106,0,1722,10,0,Spring,3175,27116,0,True
2016,05/15,SanFrancisco,2.27,1845,27742,0,1713,6,0,Spring,3558,27748,0,True
2016,05/08,SanFrancisco,1.32,1609,48288,0,2087,0,0,Spring,3696,48288,0,True
2016,05/01,SanFrancisco,1.33,1480,43790,0,1764,0,0,Spring,3244,43790,0,True
2016,04/24,SanFrancisco,2.21,1506,26093,0,2093,0,0,Spring,3599,26093,0,True
2016,04/17,SanFrancisco,2.33,1308,22553,0,1624,0,0,Spring,2932,22553,0,True
2016,04/10,SanFrancisco,2.33,1173,22169,0,1798,0,0,Spring,2971,22169,0,True
2016,04/03,SanFrancisco,2.3,1124,21364,0,1566,0,0,Spring,2690,21364,0,True
2016,03/27,SanFrancisco,2.23,1256,22352,0,1983,0,0,Spring,3239,22352,0,True
2016,03/20,SanFrancisco,2.33,1130,21871,0,1712,0,0,Spring,2842,21871,0,True
2016,03/13,SanFrancisco,2.27,1352,22132,0,1744,0,0,Spring,3096,22132,0,True
2016,03/06,SanFrancisco,2.31,1787,22321,0,760,0,0,Spring,2547,22321,0,True
2016,02/28,SanFrancisco,2.29,1143,23000,0,31,0,0,Winter,1174,23000,0,True
2016,02/21,SanFrancisco,2.38,1145,20051,0,53,6,0,Winter,1198,20057,0,True
2016,02/14,SanFrancisco,2.37,1014,20230,0,31,0,0,Winter,1045,20230,0,True
2016,02/07,SanFrancisco,1.93,1240,24785,0,62,0,0,Winter,1302,24785,0,True
2016,01/31,SanFrancisco,2.3,1637,21868,0,86,37,0,Winter,1723,21905,0,True
2016,01/24,SanFrancisco,1.89,1127,22922,0,127,114,0,Winter,1254,23036,0,True
2016,01/17,SanFrancisco,1.95,1127,17731,0,105,18,0,Winter,1232,17749,0,True
2016,01/10,SanFrancisco,1.93,1183,16067,0,233,83,0,Winter,1416,16150,0,True
2016,01/03,SanFrancisco,1.93,1153,17249,0,382,108,0,Winter,1535,17357,0,True
2016,12/25,Seattle,0.81,353,15255,2,548,64164,0,Winter,901,79419,2,True
2016,12/18,Seattle,1.08,373,10784,1,443,34613,0,Winter,816,45397,1,True
2016,12/11,Seattle,1.54,382,8657,1,555,16935,0,Winter,937,25592,1,True
2016,12/04,Seattle,1.45,442,10207,15,534,27698,0,Winter,976,37905,15,True
2016,11/27,Seattle,1.53,321,9807,26,322,26067,0,Fall,643,35874,26,True
2016,11/20,Seattle,1.59,385,10855,3,735,28297,0,Fall,1120,39152,3,True
2016,11/13,Seattle,2.28,541,18490,41,801,9032,0,Fall,1342,27522,41,True
2016,11/06,Seattle,1.69,503,10960,41,600,22997,0,Fall,1103,33957,41,True
2016,10/30,Seattle,2.73,794,11345,23,600,823,0,Fall,1394,12168,23,True
2016,10/23,Seattle,2.24,793,10958,69,688,2562,0,Fall,1481,13520,69,True
2016,10/16,Seattle,1.59,835,10706,10,3017,18538,0,Fall,3852,29244,10,True
2016,10/09,Seattle,1.73,689,9161,0,4318,9503,0,Fall,5007,18664,0,True
2016,10/02,Seattle,1.45,1498,7937,9,3661,22200,0,Fall,5159,30137,9,True
2016,09/25,Seattle,1.69,3798,7157,105,4761,13617,0,Fall,8559,20774,105,True
2016,09/18,Seattle,1.59,5284,5003,259,8769,15688,0,Fall,14053,20691,259,True
2016,09/11,Seattle,1.39,5095,7772,34,6270,22054,0,Fall,11365,29826,34,True
2016,09/04,Seattle,2.09,6158,13584,81,664,1516,0,Fall,6822,15100,81,True
2016,08/28,Seattle,2.24,5595,12638,31,532,73,0,Summer,6127,12711,31,True
2016,08/21,Seattle,1.83,5087,14464,55,10937,66,0,Summer,16024,14530,55,True
2016,08/14,Seattle,2.19,5345,20681,82,1609,466,0,Summer,6954,21147,82,True
2016,08/07,Seattle,1.81,4368,14319,56,4920,7798,0,Summer,9288,22117,56,True
2016,07/31,Seattle,1.34,3816,12705,38,2455,29232,0,Summer,6271,41937,38,True
2016,07/24,Seattle,1.95,2911,18679,77,295,6388,0,Summer,3206,25067,77,True
2016,07/17,Seattle,2.11,1924,25560,35,363,2596,0,Summer,2287,28156,35,True
2016,07/10,Seattle,1.8,1364,25562,40,277,10160,0,Summer,1641,35722,40,True
2016,07/03,Seattle,1.65,1082,27564,56,342,15963,0,Summer,1424,43527,56,True
2016,06/26,Seattle,1.74,813,32449,68,196,7638,0,Summer,1009,40087,68,True
2016,06/19,Seattle,1.75,1015,38691,35,332,804,0,Summer,1347,39495,35,True
2016,06/12,Seattle,1.87,655,26109,51,359,3783,0,Summer,1014,29892,51,True
2016,06/05,Seattle,1.76,625,39556,21,272,471,0,Summer,897,40027,21,True
2016,05/29,Seattle,1.62,625,30792,27,478,7799,0,Spring,1103,38591,27,True
2016,05/22,Seattle,1.55,631,36746,18,262,16047,0,Spring,893,52793,18,True
2016,05/15,Seattle,1.71,739,32468,22,233,9361,0,Spring,972,41829,22,True
2016,05/08,Seattle,1.2,637,24402,31,291,29633,0,Spring,928,54035,31,True
2016,05/01,Seattle,1.25,490,27880,167,280,25563,0,Spring,770,53443,167,True
2016,04/24,Seattle,1.31,667,41604,11,435,20680,0,Spring,1102,62284,11,True
2016,04/17,Seattle,1.51,573,18659,19,367,16777,0,Spring,940,35436,19,True
2016,04/10,Seattle,0.89,608,27403,10,5360,79102,0,Spring,5968,106505,10,True
2016,04/03,Seattle,1.27,614,24201,50,968,23506,0,Spring,1582,47707,50,True
2016,03/27,Seattle,1.55,454,20878,5,443,14824,0,Spring,897,35702,5,True
2016,03/20,Seattle,0.98,474,24602,55,7575,54755,0,Spring,8049,79357,55,True
2016,03/13,Seattle,1.18,409,15023,41,10152,25824,0,Spring,10561,40847,41,True
2016,03/06,Seattle,1.22,583,17846,14,521,20816,0,Spring,1104,38662,14,True
2016,02/28,Seattle,1.46,800,26050,44,2036,8796,0,Winter,2836,34846,44,True
2016,02/21,Seattle,1.41,362,14316,34,1207,13671,0,Winter,1569,27987,34,True
2016,02/14,Seattle,0.98,455,20258,40,1904,48874,0,Winter,2359,69132,40,True
2016,02/07,Seattle,1.26,557,13292,29,7549,11769,0,Winter,8106,25061,29,True
2016,01/31,Seattle,1.36,434,14514,6,4026,14977,0,Winter,4460,29491,6,True
2016,01/24,Seattle,1.47,681,11791,63,244,13736,0,Winter,925,25527,63,True
2016,01/17,Seattle,1.26,560,15954,6,163,25422,0,Winter,723,41376,6,True
2016,01/10,Seattle,1.29,649,16547,6,48,19940,0,Winter,697,36487,6,True
2016,01/03,Seattle,1.58,577,12634,12,14,11529,0,Winter,591,24163,12,True
2016,12/25,SouthCarolina,1.59,293,2329,197,2797,874,0,Winter,3090,3203,197,True
2016,12/18,SouthCarolina,1.5,280,2148,219,3481,1277,0,Winter,3761,3425,219,True
2016,12/11,SouthCarolina,1.49,345,2113,168,3096,1964,0,Winter,3441,4077,168,True
2016,12/04,SouthCarolina,1.69,219,2204,147,2942,1516,0,Winter,3161,3720,147,True
2016,11/27,SouthCarolina,1.77,316,2281,185,3086,1193,0,Fall,3402,3474,185,True
2016,11/20,SouthCarolina,1.7,354,2489,289,5563,1931,0,Fall,5917,4420,289,True
2016,11/13,SouthCarolina,1.73,402,2599,303,5617,1689,0,Fall,6019,4288,303,True
2016,11/06,SouthCarolina,1.67,405,2900,362,4928,2052,0,Fall,5333,4952,362,True
2016,10/30,SouthCarolina,1.73,392,3718,417,2907,1165,0,Fall,3299,4883,417,True
2016,10/23,SouthCarolina,1.4,428,3328,276,3788,3564,0,Fall,4216,6892,276,True
2016,10/16,SouthCarolina,1.55,499,3550,292,2933,2088,0,Fall,3432,5638,292,True
2016,10/09,SouthCarolina,1.6,614,2496,312,4261,1049,0,Fall,4875,3545,312,True
2016,10/02,SouthCarolina,1.87,761,3710,378,3318,172,0,Fall,4079,3882,378,True
2016,09/25,SouthCarolina,1.81,632,3622,306,2172,999,0,Fall,2804,4621,306,True
2016,09/18,SouthCarolina,1.66,479,3496,354,3837,1299,0,Fall,4316,4795,354,True
2016,09/11,SouthCarolina,1.6,757,3868,309,6648,874,0,Fall,7405,4742,309,True
2016,09/04,SouthCarolina,1.6,752,3665,323,5534,1077,0,Fall,6286,4742,323,True
2016,08/28,SouthCarolina,1.51,784,3574,406,6005,1700,0,Summer,6789,5274,406,True
2016,08/21,SouthCarolina,1.6,985,3391,482,7072,661,0,Summer,8057,4052,482,True
2016,08/14,SouthCarolina,1.61,1080,3792,542,6868,1093,0,Summer,7948,4885,542,True
2016,08/07,SouthCarolina,1.42,1102,4761,703,6147,3272,0,Summer,7249,8033,703,True
2016,07/31,SouthCarolina,1.58,1306,3927,705,6131,447,0,Summer,7437,4374,705,True
2016,07/24,SouthCarolina,1.58,1178,3580,616,5785,115,0,Summer,6963,3695,616,True
2016,07/17,SouthCarolina,1.32,1024,3135,681,6516,2558,0,Summer,7540,5693,681,True
2016,07/10,SouthCarolina,1.35,827,3202,616,4928,2034,0,Summer,5755,5236,616,True
2016,07/03,SouthCarolina,1.23,908,3010,683,4096,2369,0,Summer,5004,5379,683,True
2016,06/26,SouthCarolina,1.24,1132,2938,603,5690,2080,0,Summer,6822,5018,603,True
2016,06/19,SouthCarolina,1.21,681,2877,480,2757,2160,0,Summer,3438,5037,480,True
2016,06/12,SouthCarolina,1.31,998,2919,423,3877,1607,0,Summer,4875,4526,423,True
2016,06/05,SouthCarolina,1.31,968,2877,374,5142,1103,0,Summer,6110,3980,374,True
2016,05/29,SouthCarolina,1.41,1076,2749,274,4732,550,0,Spring,5808,3299,274,True
2016,05/22,SouthCarolina,1.45,1000,2448,335,5214,810,0,Spring,6214,3258,335,True
2016,05/15,SouthCarolina,1.48,752,2472,271,6020,473,0,Spring,6772,2945,271,True
2016,05/08,SouthCarolina,1.55,671,2359,315,3150,401,0,Spring,3821,2760,315,True
2016,05/01,SouthCarolina,1.44,669,2362,282,4433,779,0,Spring,5102,3141,282,True
2016,04/24,SouthCarolina,1.49,711,2575,247,5536,223,0,Spring,6247,2798,247,True
2016,04/17,SouthCarolina,1.47,812,2592,324,3937,457,0,Spring,4749,3049,324,True
2016,04/10,SouthCarolina,1.34,631,2514,391,4667,8,0,Spring,5298,2522,391,True
2016,04/03,SouthCarolina,1.37,738,2285,298,3948,64,0,Spring,4686,2349,298,True
2016,03/27,SouthCarolina,1.41,778,2339,242,3388,252,0,Spring,4166,2591,242,True
2016,03/20,SouthCarolina,1.36,714,1976,323,3922,161,0,Spring,4636,2137,323,True
2016,03/13,SouthCarolina,1.45,859,2022,293,2922,38,0,Spring,3781,2060,293,True
2016,03/06,SouthCarolina,1.56,716,1990,254,2267,26,0,Spring,2983,2016,254,True
2016,02/28,SouthCarolina,1.67,619,1867,306,1645,15,0,Winter,2264,1882,306,True
2016,02/21,SouthCarolina,1.58,669,1631,242,2121,87,0,Winter,2790,1718,242,True
2016,02/14,SouthCarolina,1.55,646,1624,248,2178,203,0,Winter,2824,1827,248,True
2016,02/07,SouthCarolina,1.61,573,1792,364,1801,129,0,Winter,2374,1921,364,True
2016,01/31,SouthCarolina,1.54,786,1594,249,2786,128,0,Winter,3572,1722,249,True
2016,01/24,SouthCarolina,1.5,693,1335,362,3458,89,0,Winter,4151,1424,362,True
2016,01/17,SouthCarolina,1.66,844,1613,323,1799,19,0,Winter,2643,1632,323,True
2016,01/10,SouthCarolina,1.6,691,2094,360,2748,212,0,Winter,3439,2306,360,True
2016,01/03,SouthCarolina,1.58,1241,1675,420,2435,120,0,Winter,3676,1795,420,True
2016,12/25,Spokane,0.89,24,1081,0,23,4203,0,Winter,47,5284,0,True
2016,12/18,Spokane,1.03,18,761,0,15,2493,0,Winter,33,3254,0,True
2016,12/11,Spokane,1.38,10,598,0,31,1497,0,Winter,41,2095,0,True
2016,12/04,Spokane,1.48,12,713,0,7,1912,0,Winter,19,2625,0,True
2016,11/27,Spokane,1.33,38,645,0,23,2461,0,Fall,61,3106,0,True
2016,11/20,Spokane,1.67,64,835,0,106,1825,0,Fall,170,2660,0,True
2016,11/13,Spokane,2.35,38,1229,1,43,482,0,Fall,81,1711,1,True
2016,11/06,Spokane,2.02,14,965,0,26,888,0,Fall,40,1853,0,True
2016,10/30,Spokane,2.89,105,907,3,0,28,0,Fall,105,935,3,True
2016,10/23,Spokane,2.23,48,938,5,0,262,0,Fall,48,1200,5,True
2016,10/16,Spokane,1.83,99,918,11,4,1125,0,Fall,103,2043,11,True
2016,10/09,Spokane,2.26,123,853,192,123,499,0,Fall,246,1352,192,True
2016,10/02,Spokane,1.64,155,710,0,144,1375,0,Fall,299,2085,0,True
2016,09/25,Spokane,2.27,299,912,0,54,470,0,Fall,353,1382,0,True
2016,09/18,Spokane,1.51,549,263,0,360,1540,0,Fall,909,1803,0,True
2016,09/11,Spokane,1.53,837,386,0,638,1331,0,Fall,1475,1717,0,True
2016,09/04,Spokane,1.93,645,996,0,22,423,0,Fall,667,1419,0,True
2016,08/28,Spokane,2.51,511,670,0,44,0,0,Summer,555,670,0,True
2016,08/21,Spokane,1.95,706,614,0,765,0,0,Summer,1471,614,0,True
2016,08/14,Spokane,2.25,622,1072,0,99,126,0,Summer,721,1198,0,True
2016,08/07,Spokane,1.64,326,709,0,456,837,0,Summer,782,1546,0,True
2016,07/31,Spokane,1.31,375,563,0,192,1862,0,Summer,567,2425,0,True
2016,07/24,Spokane,2.16,286,1281,0,7,184,0,Summer,293,1465,0,True
2016,07/17,Spokane,2.32,632,1787,0,44,5,0,Summer,676,1792,0,True
2016,07/10,Spokane,2.23,531,1459,0,0,132,0,Summer,531,1591,0,True
2016,07/03,Spokane,1.69,403,1599,0,7,1125,0,Summer,410,2724,0,True
2016,06/26,Spokane,1.76,411,2059,0,22,517,0,Summer,433,2576,0,True
2016,06/19,Spokane,1.75,348,2595,0,7,0,0,Summer,355,2595,0,True
2016,06/12,Spokane,1.89,167,1853,0,0,278,0,Summer,167,2131,0,True
2016,06/05,Spokane,1.91,99,2655,1,0,50,0,Summer,99,2705,1,True
2016,05/29,Spokane,1.64,117,2253,0,0,608,0,Spring,117,2861,0,True
2016,05/22,Spokane,1.49,81,3124,0,0,688,0,Spring,81,3812,0,True
2016,05/15,Spokane,1.61,77,2582,0,0,740,0,Spring,77,3322,0,True
2016,05/08,Spokane,1.41,72,2025,0,0,1443,0,Spring,72,3468,0,True
2016,05/01,Spokane,1.27,29,1749,0,0,1886,0,Spring,29,3635,0,True
2016,04/24,Spokane,1.46,148,4237,1,0,222,0,Spring,148,4459,1,True
2016,04/17,Spokane,1.14,79,1329,0,0,1965,0,Spring,79,3294,0,True
2016,04/10,Spokane,0.85,93,1966,0,0,6517,0,Spring,93,8483,0,True
2016,04/03,Spokane,1.33,100,2792,0,19,1237,0,Spring,119,4029,0,True
2016,03/27,Spokane,1.45,59,1996,1,0,869,0,Spring,59,2865,1,True
2016,03/20,Spokane,1.08,88,1757,0,441,2439,0,Spring,529,4196,0,True
2016,03/13,Spokane,1.28,51,1563,0,237,2184,0,Spring,288,3747,0,True
2016,03/06,Spokane,1.31,78,2007,5,0,1578,0,Spring,78,3585,5,True
2016,02/28,Spokane,1.69,316,3736,55,0,884,0,Winter,316,4620,55,True
2016,02/21,Spokane,1.42,17,1515,0,0,1534,0,Winter,17,3049,0,True
2016,02/14,Spokane,0.98,64,1798,0,146,3980,0,Winter,210,5778,0,True
2016,02/07,Spokane,1.22,59,1319,0,234,1429,0,Winter,293,2748,0,True
2016,01/31,Spokane,1.42,49,1306,0,0,1350,0,Winter,49,2656,0,True
2016,01/24,Spokane,1.52,53,951,5,0,944,0,Winter,53,1895,5,True
2016,01/17,Spokane,1.19,40,1459,3,0,1971,0,Winter,40,3430,3,True
2016,01/10,Spokane,1.2,44,1435,3,0,2044,0,Winter,44,3479,3,True
2016,01/03,Spokane,1.69,75,1380,0,0,946,0,Winter,75,2326,0,True
2016,12/25,StLouis,1.36,1490,349,0,1183,1149,0,Winter,2673,1498,0,True
2016,12/18,StLouis,1.35,2019,548,0,730,2104,0,Winter,2749,2652,0,True
2016,12/11,StLouis,1.53,1761,573,0,947,2075,0,Winter,2708,2648,0,True
2016,12/04,StLouis,1.43,1873,421,0,563,3001,0,Winter,2436,3422,0,True
2016,11/27,StLouis,1.14,1662,372,0,1130,5984,0,Fall,2792,6356,0,True
2016,11/20,StLouis,1.04,1377,537,0,1375,7220,0,Fall,2752,7757,0,True
2016,11/13,StLouis,1.49,1944,545,0,1526,2823,0,Fall,3470,3368,0,True
2016,11/06,StLouis,1.29,2297,404,0,895,3715,0,Fall,3192,4119,0,True
2016,10/30,StLouis,1.0,800,637,0,420,4797,0,Fall,1220,5434,0,True
2016,10/23,StLouis,1.12,2556,835,0,197,7084,0,Fall,2753,7919,0,True
2016,10/16,StLouis,1.6,2383,1980,0,836,3773,0,Fall,3219,5753,0,True
2016,10/09,StLouis,1.23,320,1234,0,1153,5390,0,Fall,1473,6624,0,True
2016,10/02,StLouis,1.23,572,704,0,892,4564,0,Fall,1464,5268,0,True
2016,09/25,StLouis,1.5,1707,708,0,1017,2440,0,Fall,2724,3148,0,True
2016,09/18,StLouis,1.54,2418,838,0,711,2771,0,Fall,3129,3609,0,True
2016,09/11,StLouis,1.52,1134,1259,0,55,2544,0,Fall,1189,3803,0,True
2016,09/04,StLouis,1.06,2817,568,0,55,5063,0,Fall,2872,5631,0,True
2016,08/28,StLouis,1.04,2752,1084,23,550,6465,0,Summer,3302,7549,23,True
2016,08/21,StLouis,1.88,3154,2593,70,2788,10,0,Summer,5942,2603,70,True
2016,08/14,StLouis,1.97,2390,2720,16,1526,354,0,Summer,3916,3074,16,True
2016,08/07,StLouis,1.77,2307,2240,21,3490,3,0,Summer,5797,2243,21,True
2016,07/31,StLouis,1.57,2001,1662,52,5547,6,0,Summer,7548,1668,52,True
2016,07/24,StLouis,1.69,1567,1835,7,3647,0,0,Summer,5214,1835,7,True
2016,07/17,StLouis,2.0,1440,2535,0,1523,0,0,Summer,2963,2535,0,True
2016,07/10,StLouis,1.74,423,1915,0,2716,0,0,Summer,3139,1915,0,True
2016,07/03,StLouis,1.75,398,1834,8,2546,0,0,Summer,2944,1834,8,True
2016,06/26,StLouis,1.74,1646,1916,21,3646,0,0,Summer,5292,1916,21,True
2016,06/19,StLouis,1.83,2678,2060,8,3176,0,0,Summer,5854,2060,8,True
2016,06/12,StLouis,1.72,2197,2158,1,3957,23,0,Summer,6154,2181,1,True
2016,06/05,StLouis,1.96,2336,2701,0,2010,0,0,Summer,4346,2701,0,True
2016,05/29,StLouis,2.2,2177,1738,3,218,13,0,Spring,2395,1751,3,True
2016,05/22,StLouis,2.03,2152,2715,3,304,82,0,Spring,2456,2797,3,True
2016,05/15,StLouis,1.69,2767,1279,0,315,2434,0,Spring,3082,3713,0,True
2016,05/08,StLouis,1.47,1939,608,0,155,2963,0,Spring,2094,3571,0,True
2016,05/01,StLouis,1.3,1408,528,0,0,3215,0,Spring,1408,3743,0,True
2016,04/24,StLouis,0.69,1593,510,5,7,10155,0,Spring,1600,10665,5,True
2016,04/17,StLouis,1.21,1101,422,0,0,2518,0,Spring,1101,2940,0,True
2016,04/10,StLouis,0.58,668,489,0,61,12917,0,Spring,729,13406,0,True
2016,04/03,StLouis,0.75,1433,498,5,11,8934,0,Spring,1444,9432,5,True
2016,03/27,StLouis,0.88,2743,473,0,26,8637,0,Spring,2769,9110,0,True
2016,03/20,StLouis,0.9,1490,578,0,199,10066,0,Spring,1689,10644,0,True
2016,03/13,StLouis,1.1,1855,429,1,66,5386,0,Spring,1921,5815,1,True
2016,03/06,StLouis,1.82,1975,548,1,20,1549,0,Spring,1995,2097,1,True
2016,02/28,StLouis,0.9,2968,629,0,20,7741,0,Winter,2988,8370,0,True
2016,02/21,StLouis,0.82,1078,801,3,20,10479,0,Winter,1098,11280,3,True
2016,02/14,StLouis,1.71,1732,659,0,41,2311,0,Winter,1773,2970,0,True
2016,02/07,StLouis,1.63,1245,640,0,23,2116,0,Winter,1268,2756,0,True
2016,01/31,StLouis,0.91,1065,618,0,28,6334,0,Winter,1093,6952,0,True
2016,01/24,StLouis,0.68,1490,595,5,66,12948,0,Winter,1556,13543,5,True
2016,01/17,StLouis,0.98,1669,655,0,396,5967,0,Winter,2065,6622,0,True
2016,01/10,StLouis,1.42,2159,669,0,926,3232,0,Winter,3085,3901,0,True
2016,01/03,StLouis,0.86,1303,932,5,83,7701,0,Winter,1386,8633,5,True
2016,12/25,Syracuse,1.69,113,147,0,756,0,0,Winter,869,147,0,True
2016,12/18,Syracuse,1.63,11,106,0,988,0,0,Winter,999,106,0,True
2016,12/11,Syracuse,1.77,0,171,0,1391,20,0,Winter,1391,191,0,True
2016,12/04,Syracuse,1.83,0,186,0,1471,29,0,Winter,1471,215,0,True
2016,11/27,Syracuse,1.86,0,101,0,674,0,0,Fall,674,101,0,True
2016,11/20,Syracuse,1.77,3,39,0,1529,0,0,Fall,1532,39,0,True
2016,11/13,Syracuse,1.81,0,67,0,824,0,0,Fall,824,67,0,True
2016,11/06,Syracuse,1.7,1,105,0,1034,0,0,Fall,1035,105,0,True
2016,10/30,Syracuse,1.73,4,57,0,605,0,0,Fall,609,57,0,True
2016,10/23,Syracuse,1.69,0,37,0,923,0,0,Fall,923,37,0,True
2016,10/16,Syracuse,1.61,0,50,0,745,0,0,Fall,745,50,0,True
2016,10/09,Syracuse,1.6,0,68,0,939,0,0,Fall,939,68,0,True
2016,10/02,Syracuse,1.59,0,76,0,1156,0,0,Fall,1156,76,0,True
2016,09/25,Syracuse,1.6,0,97,0,1136,0,0,Fall,1136,97,0,True
2016,09/18,Syracuse,1.51,8,69,0,1875,0,0,Fall,1883,69,0,True
2016,09/11,Syracuse,1.54,6,95,0,1513,0,0,Fall,1519,95,0,True
2016,09/04,Syracuse,1.56,10,107,0,1725,0,0,Fall,1735,107,0,True
2016,08/28,Syracuse,1.54,6,184,0,1549,0,0,Summer,1555,184,0,True
2016,08/21,Syracuse,1.53,7,157,0,2307,0,0,Summer,2314,157,0,True
2016,08/14,Syracuse,1.53,12,124,0,1254,0,0,Summer,1266,124,0,True
2016,08/07,Syracuse,1.54,7,172,0,2112,0,0,Summer,2119,172,0,True
2016,07/31,Syracuse,1.41,7,99,0,1283,100,0,Summer,1290,199,0,True
2016,07/24,Syracuse,1.45,3,159,0,1393,376,0,Summer,1396,535,0,True
2016,07/17,Syracuse,1.6,0,188,0,1618,754,0,Summer,1618,942,0,True
2016,07/10,Syracuse,1.64,0,51,0,2024,796,0,Summer,2024,847,0,True
2016,07/03,Syracuse,1.68,0,111,0,1715,1122,0,Summer,1715,1233,0,True
2016,06/26,Syracuse,1.68,0,103,0,1317,710,0,Summer,1317,813,0,True
2016,06/19,Syracuse,1.71,0,116,0,1246,1218,0,Summer,1246,1334,0,True
2016,06/12,Syracuse,1.49,0,134,0,1384,1272,0,Summer,1384,1406,0,True
2016,06/05,Syracuse,1.42,0,106,0,1899,1051,0,Summer,1899,1157,0,True
2016,05/29,Syracuse,1.55,0,328,0,1246,1339,0,Spring,1246,1667,0,True
2016,05/22,Syracuse,1.45,0,380,0,2410,905,0,Spring,2410,1285,0,True
2016,05/15,Syracuse,1.45,1,162,0,2427,846,0,Spring,2428,1008,0,True
2016,05/08,Syracuse,1.56,0,168,0,2181,1806,0,Spring,2181,1974,0,True
2016,05/01,Syracuse,1.54,0,113,0,1874,1130,0,Spring,1874,1243,0,True
2016,04/24,Syracuse,1.63,0,232,0,1805,1714,0,Spring,1805,1946,0,True
2016,04/17,Syracuse,1.71,0,145,0,889,1291,0,Spring,889,1436,0,True
2016,04/10,Syracuse,1.59,0,155,0,1440,1816,0,Spring,1440,1971,0,True
2016,04/03,Syracuse,1.46,0,75,0,1686,962,0,Spring,1686,1037,0,True
2016,03/27,Syracuse,1.57,0,103,0,1290,1274,0,Spring,1290,1377,0,True
2016,03/20,Syracuse,1.54,0,142,0,1678,1312,0,Spring,1678,1454,0,True
2016,03/13,Syracuse,1.66,0,154,0,889,1313,0,Spring,889,1467,0,True
2016,03/06,Syracuse,2.09,0,225,0,520,1345,0,Spring,520,1570,0,True
2016,02/28,Syracuse,1.62,0,94,0,856,2141,0,Winter,856,2235,0,True
2016,02/21,Syracuse,1.71,0,68,0,900,1420,0,Winter,900,1488,0,True
2016,02/14,Syracuse,1.96,0,141,0,1309,458,0,Winter,1309,599,0,True
2016,02/07,Syracuse,2.06,1,172,0,797,2111,0,Winter,798,2283,0,True
2016,01/31,Syracuse,1.98,0,155,0,642,1074,0,Winter,642,1229,0,True
2016,01/24,Syracuse,1.64,1,113,0,691,2,0,Winter,692,115,0,True
2016,01/17,Syracuse,1.53,6,226,0,1192,52,0,Winter,1198,278,0,True
2016,01/10,Syracuse,1.54,0,138,0,1240,329,0,Winter,1240,467,0,True
2016,01/03,Syracuse,1.46,1,72,0,845,702,0,Winter,846,774,0,True
2016,12/25,Tampa,1.21,254,25,0,3800,2038,0,Winter,4054,2063,0,True
2016,12/18,Tampa,1.22,317,46,0,3796,2120,0,Winter,4113,2166,0,True
2016,12/11,Tampa,1.37,317,16,0,3273,2188,0,Winter,3590,2204,0,True
2016,12/04,Tampa,1.45,306,50,0,2263,2048,0,Winter,2569,2098,0,True
2016,11/27,Tampa,1.47,283,34,0,2350,1855,0,Fall,2633,1889,0,True
2016,11/20,Tampa,1.5,351,41,0,2454,2274,0,Fall,2805,2315,0,True
2016,11/13,Tampa,1.49,324,41,0,3823,2342,0,Fall,4147,2383,0,True
2016,11/06,Tampa,1.52,459,41,0,2370,2553,0,Fall,2829,2594,0,True
2016,10/30,Tampa,1.47,433,62,0,200,2326,0,Fall,633,2388,0,True
2016,10/23,Tampa,1.49,623,89,0,130,2857,0,Fall,753,2946,0,True
2016,10/16,Tampa,1.4,362,40,0,913,1909,0,Fall,1275,1949,0,True
2016,10/09,Tampa,1.58,1007,152,0,1006,1927,0,Fall,2013,2079,0,True
2016,10/02,Tampa,2.29,2573,180,0,650,10,0,Fall,3223,190,0,True
2016,09/25,Tampa,1.51,18,119,0,860,13,0,Fall,878,132,0,True
2016,09/18,Tampa,1.35,28,13,0,3636,26,0,Fall,3664,39,0,True
2016,09/11,Tampa,1.35,19,44,0,4446,30,0,Fall,4465,74,0,True
2016,09/04,Tampa,1.37,77,45,0,4450,70,0,Fall,4527,115,0,True
2016,08/28,Tampa,1.39,114,60,0,3723,40,0,Summer,3837,100,0,True
2016,08/21,Tampa,1.36,50,65,0,4170,60,0,Summer,4220,125,0,True
2016,08/14,Tampa,1.35,49,70,0,4803,73,0,Summer,4852,143,0,True
2016,08/07,Tampa,1.35,11,41,0,3883,60,0,Summer,3894,101,0,True
2016,07/31,Tampa,1.24,22,82,0,4060,56,0,Summer,4082,138,0,True
2016,07/24,Tampa,1.2,12,31,0,5283,23,0,Summer,5295,54,0,True
2016,07/17,Tampa,1.44,733,56,0,3236,36,0,Summer,3969,92,0,True
2016,07/10,Tampa,1.44,1771,195,0,6592,10,0,Summer,8363,205,0,True
2016,07/03,Tampa,1.3,2021,150,0,5661,40,0,Summer,7682,190,0,True
2016,06/26,Tampa,1.5,2331,142,0,3370,23,0,Summer,5701,165,0,True
2016,06/19,Tampa,1.36,1760,128,0,4526,26,0,Summer,6286,154,0,True
2016,06/12,Tampa,1.42,1653,56,0,3390,50,0,Summer,5043,106,0,True
2016,06/05,Tampa,1.36,1429,24,0,4050,50,0,Summer,5479,74,0,True
2016,05/29,Tampa,1.33,1464,23,0,5070,6,0,Spring,6534,29,0,True
2016,05/22,Tampa,1.46,1261,60,0,4057,0,0,Spring,5318,60,0,True
2016,05/15,Tampa,1.5,1207,64,0,3737,0,0,Spring,4944,64,0,True
2016,05/08,Tampa,1.51,1011,74,0,2940,3,0,Spring,3951,77,0,True
2016,05/01,Tampa,1.49,1054,66,0,3680,0,0,Spring,4734,66,0,True
2016,04/24,Tampa,1.47,1134,66,0,3703,0,0,Spring,4837,66,0,True
2016,04/17,Tampa,1.47,1179,62,0,3543,0,0,Spring,4722,62,0,True
2016,04/10,Tampa,1.31,1520,56,0,3934,0,0,Spring,5454,56,0,True
2016,04/03,Tampa,1.37,1777,65,0,3471,0,0,Spring,5248,65,0,True
2016,03/27,Tampa,1.33,1260,31,0,3047,0,0,Spring,4307,31,0,True
2016,03/20,Tampa,1.34,1089,45,0,2517,0,0,Spring,3606,45,0,True
2016,03/13,Tampa,1.28,1128,26,0,3515,0,0,Spring,4643,26,0,True
2016,03/06,Tampa,1.5,1202,44,0,1610,16,0,Spring,2812,60,0,True
2016,02/28,Tampa,1.55,1372,28,0,1772,3,0,Winter,3144,31,0,True
2016,02/21,Tampa,1.46,860,24,0,1764,3,0,Winter,2624,27,0,True
2016,02/14,Tampa,1.48,1163,29,0,2110,0,0,Winter,3273,29,0,True
2016,02/07,Tampa,1.49,1128,16,0,1886,0,0,Winter,3014,16,0,True
2016,01/31,Tampa,1.6,1598,35,0,1563,0,0,Winter,3161,35,0,True
2016,01/24,Tampa,1.44,1147,39,0,2717,3,0,Winter,3864,42,0,True
2016,01/17,Tampa,1.59,1442,35,0,1473,0,0,Winter,2915,35,0,True
2016,01/10,Tampa,1.6,1487,16,0,1770,154,0,Winter,3257,170,0,True
2016,01/03,Tampa,1.08,3979,125,0,1630,5711,0,Winter,5609,5836,0,True
2016,12/25,WestTexNewMexico,1.31,1381,3099,20,12843,38,0,Winter,14224,3137,20,True
2016,12/18,WestTexNewMexico,1.34,945,2571,31,7819,38,0,Winter,8764,2609,31,True
2016,12/11,WestTexNewMexico,1.54,790,3777,60,8510,88,0,Winter,9300,3865,60,True
2016,12/04,WestTexNewMexico,1.82,819,2435,19,6533,86,0,Winter,7352,2521,19,True
2016,11/27,WestTexNewMexico,1.72,1014,2423,0,6307,38,0,Fall,7321,2461,0,True
2016,11/20,WestTexNewMexico,1.75,1377,3897,2,5848,13,0,Fall,7225,3910,2,True
2016,11/13,WestTexNewMexico,1.59,1302,3840,11,9443,69,0,Fall,10745,3909,11,True
2016,11/06,WestTexNewMexico,2.01,1281,5281,8,1804,57,0,Fall,3085,5338,8,True
2016,10/30,WestTexNewMexico,2.57,593,4865,8,176,3,0,Fall,769,4868,8,True
2016,10/23,WestTexNewMexico,2.27,758,3479,11,333,0,0,Fall,1091,3479,11,True
2016,10/16,WestTexNewMexico,2.93,901,3284,8,1146,33,0,Fall,2047,3317,8,True
2016,10/09,WestTexNewMexico,2.35,1319,2864,8,1993,36,0,Fall,3312,2900,8,True
2016,10/02,WestTexNewMexico,2.79,790,3627,14,1116,13,0,Fall,1906,3640,14,True
2016,09/25,WestTexNewMexico,2.83,652,3047,8,1231,45,0,Fall,1883,3092,8,True
2016,09/18,WestTexNewMexico,1.77,1561,2483,5,6399,276,0,Fall,7960,2759,5,True
2016,09/11,WestTexNewMexico,1.87,2037,3390,0,5526,2202,0,Fall,7563,5592,0,True
2016,09/04,WestTexNewMexico,1.82,3062,3324,0,4847,3574,0,Fall,7909,6898,0,True
2016,08/28,WestTexNewMexico,1.69,2630,2321,11,5137,3551,0,Summer,7767,5872,11,True
2016,08/21,WestTexNewMexico,1.76,3349,3122,17,4720,4149,0,Summer,8069,7271,17,True
2016,08/14,WestTexNewMexico,1.72,3292,2737,16,6816,3993,0,Summer,10108,6730,16,True
2016,08/07,WestTexNewMexico,1.78,3788,2995,22,6086,4669,0,Summer,9874,7664,22,True
2016,07/31,WestTexNewMexico,1.84,3381,3234,28,5696,4049,0,Summer,9077,7283,28,True
2016,07/24,WestTexNewMexico,1.99,3853,4310,8,3647,4205,0,Summer,7500,8515,8,True
2016,07/17,WestTexNewMexico,1.89,4933,4562,0,5736,4897,0,Summer,10669,9459,0,True
2016,07/10,WestTexNewMexico,1.65,5754,5221,0,5753,6689,0,Summer,11507,11910,0,True
2016,07/03,WestTexNewMexico,1.43,6310,5419,8,3343,7882,0,Summer,9653,13301,8,True
2016,06/26,WestTexNewMexico,1.38,5547,6169,14,4803,5133,0,Summer,10350,11302,14,True
2016,06/19,WestTexNewMexico,1.37,6836,6446,14,2193,2912,0,Summer,9029,9358,14,True
2016,06/12,WestTexNewMexico,1.36,8202,5855,1465,2191,1804,0,Summer,10393,7659,1465,True
2016,06/05,WestTexNewMexico,1.29,6253,7313,1359,5613,3627,0,Summer,11866,10940,1359,True
2016,05/29,WestTexNewMexico,1.35,4805,25176,7675,6003,3406,0,Spring,10808,28582,7675,True
2016,05/22,WestTexNewMexico,1.36,6703,12464,999,4708,6107,0,Spring,11411,18571,999,True
2016,05/15,WestTexNewMexico,1.25,6329,28751,572,5948,9206,0,Spring,12277,37957,572,True
2016,05/08,WestTexNewMexico,1.1,4759,9207,14337,7111,5829,0,Spring,11870,15036,14337,True
2016,05/01,WestTexNewMexico,1.09,5422,17237,21948,5167,2582,0,Spring,10589,19819,21948,True
2016,04/24,WestTexNewMexico,1.36,2907,25699,262,5774,4124,0,Spring,8681,29823,262,True
2016,04/17,WestTexNewMexico,1.36,2655,25121,177,5036,4895,0,Spring,7691,30016,177,True
2016,04/10,WestTexNewMexico,1.31,3204,7746,111,8558,1939,0,Spring,11762,9685,111,True
2016,04/03,WestTexNewMexico,1.29,2278,6800,58,10538,1022,0,Spring,12816,7822,58,True
2016,03/27,WestTexNewMexico,1.41,2983,6722,53,7268,501,0,Spring,10251,7223,53,True
2016,03/20,WestTexNewMexico,1.47,2731,6730,52,6185,5,0,Spring,8916,6735,52,True
2016,03/13,WestTexNewMexico,1.3,1716,8405,60,8365,64,0,Spring,10081,8469,60,True
2016,03/06,WestTexNewMexico,1.32,2653,5464,14,10704,79,0,Spring,13357,5543,14,True
2016,02/28,WestTexNewMexico,1.36,2064,5044,7,8879,38,0,Winter,10943,5082,7,True
2016,02/21,WestTexNewMexico,1.48,1308,4865,4,7090,1144,0,Winter,8398,6009,4,True
2016,02/14,WestTexNewMexico,1.39,1483,4975,38,6330,2978,0,Winter,7813,7953,38,True
2016,02/07,WestTexNewMexico,1.49,1451,4199,37,7913,110,0,Winter,9364,4309,37,True
2016,01/31,WestTexNewMexico,1.64,1618,4032,2,5957,15,0,Winter,7575,4047,2,True
2016,01/24,WestTexNewMexico,1.47,1554,4656,9,5852,98,0,Winter,7406,4754,9,True
2016,01/17,WestTexNewMexico,1.45,1912,4779,25,6447,72,0,Winter,8359,4851,25,True
2016,01/10,WestTexNewMexico,1.37,1591,4070,23,6780,182,0,Winter,8371,4252,23,True
2016,01/03,WestTexNewMexico,1.58,1820,2783,16,4651,395,0,Winter,6471,3178,16,True
2017,12/31,Albany,1.46,18,198,0,3247,0,0,Winter,3265,198,0,True
2017,12/24,Albany,1.58,31,327,0,3335,0,0,Winter,3366,327,0,True
2017,12/17,Albany,1.43,37,209,0,3267,0,0,Winter,3304,209,0,True
2017,12/10,Albany,1.45,18,262,0,3499,0,0,Winter,3517,262,0,True
2017,12/03,Albany,1.44,118,306,0,3151,0,0,Winter,3269,306,0,True
2017,11/26,Albany,1.57,27,182,0,2631,0,0,Fall,2658,182,0,True
2017,11/19,Albany,1.75,0,252,0,2250,3,0,Fall,2250,255,0,True
2017,11/12,Albany,1.71,0,245,0,2418,0,0,Fall,2418,245,0,True
2017,11/05,Albany,1.5,3,64,0,3358,0,0,Fall,3361,64,0,True
2017,10/29,Albany,1.38,12,180,0,5390,0,0,Fall,5402,180,0,True
2017,10/22,Albany,1.49,3,268,0,4061,3,0,Fall,4064,271,0,True
2017,10/15,Albany,1.47,18,237,0,4266,0,0,Fall,4284,237,0,True
2017,10/08,Albany,1.4,23,341,0,4864,0,0,Fall,4887,341,0,True
2017,10/01,Albany,1.59,31,150,0,3242,0,0,Fall,3273,150,0,True
2017,09/24,Albany,1.42,56,95,0,3475,0,0,Fall,3531,95,0,True
2017,09/17,Albany,1.55,30,215,0,3185,0,0,Fall,3215,215,0,True
2017,09/10,Albany,1.78,45,196,0,2894,3,0,Fall,2939,199,0,True
2017,09/03,Albany,2.0,112,254,0,1655,0,0,Fall,1767,254,0,True
2017,08/27,Albany,1.91,44,210,0,2270,0,0,Summer,2314,210,0,True
2017,08/20,Albany,1.86,61,143,0,2379,0,0,Summer,2440,143,0,True
2017,08/13,Albany,1.9,42,207,0,2009,0,0,Summer,2051,207,0,True
2017,08/06,Albany,1.98,39,331,0,2205,0,0,Summer,2244,331,0,True
2017,07/30,Albany,1.67,55,92,0,2355,0,0,Summer,2410,92,0,True
2017,07/23,Albany,1.42,93,93,0,4046,0,0,Summer,4139,93,0,True
2017,07/16,Albany,1.87,155,274,0,2458,0,0,Summer,2613,274,0,True
2017,07/09,Albany,2.0,38,187,0,1657,0,0,Summer,1695,187,0,True
2017,07/02,Albany,2.03,59,278,0,1931,0,0,Summer,1990,278,0,True
2017,06/25,Albany,2.13,142,295,0,2460,0,0,Summer,2602,295,0,True
2017,06/18,Albany,2.03,366,266,0,2551,0,0,Summer,2917,266,0,True
2017,06/11,Albany,2.04,21,248,0,2449,0,0,Summer,2470,248,0,True
2017,06/04,Albany,1.63,54,352,0,3364,0,0,Summer,3418,352,0,True
2017,05/28,Albany,1.87,11,344,0,3008,0,0,Spring,3019,344,0,True
2017,05/21,Albany,1.84,20,385,0,2778,0,0,Spring,2798,385,0,True
2017,05/14,Albany,1.57,44,450,0,3775,0,0,Spring,3819,450,0,True
2017,05/07,Albany,1.79,89,315,0,2492,0,0,Spring,2581,315,0,True
2017,04/30,Albany,1.74,388,280,0,2377,0,0,Spring,2765,280,0,True
2017,04/23,Albany,1.92,110,182,0,1794,0,0,Spring,1904,182,0,True
2017,04/16,Albany,1.85,265,203,0,2416,0,0,Spring,2681,203,0,True
2017,04/09,Albany,1.92,159,189,0,1860,0,0,Spring,2019,189,0,True
2017,04/02,Albany,1.86,885,362,0,2245,0,0,Spring,3130,362,0,True
2017,03/26,Albany,2.02,166,263,0,1820,0,0,Spring,1986,263,0,True
2017,03/19,Albany,1.87,503,175,0,2084,0,0,Spring,2587,175,0,True
2017,03/12,Albany,1.97,123,206,0,1671,0,0,Spring,1794,206,0,True
2017,03/05,Albany,1.84,241,208,0,1778,0,0,Spring,2019,208,0,True
2017,02/26,Albany,1.71,508,240,0,1437,0,0,Winter,1945,240,0,True
2017,02/19,Albany,1.67,1049,141,0,1332,0,0,Winter,2381,141,0,True
2017,02/12,Albany,1.78,119,170,0,1516,0,0,Winter,1635,170,0,True
2017,02/05,Albany,1.72,26,223,0,1503,0,0,Winter,1529,223,0,True
2017,01/29,Albany,1.86,32,123,0,1640,0,0,Winter,1672,123,0,True
2017,01/22,Albany,1.82,78,128,0,1690,0,0,Winter,1768,128,0,True
2017,01/15,Albany,1.84,82,328,0,1572,0,0,Winter,1654,328,0,True
2017,01/08,Albany,1.94,63,478,0,1687,0,0,Winter,1750,478,0,True
2017,01/01,Albany,1.87,71,192,0,1112,0,0,Winter,1183,192,0,True
2017,12/31,Atlanta,1.28,331,3474,0,11486,1926,0,Winter,11817,5400,0,True
2017,12/24,Atlanta,1.59,443,4328,0,9273,1265,0,Winter,9716,5593,0,True
2017,12/17,Atlanta,1.59,343,3504,0,5440,2260,0,Winter,5783,5764,0,True
2017,12/10,Atlanta,1.63,332,3555,0,5748,3664,0,Winter,6080,7219,0,True
2017,12/03,Atlanta,1.62,380,3883,0,5731,614,0,Winter,6111,4497,0,True
2017,11/26,Atlanta,1.66,344,3863,0,6495,1132,0,Fall,6839,4995,0,True
2017,11/19,Atlanta,1.62,186,4241,0,5612,353,0,Fall,5798,4594,0,True
2017,11/12,Atlanta,1.8,199,4259,0,6474,1182,0,Fall,6673,5441,0,True
2017,11/05,Atlanta,1.86,447,3686,0,5330,2124,0,Fall,5777,5810,0,True
2017,10/29,Atlanta,2.04,319,3788,0,5403,6220,0,Fall,5722,10008,0,True
2017,10/22,Atlanta,2.06,390,4323,0,5432,4205,0,Fall,5822,8528,0,True
2017,10/15,Atlanta,2.23,344,4738,0,5368,953,0,Fall,5712,5691,0,True
2017,10/08,Atlanta,2.55,371,4535,0,6809,558,0,Fall,7180,5093,0,True
2017,10/01,Atlanta,2.75,543,4724,0,4856,3433,0,Fall,5399,8157,0,True
2017,09/24,Atlanta,2.56,507,5068,0,4252,9083,0,Fall,4759,14151,0,True
2017,09/17,Atlanta,2.54,521,5064,0,4932,6774,0,Fall,5453,11838,0,True
2017,09/10,Atlanta,2.59,599,5931,0,4617,2807,0,Fall,5216,8738,0,True
2017,09/03,Atlanta,2.59,538,5588,0,3850,8013,0,Fall,4388,13601,0,True
2017,08/27,Atlanta,2.59,639,6918,0,2356,3996,0,Summer,2995,10914,0,True
2017,08/20,Atlanta,2.18,587,6921,0,8159,1669,0,Summer,8746,8590,0,True
2017,08/13,Atlanta,2.14,516,5399,0,8579,38,0,Summer,9095,5437,0,True
2017,08/06,Atlanta,1.97,451,5641,0,5936,1968,0,Summer,6387,7609,0,True
2017,07/30,Atlanta,1.78,431,6137,0,4879,4052,0,Summer,5310,10189,0,True
2017,07/23,Atlanta,1.85,609,7547,0,4594,4836,0,Summer,5203,12383,0,True
2017,07/16,Atlanta,1.89,471,7657,0,2880,3386,0,Summer,3351,11043,0,True
2017,07/09,Atlanta,1.61,564,10263,0,4751,6542,0,Summer,5315,16805,0,True
2017,07/02,Atlanta,1.53,674,9001,0,3832,9599,0,Summer,4506,18600,0,True
2017,06/25,Atlanta,1.31,607,7832,0,4645,17495,0,Summer,5252,25327,0,True
2017,06/18,Atlanta,1.49,852,9300,0,4532,8800,0,Summer,5384,18100,0,True
2017,06/11,Atlanta,1.06,1251,6518,0,4281,21918,0,Summer,5532,28436,0,True
2017,06/04,Atlanta,1.44,1464,5926,0,2610,10443,0,Summer,4074,16369,0,True
2017,05/28,Atlanta,1.59,1301,6521,0,979,10699,0,Spring,2280,17220,0,True
2017,05/21,Atlanta,1.38,1307,7474,0,1010,12065,0,Spring,2317,19539,0,True
2017,05/14,Atlanta,1.46,988,7007,0,239,7230,0,Spring,1227,14237,0,True
2017,05/07,Atlanta,1.37,338,7980,0,238,9671,0,Spring,576,17651,0,True
2017,04/30,Atlanta,1.59,1487,7556,0,194,5802,0,Spring,1681,13358,0,True
2017,04/23,Atlanta,1.63,1704,7073,0,147,4343,0,Spring,1851,11416,0,True
2017,04/16,Atlanta,1.27,1593,7034,0,278,7504,0,Spring,1871,14538,0,True
2017,04/09,Atlanta,0.91,1358,5782,0,1629,15668,0,Spring,2987,21450,0,True
2017,04/02,Atlanta,1.26,1252,6359,0,636,8694,0,Spring,1888,15053,0,True
2017,03/26,Atlanta,1.27,1653,5804,0,146,8605,0,Spring,1799,14409,0,True
2017,03/19,Atlanta,1.23,1756,4656,0,125,5215,0,Spring,1881,9871,0,True
2017,03/12,Atlanta,0.9,2140,4782,0,189,11449,0,Spring,2329,16231,0,True
2017,03/05,Atlanta,0.62,2078,4175,0,342,25696,0,Spring,2420,29871,0,True
2017,02/26,Atlanta,0.64,1111,3495,0,150,19566,0,Winter,1261,23061,0,True
2017,02/19,Atlanta,1.06,1388,3401,0,85,6991,0,Winter,1473,10392,0,True
2017,02/12,Atlanta,1.07,1085,4061,0,200,5725,0,Winter,1285,9786,0,True
2017,02/05,Atlanta,1.28,1418,4208,0,35,4022,0,Winter,1453,8230,0,True
2017,01/29,Atlanta,1.53,1102,4181,0,5,2040,0,Winter,1107,6221,0,True
2017,01/22,Atlanta,1.62,1121,4738,0,2,1621,0,Winter,1123,6359,0,True
2017,01/15,Atlanta,1.62,1129,3582,0,0,1579,0,Winter,1129,5161,0,True
2017,01/08,Atlanta,1.74,1456,5316,0,0,1471,0,Winter,1456,6787,0,True
2017,01/01,Atlanta,1.81,956,2862,0,5,1517,0,Winter,961,4379,0,True
2017,12/31,BaltimoreWashington,1.53,1177,7959,122,31680,2,0,Winter,32857,7961,122,True
2017,12/24,BaltimoreWashington,1.56,919,5886,89,28639,5,0,Winter,29558,5891,89,True
2017,12/17,BaltimoreWashington,1.58,1256,7053,50,26217,3,0,Winter,27473,7056,50,True
2017,12/10,BaltimoreWashington,1.51,1979,6934,73,32436,26,0,Winter,34415,6960,73,True
2017,12/03,BaltimoreWashington,1.58,1415,7869,76,29382,9,0,Winter,30797,7878,76,True
2017,11/26,BaltimoreWashington,1.69,882,6845,64,23890,5,0,Fall,24772,6850,64,True
2017,11/19,BaltimoreWashington,1.8,839,7176,74,20843,7,0,Fall,21682,7183,74,True
2017,11/12,BaltimoreWashington,1.81,823,7144,105,25558,10,0,Fall,26381,7154,105,True
2017,11/05,BaltimoreWashington,1.84,1134,8053,75,26614,3,0,Fall,27748,8056,75,True
2017,10/29,BaltimoreWashington,1.81,986,9121,99,26934,13,0,Fall,27920,9134,99,True
2017,10/22,BaltimoreWashington,1.64,815,10255,71,36343,1,0,Fall,37158,10256,71,True
2017,10/15,BaltimoreWashington,1.6,939,8821,68,46728,0,0,Fall,47667,8821,68,True
2017,10/08,BaltimoreWashington,1.5,2811,6844,80,57494,3,0,Fall,60305,6847,80,True
2017,10/01,BaltimoreWashington,1.62,2863,5844,56,40203,5,0,Fall,43066,5849,56,True
2017,09/24,BaltimoreWashington,1.53,2666,6252,94,53451,0,0,Fall,56117,6252,94,True
2017,09/17,BaltimoreWashington,1.54,2003,8036,72,49340,0,0,Fall,51343,8036,72,True
2017,09/10,BaltimoreWashington,1.59,2319,8702,102,52159,0,0,Fall,54478,8702,102,True
2017,09/03,BaltimoreWashington,1.68,4534,8344,134,45723,0,0,Fall,50257,8344,134,True
2017,08/27,BaltimoreWashington,1.82,4097,8674,66,28684,0,0,Summer,32781,8674,66,True
2017,08/20,BaltimoreWashington,1.75,924,8272,114,29816,4,0,Summer,30740,8276,114,True
2017,08/13,BaltimoreWashington,1.66,1099,6739,161,32534,0,0,Summer,33633,6739,161,True
2017,08/06,BaltimoreWashington,1.65,1372,10746,148,29420,13,0,Summer,30792,10759,148,True
2017,07/30,BaltimoreWashington,1.6,1117,8371,115,32243,0,0,Summer,33360,8371,115,True
2017,07/23,BaltimoreWashington,1.51,763,8833,131,40588,6,0,Summer,41351,8839,131,True
2017,07/16,BaltimoreWashington,1.57,845,4835,168,32131,0,0,Summer,32976,4835,168,True
2017,07/09,BaltimoreWashington,2.26,1270,7508,197,9685,4,0,Summer,10955,7512,197,True
2017,07/02,BaltimoreWashington,2.2,1028,12582,209,9863,3,0,Summer,10891,12585,209,True
2017,06/25,BaltimoreWashington,2.21,792,11005,179,10461,6,0,Summer,11253,11011,179,True
2017,06/18,BaltimoreWashington,2.2,963,11778,141,9958,3,0,Summer,10921,11781,141,True
2017,06/11,BaltimoreWashington,2.17,1138,11797,140,10531,0,0,Summer,11669,11797,140,True
2017,06/04,BaltimoreWashington,2.15,1029,13920,217,11174,3,0,Summer,12203,13923,217,True
2017,05/28,BaltimoreWashington,2.18,1009,13030,180,10503,5,0,Spring,11512,13035,180,True
2017,05/21,BaltimoreWashington,2.2,1034,10982,206,10985,0,0,Spring,12019,10982,206,True
2017,05/14,BaltimoreWashington,2.11,1025,12713,262,11171,8,0,Spring,12196,12721,262,True
2017,05/07,BaltimoreWashington,2.13,964,9975,229,10561,22,0,Spring,11525,9997,229,True
2017,04/30,BaltimoreWashington,2.15,1412,11979,192,12103,8,0,Spring,13515,11987,192,True
2017,04/23,BaltimoreWashington,2.14,809,11476,188,11661,2,0,Spring,12470,11478,188,True
2017,04/16,BaltimoreWashington,1.96,1248,11853,398,10925,27,0,Spring,12173,11880,398,True
2017,04/09,BaltimoreWashington,1.89,854,10375,269,7604,10,0,Spring,8458,10385,269,True
2017,04/02,BaltimoreWashington,1.97,1558,11581,275,9768,10,0,Spring,11326,11591,275,True
2017,03/26,BaltimoreWashington,1.97,1316,9686,333,9418,16,0,Spring,10734,9702,333,True
2017,03/19,BaltimoreWashington,2.06,1109,7239,227,9943,17,0,Spring,11052,7256,227,True
2017,03/12,BaltimoreWashington,2.12,1146,6980,270,8997,22,0,Spring,10143,7002,270,True
2017,03/05,BaltimoreWashington,1.97,1280,8000,234,8562,5,0,Spring,9842,8005,234,True
2017,02/26,BaltimoreWashington,1.93,1273,7291,302,7897,8,0,Winter,9170,7299,302,True
2017,02/19,BaltimoreWashington,1.81,1775,10428,261,9074,83,0,Winter,10849,10511,261,True
2017,02/12,BaltimoreWashington,1.85,1309,7233,244,9707,101,0,Winter,11016,7334,244,True
2017,02/05,BaltimoreWashington,1.85,1373,6610,202,9782,5,0,Winter,11155,6615,202,True
2017,01/29,BaltimoreWashington,1.85,1050,7816,330,8090,4,0,Winter,9140,7820,330,True
2017,01/22,BaltimoreWashington,1.85,1219,8061,345,8826,33,0,Winter,10045,8094,345,True
2017,01/15,BaltimoreWashington,1.82,1359,8445,294,10651,8,0,Winter,12010,8453,294,True
2017,01/08,BaltimoreWashington,1.85,1325,7679,444,8534,5,0,Winter,9859,7684,444,True
2017,01/01,BaltimoreWashington,1.92,1420,6298,325,5857,0,0,Winter,7277,6298,325,True
2017,12/31,Boise,1.72,78,646,0,213,1079,0,Winter,291,1725,0,True
2017,12/24,Boise,1.44,60,650,0,388,1929,0,Winter,448,2579,0,True
2017,12/17,Boise,1.79,28,552,0,264,952,0,Winter,292,1504,0,True
2017,12/10,Boise,1.76,52,566,0,463,1155,0,Winter,515,1721,0,True
2017,12/03,Boise,1.77,35,386,0,351,1055,0,Winter,386,1441,0,True
2017,11/26,Boise,1.47,49,619,0,402,1661,7,Fall,451,2280,7,True
2017,11/19,Boise,1.85,55,538,0,46,1221,0,Fall,101,1759,0,True
2017,11/12,Boise,1.88,46,484,0,356,981,0,Fall,402,1465,0,True
2017,11/05,Boise,2.33,45,504,0,383,953,0,Fall,428,1457,0,True
2017,10/29,Boise,2.34,51,511,0,382,1016,0,Fall,433,1527,0,True
2017,10/22,Boise,2.41,41,543,0,127,915,4,Fall,168,1458,4,True
2017,10/15,Boise,2.62,34,523,0,119,886,0,Fall,153,1409,0,True
2017,10/08,Boise,2.78,62,573,0,96,922,0,Fall,158,1495,0,True
2017,10/01,Boise,2.79,58,473,0,40,801,0,Fall,98,1274,0,True
2017,09/24,Boise,2.64,63,535,0,75,737,0,Fall,138,1272,0,True
2017,09/17,Boise,2.65,67,563,0,152,707,1,Fall,219,1270,1,True
2017,09/10,Boise,2.63,75,540,0,174,809,0,Fall,249,1349,0,True
2017,09/03,Boise,2.71,110,617,0,133,994,0,Fall,243,1611,0,True
2017,08/27,Boise,2.75,110,503,0,199,829,0,Summer,309,1332,0,True
2017,08/20,Boise,2.62,107,622,0,90,841,0,Summer,197,1463,0,True
2017,08/13,Boise,2.32,71,602,0,186,956,0,Summer,257,1558,0,True
2017,08/06,Boise,2.21,81,596,0,470,942,0,Summer,551,1538,0,True
2017,07/30,Boise,2.21,51,721,0,408,851,0,Summer,459,1572,0,True
2017,07/23,Boise,2.23,52,545,0,481,1117,0,Summer,533,1662,0,True
2017,07/16,Boise,2.26,74,680,0,440,1452,0,Summer,514,2132,0,True
2017,07/09,Boise,1.58,60,767,0,504,2194,0,Summer,564,2961,0,True
2017,07/02,Boise,1.92,41,1111,0,539,1072,0,Summer,580,2183,0,True
2017,06/25,Boise,2.09,53,935,0,575,808,0,Summer,628,1743,0,True
2017,06/18,Boise,1.55,48,744,0,473,1996,0,Summer,521,2740,0,True
2017,06/11,Boise,1.27,24,636,0,558,3155,0,Summer,582,3791,0,True
2017,06/04,Boise,1.27,72,651,0,635,3220,0,Summer,707,3871,0,True
2017,05/28,Boise,1.22,14,683,0,608,3161,0,Spring,622,3844,0,True
2017,05/21,Boise,1.27,15,659,0,557,2663,0,Spring,572,3322,0,True
2017,05/14,Boise,1.27,7,681,0,527,2887,0,Spring,534,3568,0,True
2017,05/07,Boise,1.17,11,634,0,387,3450,0,Spring,398,4084,0,True
2017,04/30,Boise,1.22,19,603,0,496,2823,0,Spring,515,3426,0,True
2017,04/23,Boise,1.23,11,570,0,340,2393,0,Spring,351,2963,0,True
2017,04/16,Boise,1.23,35,568,0,374,2515,0,Spring,409,3083,0,True
2017,04/09,Boise,1.18,17,526,0,370,2601,0,Spring,387,3127,0,True
2017,04/02,Boise,0.82,17,676,0,300,3773,0,Spring,317,4449,0,True
2017,03/26,Boise,0.81,9,541,0,233,3665,0,Spring,242,4206,0,True
2017,03/19,Boise,1.25,6,539,0,454,1665,0,Spring,460,2204,0,True
2017,03/12,Boise,1.16,7,483,0,240,2186,0,Spring,247,2669,0,True
2017,03/05,Boise,0.72,19,603,0,171,3872,0,Spring,190,4475,0,True
2017,02/26,Boise,1.15,21,393,0,659,1875,0,Winter,680,2268,0,True
2017,02/19,Boise,1.65,11,403,0,1166,522,0,Winter,1177,925,0,True
2017,02/12,Boise,1.58,20,426,0,1244,683,0,Winter,1264,1109,0,True
2017,02/05,Boise,0.95,20,321,0,679,2122,0,Winter,699,2443,0,True
2017,01/29,Boise,1.06,15,452,0,623,2121,0,Winter,638,2573,0,True
2017,01/22,Boise,1.06,3,450,0,639,1990,0,Winter,642,2440,0,True
2017,01/15,Boise,1.06,0,457,0,508,2106,0,Winter,508,2563,0,True
2017,01/08,Boise,1.04,3,585,0,632,2916,0,Winter,635,3501,0,True
2017,01/01,Boise,1.05,0,368,0,577,1877,0,Winter,577,2245,0,True
2017,12/31,Boston,1.86,9,2796,0,20109,2360,0,Winter,20118,5156,0,True
2017,12/24,Boston,1.83,29,1723,0,23597,288,0,Winter,23626,2011,0,True
2017,12/17,Boston,1.82,12,1538,0,19173,4179,0,Winter,19185,5717,0,True
2017,12/10,Boston,1.74,14,1541,0,19905,4852,0,Winter,19919,6393,0,True
2017,12/03,Boston,1.88,39,1355,0,18266,1676,0,Winter,18305,3031,0,True
2017,11/26,Boston,1.81,28,1098,0,19514,947,0,Fall,19542,2045,0,True
2017,11/19,Boston,1.81,3,1261,0,21415,3469,0,Fall,21418,4730,0,True
2017,11/12,Boston,1.87,24,1429,0,21304,3389,0,Fall,21328,4818,0,True
2017,11/05,Boston,1.95,14,1535,3,25996,1076,0,Fall,26010,2611,3,True
2017,10/29,Boston,1.83,7,1225,0,32401,376,0,Fall,32408,1601,0,True
2017,10/22,Boston,1.58,16,1569,0,33327,0,0,Fall,33343,1569,0,True
2017,10/15,Boston,1.6,14,1420,0,36442,0,0,Fall,36456,1420,0,True
2017,10/08,Boston,1.56,15,1103,0,28907,17,0,Fall,28922,1120,0,True
2017,10/01,Boston,1.61,17,1127,0,25559,13,0,Fall,25576,1140,0,True
2017,09/24,Boston,1.56,51,952,0,30124,4,0,Fall,30175,956,0,True
2017,09/17,Boston,1.56,7,1268,0,29698,92,0,Fall,29705,1360,0,True
2017,09/10,Boston,1.74,20,1076,0,23213,1169,0,Fall,23233,2245,0,True
2017,09/03,Boston,1.76,26,866,0,20203,1480,0,Fall,20229,2346,0,True
2017,08/27,Boston,1.75,18,1150,0,20161,1009,0,Summer,20179,2159,0,True
2017,08/20,Boston,1.72,10,1256,0,18683,3004,0,Summer,18693,4260,0,True
2017,08/13,Boston,1.77,9,1183,0,15759,1994,0,Summer,15768,3177,0,True
2017,08/06,Boston,1.61,7,1198,0,16162,4669,0,Summer,16169,5867,0,True
2017,07/30,Boston,1.61,7,1303,0,17924,4656,0,Summer,17931,5959,0,True
2017,07/23,Boston,1.59,6,1165,0,23227,4557,0,Summer,23233,5722,0,True
2017,07/16,Boston,1.61,18,1315,0,22172,1994,0,Summer,22190,3309,0,True
2017,07/09,Boston,2.17,9,1693,0,16339,2110,0,Summer,16348,3803,0,True
2017,07/02,Boston,2.13,8,1676,0,16435,1566,0,Summer,16443,3242,0,True
2017,06/25,Boston,2.13,12,1891,0,18533,1613,0,Summer,18545,3504,0,True
2017,06/18,Boston,2.12,16,1617,0,19934,1709,0,Summer,19950,3326,0,True
2017,06/11,Boston,2.07,9,1490,0,17150,1787,0,Summer,17159,3277,0,True
2017,06/04,Boston,2.04,12,1676,0,19576,1659,0,Summer,19588,3335,0,True
2017,05/28,Boston,2.04,20,1658,0,17542,1638,0,Spring,17562,3296,0,True
2017,05/21,Boston,1.92,19,1408,0,18624,2112,0,Spring,18643,3520,0,True
2017,05/14,Boston,1.99,60,1839,0,16626,2588,0,Spring,16686,4427,0,True
2017,05/07,Boston,1.98,82,1772,0,16567,2633,0,Spring,16649,4405,0,True
2017,04/30,Boston,2.02,85,2341,0,14866,570,0,Spring,14951,2911,0,True
2017,04/23,Boston,1.88,138,1028,0,14864,1742,0,Spring,15002,2770,0,True
2017,04/16,Boston,2.0,67,1173,0,14424,1975,0,Spring,14491,3148,0,True
2017,04/09,Boston,2.0,64,1219,0,13774,1974,0,Spring,13838,3193,0,True
2017,04/02,Boston,2.0,80,1392,0,14307,539,0,Spring,14387,1931,0,True
2017,03/26,Boston,2.02,182,1192,0,14681,1251,0,Spring,14863,2443,0,True
2017,03/19,Boston,2.06,154,1066,0,15509,1404,0,Spring,15663,2470,0,True
2017,03/12,Boston,2.09,138,1200,0,15584,1371,0,Spring,15722,2571,0,True
2017,03/05,Boston,1.72,100,1266,0,17340,563,0,Spring,17440,1829,0,True
2017,02/26,Boston,2.01,13,1274,0,12821,462,0,Winter,12834,1736,0,True
2017,02/19,Boston,2.06,13,1014,0,12903,2245,0,Winter,12916,3259,0,True
2017,02/12,Boston,1.95,13,1111,13,15419,1169,0,Winter,15432,2280,13,True
2017,02/05,Boston,1.63,7,2644,38,16906,2653,0,Winter,16913,5297,38,True
2017,01/29,Boston,1.9,8,1127,0,13878,256,0,Winter,13886,1383,0,True
2017,01/22,Boston,1.93,9,969,0,14438,0,0,Winter,14447,969,0,True
2017,01/15,Boston,1.88,12,1315,0,15554,130,0,Winter,15566,1445,0,True
2017,01/08,Boston,1.95,8,1134,0,15137,1275,0,Winter,15145,2409,0,True
2017,01/01,Boston,2.06,14,2181,0,10636,605,0,Winter,10650,2786,0,True
2017,12/31,BuffaloRochester,1.15,176,82,0,5004,5304,0,Winter,5180,5386,0,True
2017,12/24,BuffaloRochester,1.15,233,65,0,9439,1287,0,Winter,9672,1352,0,True
2017,12/17,BuffaloRochester,1.15,196,131,0,3560,6896,0,Winter,3756,7027,0,True
2017,12/10,BuffaloRochester,1.14,198,70,0,3941,6932,0,Winter,4139,7002,0,True
2017,12/03,BuffaloRochester,1.18,101,39,0,3655,3779,0,Winter,3756,3818,0,True
2017,11/26,BuffaloRochester,1.26,216,57,0,4509,496,0,Fall,4725,553,0,True
2017,11/19,BuffaloRochester,1.42,256,68,0,3938,3255,0,Fall,4194,3323,0,True
2017,11/12,BuffaloRochester,1.39,250,105,0,6031,6008,0,Fall,6281,6113,0,True
2017,11/05,BuffaloRochester,1.36,175,92,0,10351,1634,0,Fall,10526,1726,0,True
2017,10/29,BuffaloRochester,1.35,216,114,0,12428,0,0,Fall,12644,114,0,True
2017,10/22,BuffaloRochester,1.35,231,135,0,9744,4,0,Fall,9975,139,0,True
2017,10/15,BuffaloRochester,1.33,158,153,0,12617,0,0,Fall,12775,153,0,True
2017,10/08,BuffaloRochester,1.34,324,148,0,14993,0,0,Fall,15317,148,0,True
2017,10/01,BuffaloRochester,1.39,277,111,0,11092,5,0,Fall,11369,116,0,True
2017,09/24,BuffaloRochester,1.4,277,133,0,9642,28,0,Fall,9919,161,0,True
2017,09/17,BuffaloRochester,1.47,274,139,0,6095,1188,0,Fall,6369,1327,0,True
2017,09/10,BuffaloRochester,1.8,408,156,0,1514,2867,0,Fall,1922,3023,0,True
2017,09/03,BuffaloRochester,1.41,367,160,0,7804,2840,0,Fall,8171,3000,0,True
2017,08/27,BuffaloRochester,1.37,193,181,0,9102,1707,0,Summer,9295,1888,0,True
2017,08/20,BuffaloRochester,1.46,74,227,0,2469,5463,0,Summer,2543,5690,0,True
2017,08/13,BuffaloRochester,1.27,4,416,0,5319,4472,0,Summer,5323,4888,0,True
2017,08/06,BuffaloRochester,1.34,0,311,0,3181,9211,0,Summer,3181,9522,0,True
2017,07/30,BuffaloRochester,1.44,9,451,0,1433,8814,0,Summer,1442,9265,0,True
2017,07/23,BuffaloRochester,1.28,5,427,0,4223,9460,0,Summer,4228,9887,0,True
2017,07/16,BuffaloRochester,1.26,4,446,0,7111,5202,0,Summer,7115,5648,0,True
2017,07/09,BuffaloRochester,2.55,5,393,0,731,4239,0,Summer,736,4632,0,True
2017,07/02,BuffaloRochester,2.57,4,473,0,486,3306,0,Summer,490,3779,0,True
2017,06/25,BuffaloRochester,2.57,15,439,0,636,4136,0,Summer,651,4575,0,True
2017,06/18,BuffaloRochester,2.54,28,544,0,830,4042,0,Summer,858,4586,0,True
2017,06/11,BuffaloRochester,2.46,4,644,0,1073,3442,0,Summer,1077,4086,0,True
2017,06/04,BuffaloRochester,2.51,3,491,0,948,3981,0,Summer,951,4472,0,True
2017,05/28,BuffaloRochester,2.19,0,711,0,980,4020,0,Spring,980,4731,0,True
2017,05/21,BuffaloRochester,2.16,7,843,0,1050,3033,0,Spring,1057,3876,0,True
2017,05/14,BuffaloRochester,2.16,0,548,0,1203,4193,0,Spring,1203,4741,0,True
2017,05/07,BuffaloRochester,2.19,0,650,0,1219,5739,0,Spring,1219,6389,0,True
2017,04/30,BuffaloRochester,2.16,2,508,0,900,2219,0,Spring,902,2727,0,True
2017,04/23,BuffaloRochester,2.14,7,384,0,1181,4351,0,Spring,1188,4735,0,True
2017,04/16,BuffaloRochester,2.14,8,525,0,1313,4139,0,Spring,1321,4664,0,True
2017,04/09,BuffaloRochester,2.17,0,547,0,1003,3463,0,Spring,1003,4010,0,True
2017,04/02,BuffaloRochester,2.09,1,923,0,1180,1232,0,Spring,1181,2155,0,True
2017,03/26,BuffaloRochester,2.16,0,451,0,738,3296,0,Spring,738,3747,0,True
2017,03/19,BuffaloRochester,2.05,2,292,0,973,2346,0,Spring,975,2638,0,True
2017,03/12,BuffaloRochester,2.05,0,286,0,636,1491,0,Spring,636,1777,0,True
2017,03/05,BuffaloRochester,1.89,9,1404,0,910,859,0,Spring,919,2263,0,True
2017,02/26,BuffaloRochester,1.93,4,606,0,966,522,0,Winter,970,1128,0,True
2017,02/19,BuffaloRochester,1.98,0,1112,0,1261,2459,0,Winter,1261,3571,0,True
2017,02/12,BuffaloRochester,1.81,0,369,0,1950,1274,0,Winter,1950,1643,0,True
2017,02/05,BuffaloRochester,1.81,6,258,0,3200,2285,0,Winter,3206,2543,0,True
2017,01/29,BuffaloRochester,1.61,2,347,0,1829,169,0,Winter,1831,516,0,True
2017,01/22,BuffaloRochester,1.5,8,139,0,2440,2,0,Winter,2448,141,0,True
2017,01/15,BuffaloRochester,1.58,7,184,0,3416,549,0,Winter,3423,733,0,True
2017,01/08,BuffaloRochester,1.73,13,175,0,2000,1058,0,Winter,2013,1233,0,True
2017,01/01,BuffaloRochester,1.64,8,320,0,2585,511,0,Winter,2593,831,0,True
2017,12/31,Charlotte,1.71,34,5197,198,6416,91,0,Winter,6450,5288,198,True
2017,12/24,Charlotte,1.83,6,3987,214,4855,0,0,Winter,4861,3987,214,True
2017,12/17,Charlotte,1.86,1,4729,227,4720,0,0,Winter,4721,4729,227,True
2017,12/10,Charlotte,1.91,4,4292,202,5497,6,0,Winter,5501,4298,202,True
2017,12/03,Charlotte,1.9,20,4864,210,4270,192,0,Winter,4290,5056,210,True
2017,11/26,Charlotte,2.11,21,3663,157,4345,298,0,Fall,4366,3961,157,True
2017,11/19,Charlotte,2.13,7,3853,131,3802,123,0,Fall,3809,3976,131,True
2017,11/12,Charlotte,2.15,16,3865,176,4734,255,0,Fall,4750,4120,176,True
2017,11/05,Charlotte,2.22,31,4550,194,4819,222,0,Fall,4850,4772,194,True
2017,10/29,Charlotte,2.02,43,3776,160,7117,146,0,Fall,7160,3922,160,True
2017,10/22,Charlotte,2.08,36,4320,181,6886,145,0,Fall,6922,4465,181,True
2017,10/15,Charlotte,2.38,64,3476,161,6320,172,0,Fall,6384,3648,161,True
2017,10/08,Charlotte,2.67,30,3911,130,5147,178,0,Fall,5177,4089,130,True
2017,10/01,Charlotte,2.82,12,4182,174,3656,250,0,Fall,3668,4432,174,True
2017,09/24,Charlotte,2.55,22,4284,118,5560,389,0,Fall,5582,4673,118,True
2017,09/17,Charlotte,2.77,22,4305,157,4168,166,0,Fall,4190,4471,157,True
2017,09/10,Charlotte,2.8,68,4094,222,5892,9,0,Fall,5960,4103,222,True
2017,09/03,Charlotte,2.82,17,4696,241,5203,152,0,Fall,5220,4848,241,True
2017,08/27,Charlotte,2.83,66,4585,175,4970,3,0,Summer,5036,4588,175,True
2017,08/20,Charlotte,2.48,92,4682,200,5500,6,0,Summer,5592,4688,200,True
2017,08/13,Charlotte,2.35,33,4739,242,5418,4,0,Summer,5451,4743,242,True
2017,08/06,Charlotte,2.36,28,4983,251,5008,0,0,Summer,5036,4983,251,True
2017,07/30,Charlotte,2.07,26,5054,322,3072,0,0,Summer,3098,5054,322,True
2017,07/23,Charlotte,2.0,22,5297,390,3424,0,0,Summer,3446,5297,390,True
2017,07/16,Charlotte,1.99,12,5361,376,3693,3,0,Summer,3705,5364,376,True
2017,07/09,Charlotte,2.06,5,5370,348,3064,0,0,Summer,3069,5370,348,True
2017,07/02,Charlotte,2.09,46,5110,372,2660,4,0,Summer,2706,5114,372,True
2017,06/25,Charlotte,1.99,31,5152,283,3926,10,0,Summer,3957,5162,283,True
2017,06/18,Charlotte,2.03,79,4880,337,3081,3,0,Summer,3160,4883,337,True
2017,06/11,Charlotte,2.15,285,4582,302,4415,0,0,Summer,4700,4582,302,True
2017,06/04,Charlotte,2.47,295,4783,342,1638,0,0,Summer,1933,4783,342,True
2017,05/28,Charlotte,2.5,313,5326,398,1790,426,0,Spring,2103,5752,398,True
2017,05/21,Charlotte,2.48,256,4833,438,1582,173,0,Spring,1838,5006,438,True
2017,05/14,Charlotte,2.21,420,6462,585,1270,266,0,Spring,1690,6728,585,True
2017,05/07,Charlotte,2.31,146,5186,414,1777,558,0,Spring,1923,5744,414,True
2017,04/30,Charlotte,2.53,290,4784,413,1614,126,0,Spring,1904,4910,413,True
2017,04/23,Charlotte,2.58,280,4591,403,1765,0,0,Spring,2045,4591,403,True
2017,04/16,Charlotte,2.05,300,6234,655,1600,7,0,Spring,1900,6241,655,True
2017,04/09,Charlotte,2.02,247,5759,705,1909,193,0,Spring,2156,5952,705,True
2017,04/02,Charlotte,1.95,277,6849,639,1828,724,0,Spring,2105,7573,639,True
2017,03/26,Charlotte,2.01,276,5908,559,1581,398,0,Spring,1857,6306,559,True
2017,03/19,Charlotte,1.96,290,4578,555,270,338,0,Spring,560,4916,555,True
2017,03/12,Charlotte,1.86,226,4485,589,1840,0,0,Spring,2066,4485,589,True
2017,03/05,Charlotte,1.78,330,3724,436,2274,193,0,Spring,2604,3917,436,True
2017,02/26,Charlotte,1.7,220,3918,541,3466,352,0,Winter,3686,4270,541,True
2017,02/19,Charlotte,1.67,299,4076,598,4295,147,0,Winter,4594,4223,598,True
2017,02/12,Charlotte,1.63,148,4040,418,4319,162,0,Winter,4467,4202,418,True
2017,02/05,Charlotte,1.62,140,3540,461,4075,254,0,Winter,4215,3794,461,True
2017,01/29,Charlotte,1.5,131,4705,520,4139,555,0,Winter,4270,5260,520,True
2017,01/22,Charlotte,1.48,92,3486,448,3971,444,0,Winter,4063,3930,448,True
2017,01/15,Charlotte,1.5,148,4643,570,4702,607,0,Winter,4850,5250,570,True
2017,01/08,Charlotte,1.49,235,4456,620,5971,454,0,Winter,6206,4910,620,True
2017,01/01,Charlotte,1.7,120,3134,489,3126,353,0,Winter,3246,3487,489,True
2017,12/31,Chicago,1.79,142,16241,0,9650,6,0,Winter,9792,16247,0,True
2017,12/24,Chicago,1.81,324,21629,0,10483,6,0,Winter,10807,21635,0,True
2017,12/17,Chicago,1.39,946,21147,0,22340,0,0,Winter,23286,21147,0,True
2017,12/10,Chicago,1.65,180,30865,0,9681,6,0,Winter,9861,30871,0,True
2017,12/03,Chicago,1.75,21,24946,0,7209,55,0,Winter,7230,25001,0,True
2017,11/26,Chicago,1.73,35,19019,0,9427,31,0,Fall,9462,19050,0,True
2017,11/19,Chicago,1.79,29,20559,0,7291,17,0,Fall,7320,20576,0,True
2017,11/12,Chicago,2.06,24,25147,0,7733,18,0,Fall,7757,25165,0,True
2017,11/05,Chicago,1.95,24,31160,0,9915,7,0,Fall,9939,31167,0,True
2017,10/29,Chicago,2.06,29,28053,0,7239,11,0,Fall,7268,28064,0,True
2017,10/22,Chicago,2.1,38,23237,0,10491,8,0,Fall,10529,23245,0,True
2017,10/15,Chicago,1.9,24,30172,0,12070,4,0,Fall,12094,30176,0,True
2017,10/08,Chicago,1.8,50,31925,0,12070,7,0,Fall,12120,31932,0,True
2017,10/01,Chicago,1.84,61,25186,0,6656,0,0,Fall,6717,25186,0,True
2017,09/24,Chicago,1.92,110,25900,0,7331,4,0,Fall,7441,25904,0,True
2017,09/17,Chicago,2.13,123,20717,0,7206,0,0,Fall,7329,20717,0,True
2017,09/10,Chicago,1.96,245,17923,0,8311,0,0,Fall,8556,17923,0,True
2017,09/03,Chicago,2.05,107,11896,0,8127,0,0,Fall,8234,11896,0,True
2017,08/27,Chicago,2.11,91,18593,0,7844,0,0,Summer,7935,18593,0,True
2017,08/20,Chicago,1.71,51,5013,0,8824,6,0,Summer,8875,5019,0,True
2017,08/13,Chicago,1.69,65,6949,0,10433,3,0,Summer,10498,6952,0,True
2017,08/06,Chicago,1.74,38,7883,0,5820,0,0,Summer,5858,7883,0,True
2017,07/30,Chicago,1.9,93,31700,0,7248,0,0,Summer,7341,31700,0,True
2017,07/23,Chicago,1.88,87,31152,0,5350,0,0,Summer,5437,31152,0,True
2017,07/16,Chicago,1.83,84,35396,0,8192,0,0,Summer,8276,35396,0,True
2017,07/09,Chicago,1.99,101,33439,0,988,0,0,Summer,1089,33439,0,True
2017,07/02,Chicago,1.98,88,33041,0,1565,0,0,Summer,1653,33041,0,True
2017,06/25,Chicago,1.98,151,33077,0,991,3,0,Summer,1142,33080,0,True
2017,06/18,Chicago,1.98,47,34824,0,1143,0,0,Summer,1190,34824,0,True
2017,06/11,Chicago,1.96,68,42911,0,1880,0,0,Summer,1948,42911,0,True
2017,06/04,Chicago,1.94,41,43896,0,3050,4,0,Summer,3091,43900,0,True
2017,05/28,Chicago,1.93,61,43856,0,4959,0,0,Spring,5020,43856,0,True
2017,05/21,Chicago,1.94,34,40715,0,3841,0,0,Spring,3875,40715,0,True
2017,05/14,Chicago,1.93,71,36510,0,3907,0,0,Spring,3978,36510,0,True
2017,05/07,Chicago,1.95,42,39979,0,2776,0,0,Spring,2818,39979,0,True
2017,04/30,Chicago,1.97,39,44553,0,1680,0,0,Spring,1719,44553,0,True
2017,04/23,Chicago,1.67,144,46354,0,4072,4,0,Spring,4216,46358,0,True
2017,04/16,Chicago,1.74,189,63660,0,4344,0,0,Spring,4533,63660,0,True
2017,04/09,Chicago,1.95,298,53040,0,3685,0,0,Spring,3983,53040,0,True
2017,04/02,Chicago,1.94,538,51259,0,4248,0,0,Spring,4786,51259,0,True
2017,03/26,Chicago,1.67,1252,43428,0,3645,4,0,Spring,4897,43432,0,True
2017,03/19,Chicago,1.68,1720,40737,0,3527,4,0,Spring,5247,40741,0,True
2017,03/12,Chicago,1.93,262,29577,0,3345,0,0,Spring,3607,29577,0,True
2017,03/05,Chicago,1.64,444,42428,0,5011,0,0,Spring,5455,42428,0,True
2017,02/26,Chicago,1.69,799,37768,0,8029,4,0,Winter,8828,37772,0,True
2017,02/19,Chicago,1.6,324,28155,0,8165,0,0,Winter,8489,28155,0,True
2017,02/12,Chicago,1.53,49,32792,0,3028,0,0,Winter,3077,32792,0,True
2017,02/05,Chicago,1.49,82,39288,0,3068,0,0,Winter,3150,39288,0,True
2017,01/29,Chicago,1.51,87,40554,0,4088,4,0,Winter,4175,40558,0,True
2017,01/22,Chicago,1.51,52,43587,0,3921,0,0,Winter,3973,43587,0,True
2017,01/15,Chicago,1.85,78,34378,0,4086,0,0,Winter,4164,34378,0,True
2017,01/08,Chicago,1.81,70,23893,0,4135,0,0,Winter,4205,23893,0,True
2017,01/01,Chicago,1.34,36,34076,0,2802,0,0,Winter,2838,34076,0,True
2017,12/31,CincinnatiDayton,1.36,483,4217,0,7802,1991,0,Winter,8285,6208,0,True
2017,12/24,CincinnatiDayton,1.73,444,5455,0,3411,3907,0,Winter,3855,9362,0,True
2017,12/17,CincinnatiDayton,1.73,371,4597,0,2324,2172,0,Winter,2695,6769,0,True
2017,12/10,CincinnatiDayton,1.69,253,4171,0,2864,949,0,Winter,3117,5120,0,True
2017,12/03,CincinnatiDayton,1.72,184,3716,0,2570,384,0,Winter,2754,4100,0,True
2017,11/26,CincinnatiDayton,1.69,133,2991,0,3958,1382,0,Fall,4091,4373,0,True
2017,11/19,CincinnatiDayton,1.66,293,3450,0,3342,427,0,Fall,3635,3877,0,True
2017,11/12,CincinnatiDayton,1.67,203,3368,0,5085,3614,0,Fall,5288,6982,0,True
2017,11/05,CincinnatiDayton,1.92,194,2940,0,3749,6315,0,Fall,3943,9255,0,True
2017,10/29,CincinnatiDayton,1.87,171,3285,0,3873,4840,0,Fall,4044,8125,0,True
2017,10/22,CincinnatiDayton,1.86,265,3671,0,5671,4874,0,Fall,5936,8545,0,True
2017,10/15,CincinnatiDayton,1.81,258,4239,0,5540,343,0,Fall,5798,4582,0,True
2017,10/08,CincinnatiDayton,1.94,246,4265,0,3897,50,0,Fall,4143,4315,0,True
2017,10/01,CincinnatiDayton,2.01,398,4418,0,6126,1813,0,Fall,6524,6231,0,True
2017,09/24,CincinnatiDayton,2.2,351,3638,0,2048,10019,0,Fall,2399,13657,0,True
2017,09/17,CincinnatiDayton,2.14,294,3982,0,2517,5161,0,Fall,2811,9143,0,True
2017,09/10,CincinnatiDayton,2.15,313,4230,0,2166,3172,0,Fall,2479,7402,0,True
2017,09/03,CincinnatiDayton,2.17,341,3270,0,2220,8131,0,Fall,2561,11401,0,True
2017,08/27,CincinnatiDayton,1.95,270,3292,0,2503,5886,0,Summer,2773,9178,0,True
2017,08/20,CincinnatiDayton,1.92,249,3687,0,1706,2998,0,Summer,1955,6685,0,True
2017,08/13,CincinnatiDayton,1.97,219,4075,0,2701,731,0,Summer,2920,4806,0,True
2017,08/06,CincinnatiDayton,2.06,221,4752,0,3807,2001,0,Summer,4028,6753,0,True
2017,07/30,CincinnatiDayton,1.85,286,6566,0,2278,5603,0,Summer,2564,12169,0,True
2017,07/23,CincinnatiDayton,1.82,364,11735,0,1647,12895,0,Summer,2011,24630,0,True
2017,07/16,CincinnatiDayton,1.82,201,5849,0,2066,14440,0,Summer,2267,20289,0,True
2017,07/09,CincinnatiDayton,1.29,172,4678,0,250,16211,0,Summer,422,20889,0,True
2017,07/02,CincinnatiDayton,1.28,201,4916,0,718,21634,0,Summer,919,26550,0,True
2017,06/25,CincinnatiDayton,1.46,235,4991,0,467,12892,0,Summer,702,17883,0,True
2017,06/18,CincinnatiDayton,1.55,342,8331,0,182,9313,0,Summer,524,17644,0,True
2017,06/11,CincinnatiDayton,0.77,297,5882,0,495,35845,0,Summer,792,41727,0,True
2017,06/04,CincinnatiDayton,1.65,307,4899,0,829,6846,0,Summer,1136,11745,0,True
2017,05/28,CincinnatiDayton,1.78,325,4912,0,975,5946,0,Spring,1300,10858,0,True
2017,05/21,CincinnatiDayton,1.66,257,5819,0,1103,6958,0,Spring,1360,12777,0,True
2017,05/14,CincinnatiDayton,1.41,239,5966,0,802,15287,0,Spring,1041,21253,0,True
2017,05/07,CincinnatiDayton,1.48,287,7274,0,925,11501,0,Spring,1212,18775,0,True
2017,04/30,CincinnatiDayton,1.66,243,4877,0,882,7921,0,Spring,1125,12798,0,True
2017,04/23,CincinnatiDayton,1.92,195,4322,0,1158,2939,0,Spring,1353,7261,0,True
2017,04/16,CincinnatiDayton,0.98,290,4390,0,1115,13472,0,Spring,1405,17862,0,True
2017,04/09,CincinnatiDayton,0.86,252,4493,0,1003,18433,0,Spring,1255,22926,0,True
2017,04/02,CincinnatiDayton,0.83,303,4768,0,996,18957,0,Spring,1299,23725,0,True
2017,03/26,CincinnatiDayton,1.04,244,4884,0,958,17963,0,Spring,1202,22847,0,True
2017,03/19,CincinnatiDayton,1.68,303,6026,0,1116,1771,0,Spring,1419,7797,0,True
2017,03/12,CincinnatiDayton,0.64,325,5300,0,687,23366,0,Spring,1012,28666,0,True
2017,03/05,CincinnatiDayton,0.44,223,4748,0,638,58445,0,Spring,861,63193,0,True
2017,02/26,CincinnatiDayton,0.49,252,4472,0,600,38698,0,Winter,852,43170,0,True
2017,02/19,CincinnatiDayton,0.51,225,5734,0,473,35554,0,Winter,698,41288,0,True
2017,02/12,CincinnatiDayton,0.64,287,6528,0,487,19403,0,Winter,774,25931,0,True
2017,02/05,CincinnatiDayton,0.57,198,4655,0,458,19756,0,Winter,656,24411,0,True
2017,01/29,CincinnatiDayton,0.8,241,4263,0,446,10877,0,Winter,687,15140,0,True
2017,01/22,CincinnatiDayton,1.58,235,4884,0,694,1394,0,Winter,929,6278,0,True
2017,01/15,CincinnatiDayton,1.88,364,5229,0,715,40,0,Winter,1079,5269,0,True
2017,01/08,CincinnatiDayton,1.07,323,6801,0,654,4566,0,Winter,977,11367,0,True
2017,01/01,CincinnatiDayton,1.23,351,8558,0,293,1595,0,Winter,644,10153,0,True
2017,12/31,Columbus,1.14,446,1042,0,13142,1221,0,Winter,13588,2263,0,True
2017,12/24,Columbus,1.54,348,1173,0,4651,919,0,Winter,4999,2092,0,True
2017,12/17,Columbus,1.56,410,1349,1,3876,1001,0,Winter,4286,2350,1,True
2017,12/10,Columbus,1.52,423,1207,0,4523,448,0,Winter,4946,1655,0,True
2017,12/03,Columbus,1.54,412,1265,0,4313,35,0,Winter,4725,1300,0,True
2017,11/26,Columbus,1.54,427,1500,0,5052,756,0,Fall,5479,2256,0,True
2017,11/19,Columbus,1.47,538,1545,0,5289,349,0,Fall,5827,1894,0,True
2017,11/12,Columbus,1.53,590,1463,0,6057,327,0,Fall,6647,1790,0,True
2017,11/05,Columbus,1.67,569,1069,0,5688,151,0,Fall,6257,1220,0,True
2017,10/29,Columbus,1.73,549,1472,0,6422,758,0,Fall,6971,2230,0,True
2017,10/22,Columbus,1.68,546,1829,0,8496,1333,0,Fall,9042,3162,0,True
2017,10/15,Columbus,1.78,583,1787,0,7285,1058,0,Fall,7868,2845,0,True
2017,10/08,Columbus,1.89,583,1941,0,6597,20,0,Fall,7180,1961,0,True
2017,10/01,Columbus,1.91,599,2055,0,6061,635,0,Fall,6660,2690,0,True
2017,09/24,Columbus,2.22,571,1881,0,4142,3893,0,Fall,4713,5774,0,True
2017,09/17,Columbus,2.03,655,1881,0,4019,991,0,Fall,4674,2872,0,True
2017,09/10,Columbus,2.13,647,2091,0,3489,1136,0,Fall,4136,3227,0,True
2017,09/03,Columbus,2.1,525,1736,0,4338,2458,0,Fall,4863,4194,0,True
2017,08/27,Columbus,1.87,547,1241,0,4030,1291,0,Summer,4577,2532,0,True
2017,08/20,Columbus,1.8,580,1815,0,4049,1118,0,Summer,4629,2933,0,True
2017,08/13,Columbus,1.73,745,2180,0,4463,135,0,Summer,5208,2315,0,True
2017,08/06,Columbus,1.72,559,1980,0,4024,1022,0,Summer,4583,3002,0,True
2017,07/30,Columbus,1.61,639,2112,0,4054,2226,0,Summer,4693,4338,0,True
2017,07/23,Columbus,1.73,506,3600,0,2960,5003,0,Summer,3466,8603,0,True
2017,07/16,Columbus,1.69,693,3253,0,3221,3222,0,Summer,3914,6475,0,True
2017,07/09,Columbus,1.38,584,2285,0,1024,5273,0,Summer,1608,7558,0,True
2017,07/02,Columbus,1.46,477,1907,0,1828,4462,0,Summer,2305,6369,0,True
2017,06/25,Columbus,1.28,327,1745,0,418,3551,0,Summer,745,5296,0,True
2017,06/18,Columbus,1.14,463,2943,0,784,4463,0,Summer,1247,7406,0,True
2017,06/11,Columbus,0.83,596,3255,0,1650,15762,0,Summer,2246,19017,0,True
2017,06/04,Columbus,1.44,726,3262,0,2168,4225,0,Summer,2894,7487,0,True
2017,05/28,Columbus,1.51,644,3161,0,2471,6145,0,Spring,3115,9306,0,True
2017,05/21,Columbus,1.44,641,3255,0,1630,4002,0,Spring,2271,7257,0,True
2017,05/14,Columbus,1.64,665,3417,0,2226,1807,0,Spring,2891,5224,0,True
2017,05/07,Columbus,1.61,695,3430,0,1994,3819,0,Spring,2689,7249,0,True
2017,04/30,Columbus,1.7,784,3774,0,2554,3520,0,Spring,3338,7294,0,True
2017,04/23,Columbus,1.63,710,2797,0,2811,1060,0,Spring,3521,3857,0,True
2017,04/16,Columbus,1.03,763,2797,0,2641,7879,0,Spring,3404,10676,0,True
2017,04/09,Columbus,0.97,757,3086,0,2634,6830,0,Spring,3391,9916,0,True
2017,04/02,Columbus,1.39,801,3979,0,2329,2591,0,Spring,3130,6570,0,True
2017,03/26,Columbus,0.72,631,3717,0,2514,15696,0,Spring,3145,19413,0,True
2017,03/19,Columbus,1.5,695,3641,0,2434,1121,0,Spring,3129,4762,0,True
2017,03/12,Columbus,0.83,656,3678,0,2148,10635,0,Spring,2804,14313,0,True
2017,03/05,Columbus,0.52,702,3007,0,1850,26553,0,Spring,2552,29560,0,True
2017,02/26,Columbus,0.66,658,3386,0,1483,14244,0,Winter,2141,17630,0,True
2017,02/19,Columbus,0.74,682,3152,0,1933,11750,0,Winter,2615,14902,0,True
2017,02/12,Columbus,1.0,750,2489,0,1835,5777,0,Winter,2585,8266,0,True
2017,02/05,Columbus,0.98,688,2992,0,1755,4946,0,Winter,2443,7938,0,True
2017,01/29,Columbus,1.49,801,3370,0,2039,760,0,Winter,2840,4130,0,True
2017,01/22,Columbus,0.94,627,2305,0,2082,6243,0,Winter,2709,8548,0,True
2017,01/15,Columbus,1.73,626,2307,0,2172,42,0,Winter,2798,2349,0,True
2017,01/08,Columbus,1.56,579,2132,0,2139,139,0,Winter,2718,2271,0,True
2017,01/01,Columbus,1.58,772,2724,0,2273,177,0,Winter,3045,2901,0,True
2017,12/31,DallasFtWorth,1.48,3745,326,0,15338,1769,0,Winter,19083,2095,0,True
2017,12/24,DallasFtWorth,1.44,4617,479,0,19024,803,0,Winter,23641,1282,0,True
2017,12/17,DallasFtWorth,1.41,3363,338,0,16349,196,0,Winter,19712,534,0,True
2017,12/10,DallasFtWorth,1.53,3195,333,0,9916,3194,0,Winter,13111,3527,0,True
2017,12/03,DallasFtWorth,1.66,4177,330,0,10610,3421,0,Winter,14787,3751,0,True
2017,11/26,DallasFtWorth,1.65,3562,249,0,11661,48,0,Fall,15223,297,0,True
2017,11/19,DallasFtWorth,1.63,5229,295,0,15488,31,0,Fall,20717,326,0,True
2017,11/12,DallasFtWorth,1.7,5898,416,0,13895,34,0,Fall,19793,450,0,True
2017,11/05,DallasFtWorth,1.64,4533,324,0,13307,103,0,Fall,17840,427,0,True
2017,10/29,DallasFtWorth,1.67,4525,322,0,15694,16,0,Fall,20219,338,0,True
2017,10/22,DallasFtWorth,1.69,3989,395,0,14806,23,0,Fall,18795,418,0,True
2017,10/15,DallasFtWorth,1.71,5297,449,0,15504,10,0,Fall,20801,459,0,True
2017,10/08,DallasFtWorth,1.73,5943,470,0,13391,3,0,Fall,19334,473,0,True
2017,10/01,DallasFtWorth,1.7,5442,387,0,15386,3,0,Fall,20828,390,0,True
2017,09/24,DallasFtWorth,1.68,5819,535,0,15146,6,0,Fall,20965,541,0,True
2017,09/17,DallasFtWorth,1.79,6047,554,0,13403,16,0,Fall,19450,570,0,True
2017,09/10,DallasFtWorth,1.81,8554,657,0,15605,13,0,Fall,24159,670,0,True
2017,09/03,DallasFtWorth,1.81,8362,686,0,14294,28,0,Fall,22656,714,0,True
2017,08/27,DallasFtWorth,1.9,7685,483,0,12421,120,0,Summer,20106,603,0,True
2017,08/20,DallasFtWorth,1.8,7818,694,0,12022,614,0,Summer,19840,1308,0,True
2017,08/13,DallasFtWorth,1.68,5364,322,0,13044,94,0,Summer,18408,416,0,True
2017,08/06,DallasFtWorth,1.63,6944,440,0,14378,3,0,Summer,21322,443,0,True
2017,07/30,DallasFtWorth,1.62,7498,747,0,12034,20,0,Summer,19532,767,0,True
2017,07/23,DallasFtWorth,1.57,11038,468,0,9851,18,0,Summer,20889,486,0,True
2017,07/16,DallasFtWorth,1.49,6649,451,0,17684,26,0,Summer,24333,477,0,True
2017,07/09,DallasFtWorth,1.06,8288,577,0,30660,64,0,Summer,38948,641,0,True
2017,07/02,DallasFtWorth,1.02,8791,475,0,23602,83,0,Summer,32393,558,0,True
2017,06/25,DallasFtWorth,1.33,13719,845,0,10240,109,0,Summer,23959,954,0,True
2017,06/18,DallasFtWorth,1.44,9426,1997,0,15370,90,0,Summer,24796,2087,0,True
2017,06/11,DallasFtWorth,1.35,7249,2371,0,18632,140,0,Summer,25881,2511,0,True
2017,06/04,DallasFtWorth,1.08,6369,4490,0,31403,128,0,Summer,37772,4618,0,True
2017,05/28,DallasFtWorth,1.13,5642,6595,0,29825,180,0,Spring,35467,6775,0,True
2017,05/21,DallasFtWorth,1.46,5639,4903,0,18036,102,0,Spring,23675,5005,0,True
2017,05/14,DallasFtWorth,1.45,5498,4103,0,18976,156,0,Spring,24474,4259,0,True
2017,05/07,DallasFtWorth,1.35,5808,3693,0,16631,128,0,Spring,22439,3821,0,True
2017,04/30,DallasFtWorth,1.28,11119,1806,0,14724,117,0,Spring,25843,1923,0,True
2017,04/23,DallasFtWorth,1.34,10749,560,0,10470,177,0,Spring,21219,737,0,True
2017,04/16,DallasFtWorth,1.12,9397,707,0,22882,135,0,Spring,32279,842,0,True
2017,04/09,DallasFtWorth,1.24,11723,530,0,13741,126,0,Spring,25464,656,0,True
2017,04/02,DallasFtWorth,1.41,12593,1272,0,9589,291,0,Spring,22182,1563,0,True
2017,03/26,DallasFtWorth,1.14,9799,501,0,19181,144,0,Spring,28980,645,0,True
2017,03/19,DallasFtWorth,1.1,8489,509,0,17453,226,0,Spring,25942,735,0,True
2017,03/12,DallasFtWorth,1.11,8206,408,0,16288,146,0,Spring,24494,554,0,True
2017,03/05,DallasFtWorth,1.04,8206,345,0,17695,169,0,Spring,25901,514,0,True
2017,02/26,DallasFtWorth,1.05,7437,210,0,21167,129,0,Winter,28604,339,0,True
2017,02/19,DallasFtWorth,1.17,7619,231,0,12433,109,0,Winter,20052,340,0,True
2017,02/12,DallasFtWorth,1.35,9431,235,0,6468,114,0,Winter,15899,349,0,True
2017,02/05,DallasFtWorth,1.3,7770,205,0,9148,44,0,Winter,16918,249,0,True
2017,01/29,DallasFtWorth,1.16,9611,639,0,12862,95,0,Winter,22473,734,0,True
2017,01/22,DallasFtWorth,1.03,6279,1204,0,21974,89,0,Winter,28253,1293,0,True
2017,01/15,DallasFtWorth,1.04,3979,1535,0,13871,86,0,Winter,17850,1621,0,True
2017,01/08,DallasFtWorth,1.02,4931,1063,0,17898,137,0,Winter,22829,1200,0,True
2017,01/01,DallasFtWorth,1.06,4110,312,0,11137,109,0,Winter,15247,421,0,True
2017,12/31,Denver,1.48,4400,482,12,12128,881,0,Winter,16528,1363,12,True
2017,12/24,Denver,1.61,6227,528,30,22304,377,0,Winter,28531,905,30,True
2017,12/17,Denver,1.46,5039,435,42,28941,65,0,Winter,33980,500,42,True
2017,12/10,Denver,1.67,4093,451,49,19803,73,0,Winter,23896,524,49,True
2017,12/03,Denver,1.79,4565,367,16,18830,75,0,Winter,23395,442,16,True
2017,11/26,Denver,2.01,4744,393,85,11998,200,0,Fall,16742,593,85,True
2017,11/19,Denver,2.01,4506,340,16,12689,87,0,Fall,17195,427,16,True
2017,11/12,Denver,1.99,4294,411,20,12014,118,0,Fall,16308,529,20,True
2017,11/05,Denver,2.05,4139,411,35,11030,177,0,Fall,15169,588,35,True
2017,10/29,Denver,2.01,4980,572,26,11256,146,0,Fall,16236,718,26,True
2017,10/22,Denver,1.64,5719,906,75,20034,288,0,Fall,25753,1194,75,True
2017,10/15,Denver,1.55,11990,1114,85,24092,1654,0,Fall,36082,2768,85,True
2017,10/08,Denver,1.97,7350,484,30,14714,139,0,Fall,22064,623,30,True
2017,10/01,Denver,1.93,3685,235,11,6690,10,0,Fall,10375,245,11,True
2017,09/24,Denver,1.69,3286,244,17,3000,6,0,Fall,6286,250,17,True
2017,09/17,Denver,2.02,6551,478,20,14966,13,0,Fall,21517,491,20,True
2017,09/10,Denver,2.06,6045,524,38,16816,123,0,Fall,22861,647,38,True
2017,09/03,Denver,2.02,5319,499,20,12016,83,0,Fall,17335,582,20,True
2017,08/27,Denver,2.16,5403,507,21,14579,63,0,Summer,19982,570,21,True
2017,08/20,Denver,2.11,5178,520,40,11414,184,0,Summer,16592,704,40,True
2017,08/13,Denver,2.08,7525,864,58,13825,100,0,Summer,21350,964,58,True
2017,08/06,Denver,1.95,9900,1086,46,8703,29,0,Summer,18603,1115,46,True
2017,07/30,Denver,1.83,8612,1388,54,11787,82,0,Summer,20399,1470,54,True
2017,07/23,Denver,1.83,8533,3419,214,3899,78,2,Summer,12432,3497,216,True
2017,07/16,Denver,1.83,3638,1154,99,1215,1546,0,Summer,4853,2700,99,True
2017,07/09,Denver,1.94,12539,1475,80,90,723,0,Summer,12629,2198,80,True
2017,07/02,Denver,1.44,11850,2544,61,551,10724,0,Summer,12401,13268,61,True
2017,06/25,Denver,1.17,4521,3679,27,3967,13251,0,Summer,8488,16930,27,True
2017,06/18,Denver,1.25,8640,2043,54,7228,10496,0,Summer,15868,12539,54,True
2017,06/11,Denver,1.97,16512,1809,103,225,264,0,Summer,16737,2073,103,True
2017,06/04,Denver,1.97,13420,1057,45,460,41,0,Summer,13880,1098,45,True
2017,05/28,Denver,1.69,25873,2438,165,303,97,0,Spring,26176,2535,165,True
2017,05/21,Denver,1.38,25044,4244,82,5217,1075,0,Spring,30261,5319,82,True
2017,05/14,Denver,0.74,22355,7368,139,91421,41214,0,Spring,113776,48582,139,True
2017,05/07,Denver,0.9,32779,13318,213,45109,54173,0,Spring,77888,67491,213,True
2017,04/30,Denver,1.24,24513,3402,97,14722,120,0,Spring,39235,3522,97,True
2017,04/23,Denver,0.9,12793,2126,69,47195,200,0,Spring,59988,2326,69,True
2017,04/16,Denver,0.96,16051,2802,111,43314,5386,0,Spring,59365,8188,111,True
2017,04/09,Denver,0.89,11793,2019,76,47908,4022,0,Spring,59701,6041,76,True
2017,04/02,Denver,0.84,9309,2010,57,56838,411,0,Spring,66147,2421,57,True
2017,03/26,Denver,0.85,10129,1677,36,55592,221,0,Spring,65721,1898,36,True
2017,03/19,Denver,0.89,9086,1631,24,39619,284,0,Spring,48705,1915,24,True
2017,03/12,Denver,0.98,14682,2307,33,35069,481,0,Spring,49751,2788,33,True
2017,03/05,Denver,0.94,23363,3586,23,34708,1295,0,Spring,58071,4881,23,True
2017,02/26,Denver,0.78,12233,2065,39,26967,22735,0,Winter,39200,24800,39,True
2017,02/19,Denver,1.16,10979,1473,19,581,21236,0,Winter,11560,22709,19,True
2017,02/12,Denver,1.44,15109,2067,16,224,7364,0,Winter,15333,9431,16,True
2017,02/05,Denver,1.38,9065,1335,20,105,7186,0,Winter,9170,8521,20,True
2017,01/29,Denver,1.49,13842,3182,13,1226,76,0,Winter,15068,3258,13,True
2017,01/22,Denver,0.98,12519,5289,11,8840,2621,0,Winter,21359,7910,11,True
2017,01/15,Denver,0.73,18780,3010,270,15918,12705,0,Winter,34698,15715,270,True
2017,01/08,Denver,0.8,8720,1639,53,3473,25516,0,Winter,12193,27155,53,True
2017,01/01,Denver,0.91,4103,775,5,3485,13078,0,Winter,7588,13853,5,True
2017,12/31,Detroit,1.05,398,2116,0,27997,2264,0,Winter,28395,4380,0,True
2017,12/24,Detroit,1.37,389,2494,0,12812,2509,0,Winter,13201,5003,0,True
2017,12/17,Detroit,1.41,403,2548,0,10946,3036,0,Winter,11349,5584,0,True
2017,12/10,Detroit,1.39,435,2561,0,9555,984,0,Winter,9990,3545,0,True
2017,12/03,Detroit,1.39,403,2628,0,8940,95,0,Winter,9343,2723,0,True
2017,11/26,Detroit,1.43,367,2814,0,11436,1609,0,Fall,11803,4423,0,True
2017,11/19,Detroit,1.37,597,3005,0,11976,438,0,Fall,12573,3443,0,True
2017,11/12,Detroit,1.42,718,2938,0,13814,339,0,Fall,14532,3277,0,True
2017,11/05,Detroit,1.58,518,2512,0,13656,505,0,Fall,14174,3017,0,True
2017,10/29,Detroit,1.65,425,2658,0,15086,2732,0,Fall,15511,5390,0,True
2017,10/22,Detroit,1.61,619,3460,0,14598,2798,0,Fall,15217,6258,0,True
2017,10/15,Detroit,1.69,468,3770,0,14535,1974,0,Fall,15003,5744,0,True
2017,10/08,Detroit,1.82,552,3869,1,14007,45,0,Fall,14559,3914,1,True
2017,10/01,Detroit,1.75,503,3596,0,15555,1980,0,Fall,16058,5576,0,True
2017,09/24,Detroit,2.08,556,3536,0,11223,9028,0,Fall,11779,12564,0,True
2017,09/17,Detroit,1.85,432,3502,0,11092,2406,0,Fall,11524,5908,0,True
2017,09/10,Detroit,1.88,434,4007,0,11927,2846,0,Fall,12361,6853,0,True
2017,09/03,Detroit,1.87,500,2793,0,12468,5925,0,Fall,12968,8718,0,True
2017,08/27,Detroit,1.64,391,2392,0,12233,3383,0,Summer,12624,5775,0,True
2017,08/20,Detroit,1.59,544,3347,0,12819,3342,0,Summer,13363,6689,0,True
2017,08/13,Detroit,1.54,515,3457,0,10115,410,0,Summer,10630,3867,0,True
2017,08/06,Detroit,1.68,572,3106,0,10690,1690,0,Summer,11262,4796,0,True
2017,07/30,Detroit,1.61,507,3352,0,9913,4218,0,Summer,10420,7570,0,True
2017,07/23,Detroit,1.74,603,5510,0,10022,9057,0,Summer,10625,14567,0,True
2017,07/16,Detroit,1.6,666,4375,0,10835,6717,0,Summer,11501,11092,0,True
2017,07/09,Detroit,1.47,532,5228,0,547,11415,0,Summer,1079,16643,0,True
2017,07/02,Detroit,1.44,435,3969,0,343,14987,0,Summer,778,18956,0,True
2017,06/25,Detroit,1.39,478,2992,0,544,9584,0,Summer,1022,12576,0,True
2017,06/18,Detroit,1.51,595,4884,0,318,9438,0,Summer,913,14322,0,True
2017,06/11,Detroit,0.92,447,4744,0,646,32516,0,Summer,1093,37260,0,True
2017,06/04,Detroit,1.75,512,4770,0,920,7920,0,Summer,1432,12690,0,True
2017,05/28,Detroit,1.64,529,4739,0,1096,12027,0,Spring,1625,16766,0,True
2017,05/21,Detroit,1.5,551,4582,0,1342,7254,0,Spring,1893,11836,0,True
2017,05/14,Detroit,1.76,531,5473,0,1319,3533,0,Spring,1850,9006,0,True
2017,05/07,Detroit,1.81,649,5629,0,441,7743,0,Spring,1090,13372,0,True
2017,04/30,Detroit,1.83,582,5993,0,816,7138,0,Spring,1398,13131,0,True
2017,04/23,Detroit,1.79,568,3906,0,1277,2145,0,Spring,1845,6051,0,True
2017,04/16,Detroit,0.93,670,5647,0,966,23974,0,Spring,1636,29621,0,True
2017,04/09,Detroit,0.9,719,5138,0,1008,16385,0,Spring,1727,21523,0,True
2017,04/02,Detroit,1.46,576,4786,0,1028,4874,0,Spring,1604,9660,0,True
2017,03/26,Detroit,0.65,645,5540,0,637,36029,0,Spring,1282,41569,0,True
2017,03/19,Detroit,1.32,729,6016,0,669,4457,0,Spring,1398,10473,0,True
2017,03/12,Detroit,0.7,765,5012,0,749,21068,0,Spring,1514,26080,0,True
2017,03/05,Detroit,0.48,717,4138,0,1385,44649,0,Spring,2102,48787,0,True
2017,02/26,Detroit,0.57,620,4638,0,826,29197,0,Winter,1446,33835,0,True
2017,02/19,Detroit,0.57,822,5987,0,1150,30425,0,Winter,1972,36412,0,True
2017,02/12,Detroit,0.82,766,5919,0,1146,11153,0,Winter,1912,17072,0,True
2017,02/05,Detroit,0.85,741,4326,0,681,10425,0,Winter,1422,14751,0,True
2017,01/29,Detroit,1.54,724,4667,0,770,1688,0,Winter,1494,6355,0,True
2017,01/22,Detroit,0.77,645,4104,0,1331,13370,0,Winter,1976,17474,0,True
2017,01/15,Detroit,1.88,790,6131,0,937,15,0,Winter,1727,6146,0,True
2017,01/08,Detroit,1.74,751,5747,0,973,682,0,Winter,1724,6429,0,True
2017,01/01,Detroit,1.77,593,6565,0,280,106,0,Winter,873,6671,0,True
2017,12/31,GrandRapids,1.28,9,770,0,5991,20,0,Winter,6000,790,0,True
2017,12/24,GrandRapids,1.3,32,1067,0,6660,14,0,Winter,6692,1081,0,True
2017,12/17,GrandRapids,1.28,25,782,0,5965,3,0,Winter,5990,785,0,True
2017,12/10,GrandRapids,1.29,0,729,0,5523,0,0,Winter,5523,729,0,True
2017,12/03,GrandRapids,1.31,14,758,0,5411,0,0,Winter,5425,758,0,True
2017,11/26,GrandRapids,1.3,17,766,0,5344,0,0,Fall,5361,766,0,True
2017,11/19,GrandRapids,1.27,14,611,0,6119,0,0,Fall,6133,611,0,True
2017,11/12,GrandRapids,1.43,37,1159,0,7303,6,0,Fall,7340,1165,0,True
2017,11/05,GrandRapids,1.52,44,3069,0,6355,0,0,Fall,6399,3069,0,True
2017,10/29,GrandRapids,1.32,61,540,0,7122,0,0,Fall,7183,540,0,True
2017,10/22,GrandRapids,1.32,15,686,0,8469,0,0,Fall,8484,686,0,True
2017,10/15,GrandRapids,1.41,15,724,0,7660,0,0,Fall,7675,724,0,True
2017,10/08,GrandRapids,1.51,42,1218,0,7546,0,0,Fall,7588,1218,0,True
2017,10/01,GrandRapids,1.44,42,3419,0,9090,0,0,Fall,9132,3419,0,True
2017,09/24,GrandRapids,1.46,30,978,0,7033,0,0,Fall,7063,978,0,True
2017,09/17,GrandRapids,1.4,44,818,0,7514,0,0,Fall,7558,818,0,True
2017,09/10,GrandRapids,1.4,156,1074,0,6756,33,0,Fall,6912,1107,0,True
2017,09/03,GrandRapids,1.26,124,825,0,8305,18,0,Fall,8429,843,0,True
2017,08/27,GrandRapids,1.21,28,493,0,7516,21,0,Summer,7544,514,0,True
2017,08/20,GrandRapids,1.13,23,35,0,7421,21,0,Summer,7444,56,0,True
2017,08/13,GrandRapids,1.18,39,347,0,7131,15,0,Summer,7170,362,0,True
2017,08/06,GrandRapids,1.29,6,825,0,4408,44,0,Summer,4414,869,0,True
2017,07/30,GrandRapids,1.33,4,1376,0,6772,79,0,Summer,6776,1455,0,True
2017,07/23,GrandRapids,1.27,4,667,0,5767,44,0,Summer,5771,711,0,True
2017,07/16,GrandRapids,1.32,2,1252,0,7785,3,0,Summer,7787,1255,0,True
2017,07/09,GrandRapids,2.19,32,3300,0,6,182,0,Summer,38,3482,0,True
2017,07/02,GrandRapids,1.97,34,4237,0,6,182,0,Summer,40,4419,0,True
2017,06/25,GrandRapids,2.73,7,891,0,6,129,0,Summer,13,1020,0,True
2017,06/18,GrandRapids,2.62,18,1057,0,12,225,0,Summer,30,1282,0,True
2017,06/11,GrandRapids,2.39,0,939,0,85,286,0,Summer,85,1225,0,True
2017,06/04,GrandRapids,2.33,2,903,0,326,156,0,Summer,328,1059,0,True
2017,05/28,GrandRapids,2.44,2,943,0,418,22,0,Spring,420,965,0,True
2017,05/21,GrandRapids,2.34,10,1091,0,576,0,0,Spring,586,1091,0,True
2017,05/14,GrandRapids,2.11,0,1013,0,555,0,0,Spring,555,1013,0,True
2017,05/07,GrandRapids,2.32,0,738,0,86,19,0,Spring,86,757,0,True
2017,04/30,GrandRapids,2.21,2,1052,0,370,26,0,Spring,372,1078,0,True
2017,04/23,GrandRapids,2.13,17,1363,0,716,3,0,Spring,733,1366,0,True
2017,04/16,GrandRapids,2.19,23,1581,0,574,65,0,Spring,597,1646,0,True
2017,04/09,GrandRapids,2.0,43,1224,0,599,171,0,Spring,642,1395,0,True
2017,04/02,GrandRapids,2.07,41,1182,0,614,69,0,Spring,655,1251,0,True
2017,03/26,GrandRapids,2.05,5,1421,0,561,147,0,Spring,566,1568,0,True
2017,03/19,GrandRapids,2.05,27,1593,0,689,84,0,Spring,716,1677,0,True
2017,03/12,GrandRapids,1.94,39,2890,0,1163,52,0,Spring,1202,2942,0,True
2017,03/05,GrandRapids,1.33,127,10247,0,2806,0,0,Spring,2933,10247,0,True
2017,02/26,GrandRapids,1.57,49,4221,0,3560,84,0,Winter,3609,4305,0,True
2017,02/19,GrandRapids,1.64,22,1036,0,803,0,0,Winter,825,1036,0,True
2017,02/12,GrandRapids,1.27,93,3515,0,663,0,0,Winter,756,3515,0,True
2017,02/05,GrandRapids,1.7,54,688,0,369,0,0,Winter,423,688,0,True
2017,01/29,GrandRapids,1.67,47,1079,0,386,112,0,Winter,433,1191,0,True
2017,01/22,GrandRapids,1.52,65,2010,0,616,0,0,Winter,681,2010,0,True
2017,01/15,GrandRapids,1.75,60,973,0,393,0,0,Winter,453,973,0,True
2017,01/08,GrandRapids,1.52,108,1992,0,550,0,0,Winter,658,1992,0,True
2017,01/01,GrandRapids,1.79,84,738,0,263,10,0,Winter,347,748,0,True
2017,12/31,HarrisburgScranton,1.45,138,209,0,18504,4,0,Winter,18642,213,0,True
2017,12/24,HarrisburgScranton,1.46,181,240,0,18638,0,0,Winter,18819,240,0,True
2017,12/17,HarrisburgScranton,1.46,380,287,5,16269,3,0,Winter,16649,290,5,True
2017,12/10,HarrisburgScranton,1.41,237,282,9,19982,4,0,Winter,20219,286,9,True
2017,12/03,HarrisburgScranton,1.46,450,329,5,17313,6,0,Winter,17763,335,5,True
2017,11/26,HarrisburgScranton,1.51,212,235,10,14897,0,0,Fall,15109,235,10,True
2017,11/19,HarrisburgScranton,1.62,176,275,9,13700,0,0,Fall,13876,275,9,True
2017,11/12,HarrisburgScranton,1.56,204,163,6,18711,14,0,Fall,18915,177,6,True
2017,11/05,HarrisburgScranton,1.61,256,154,5,18300,6,0,Fall,18556,160,5,True
2017,10/29,HarrisburgScranton,1.63,215,156,20,16284,0,0,Fall,16499,156,20,True
2017,10/22,HarrisburgScranton,1.48,189,237,6,21090,8,0,Fall,21279,245,6,True
2017,10/15,HarrisburgScranton,1.51,252,166,11,21109,8,0,Fall,21361,174,11,True
2017,10/08,HarrisburgScranton,1.44,236,183,12,25562,1,0,Fall,25798,184,12,True
2017,10/01,HarrisburgScranton,1.5,259,164,6,22313,0,0,Fall,22572,164,6,True
2017,09/24,HarrisburgScranton,1.47,312,164,17,23317,0,0,Fall,23629,164,17,True
2017,09/17,HarrisburgScranton,1.51,298,248,18,20429,0,0,Fall,20727,248,18,True
2017,09/10,HarrisburgScranton,1.51,322,178,7,24150,4,0,Fall,24472,182,7,True
2017,09/03,HarrisburgScranton,1.72,388,311,17,15724,0,0,Fall,16112,311,17,True
2017,08/27,HarrisburgScranton,1.73,234,194,7,13450,0,0,Summer,13684,194,7,True
2017,08/20,HarrisburgScranton,1.68,634,206,23,14240,0,0,Summer,14874,206,23,True
2017,08/13,HarrisburgScranton,1.69,285,243,18,13936,0,0,Summer,14221,243,18,True
2017,08/06,HarrisburgScranton,1.63,253,179,5,13199,3,0,Summer,13452,182,5,True
2017,07/30,HarrisburgScranton,1.59,231,177,9,13673,4,0,Summer,13904,181,9,True
2017,07/23,HarrisburgScranton,1.43,231,221,23,20656,3,0,Summer,20887,224,23,True
2017,07/16,HarrisburgScranton,1.56,184,186,15,16931,0,0,Summer,17115,186,15,True
2017,07/09,HarrisburgScranton,2.23,176,213,14,6759,0,0,Summer,6935,213,14,True
2017,07/02,HarrisburgScranton,2.15,377,265,35,8336,0,0,Summer,8713,265,35,True
2017,06/25,HarrisburgScranton,2.15,249,283,21,8976,0,0,Summer,9225,283,21,True
2017,06/18,HarrisburgScranton,2.09,1032,569,18,9460,24,0,Summer,10492,593,18,True
2017,06/11,HarrisburgScranton,2.27,395,228,1254,10298,52,0,Summer,10693,280,1254,True
2017,06/04,HarrisburgScranton,2.04,863,269,16,9961,60,0,Summer,10824,329,16,True
2017,05/28,HarrisburgScranton,2.19,442,290,15,9185,0,0,Spring,9627,290,15,True
2017,05/21,HarrisburgScranton,2.18,274,237,9,8421,0,0,Spring,8695,237,9,True
2017,05/14,HarrisburgScranton,2.13,282,444,11,9660,0,0,Spring,9942,444,11,True
2017,05/07,HarrisburgScranton,2.08,306,273,8,10166,0,0,Spring,10472,273,8,True
2017,04/30,HarrisburgScranton,2.01,1004,300,11,9031,0,0,Spring,10035,300,11,True
2017,04/23,HarrisburgScranton,2.01,356,464,9,8679,0,0,Spring,9035,464,9,True
2017,04/16,HarrisburgScranton,1.99,928,819,14,9625,32,0,Spring,10553,851,14,True
2017,04/09,HarrisburgScranton,2.06,364,440,13,8234,0,0,Spring,8598,440,13,True
2017,04/02,HarrisburgScranton,1.95,888,665,9,7606,0,0,Spring,8494,665,9,True
2017,03/26,HarrisburgScranton,1.91,388,323,10,9320,0,0,Spring,9708,323,10,True
2017,03/19,HarrisburgScranton,1.93,790,573,17,8982,7,0,Spring,9772,580,17,True
2017,03/12,HarrisburgScranton,2.21,476,345,19,6948,0,0,Spring,7424,345,19,True
2017,03/05,HarrisburgScranton,1.97,948,600,9,7793,12,0,Spring,8741,612,9,True
2017,02/26,HarrisburgScranton,1.84,618,655,14,7322,4,0,Winter,7940,659,14,True
2017,02/19,HarrisburgScranton,1.62,3590,2202,10,7429,32,0,Winter,11019,2234,10,True
2017,02/12,HarrisburgScranton,1.81,414,205,11,8333,44,0,Winter,8747,249,11,True
2017,02/05,HarrisburgScranton,1.83,362,140,6,7677,24,0,Winter,8039,164,6,True
2017,01/29,HarrisburgScranton,1.72,364,195,10,8622,60,0,Winter,8986,255,10,True
2017,01/22,HarrisburgScranton,1.76,356,139,16,7826,20,0,Winter,8182,159,16,True
2017,01/15,HarrisburgScranton,1.88,308,178,9,8134,0,0,Winter,8442,178,9,True
2017,01/08,HarrisburgScranton,1.95,403,226,8,6723,4,0,Winter,7126,230,8,True
2017,01/01,HarrisburgScranton,1.93,255,189,6,5004,0,0,Winter,5259,189,6,True
2017,12/31,HartfordSpringfield,1.9,59,6811,0,8600,0,0,Winter,8659,6811,0,True
2017,12/24,HartfordSpringfield,1.99,448,3902,0,8290,0,0,Winter,8738,3902,0,True
2017,12/17,HartfordSpringfield,1.93,183,3070,0,8784,29,0,Winter,8967,3099,0,True
2017,12/10,HartfordSpringfield,1.81,77,3133,5,10446,27,0,Winter,10523,3160,5,True
2017,12/03,HartfordSpringfield,1.83,288,5155,1,8644,0,0,Winter,8932,5155,1,True
2017,11/26,HartfordSpringfield,1.9,31,2682,0,8827,0,0,Fall,8858,2682,0,True
2017,11/19,HartfordSpringfield,2.09,34,2619,1,8724,0,0,Fall,8758,2619,1,True
2017,11/12,HartfordSpringfield,2.09,36,2880,1,9531,37,0,Fall,9567,2917,1,True
2017,11/05,HartfordSpringfield,2.17,26,3106,2,9090,62,0,Fall,9116,3168,2,True
2017,10/29,HartfordSpringfield,1.98,45,2689,0,10867,48,0,Fall,10912,2737,0,True
2017,10/22,HartfordSpringfield,1.53,35,2862,1,18475,67,0,Fall,18510,2929,1,True
2017,10/15,HartfordSpringfield,1.81,60,2147,4,14397,9,0,Fall,14457,2156,4,True
2017,10/08,HartfordSpringfield,1.93,52,3324,7,13882,79,0,Fall,13934,3403,7,True
2017,10/01,HartfordSpringfield,2.06,72,3318,1,10434,1,0,Fall,10506,3319,1,True
2017,09/24,HartfordSpringfield,1.82,122,3577,0,15912,0,0,Fall,16034,3577,0,True
2017,09/17,HartfordSpringfield,1.96,68,4275,11,14216,0,0,Fall,14284,4275,11,True
2017,09/10,HartfordSpringfield,2.08,87,3878,1,14049,0,0,Fall,14136,3878,1,True
2017,09/03,HartfordSpringfield,2.21,142,3792,0,11020,0,0,Fall,11162,3792,0,True
2017,08/27,HartfordSpringfield,2.4,74,4981,2,8935,0,0,Summer,9009,4981,2,True
2017,08/20,HartfordSpringfield,2.19,333,6341,2,9363,0,0,Summer,9696,6341,2,True
2017,08/13,HartfordSpringfield,2.26,83,4346,0,8889,10,0,Summer,8972,4356,0,True
2017,08/06,HartfordSpringfield,2.11,37,4371,0,9127,12,0,Summer,9164,4383,0,True
2017,07/30,HartfordSpringfield,2.1,72,4282,2,9501,4,0,Summer,9573,4286,2,True
2017,07/23,HartfordSpringfield,1.95,97,4468,8,12887,0,0,Summer,12984,4468,8,True
2017,07/16,HartfordSpringfield,1.94,308,4236,1,10582,0,0,Summer,10890,4236,1,True
2017,07/09,HartfordSpringfield,2.67,43,4563,8,7226,0,0,Summer,7269,4563,8,True
2017,07/02,HartfordSpringfield,2.67,120,5069,35,6515,3,0,Summer,6635,5072,35,True
2017,06/25,HartfordSpringfield,2.61,64,5815,16,6987,0,0,Summer,7051,5815,16,True
2017,06/18,HartfordSpringfield,2.14,549,14022,6,8418,754,0,Summer,8967,14776,6,True
2017,06/11,HartfordSpringfield,2.62,89,4953,13,7752,232,0,Summer,7841,5185,13,True
2017,06/04,HartfordSpringfield,2.5,340,6314,0,8242,87,0,Summer,8582,6401,0,True
2017,05/28,HartfordSpringfield,2.67,148,4613,57,8109,0,0,Spring,8257,4613,57,True
2017,05/21,HartfordSpringfield,2.62,107,4361,12,7752,0,0,Spring,7859,4361,12,True
2017,05/14,HartfordSpringfield,2.58,310,4316,4,7825,0,0,Spring,8135,4316,4,True
2017,05/07,HartfordSpringfield,2.51,198,7086,2,7885,0,0,Spring,8083,7086,2,True
2017,04/30,HartfordSpringfield,2.25,477,10235,15,7839,0,0,Spring,8316,10235,15,True
2017,04/23,HartfordSpringfield,2.49,44,6007,4,7224,3,0,Spring,7268,6010,4,True
2017,04/16,HartfordSpringfield,2.0,997,18975,5,6618,42,0,Spring,7615,19017,5,True
2017,04/09,HartfordSpringfield,2.6,198,4395,12,6439,0,0,Spring,6637,4395,12,True
2017,04/02,HartfordSpringfield,2.42,495,6057,0,6538,30,0,Spring,7033,6087,0,True
2017,03/26,HartfordSpringfield,2.48,173,6545,0,6005,329,0,Spring,6178,6874,0,True
2017,03/19,HartfordSpringfield,2.04,604,17563,45,6460,122,0,Spring,7064,17685,45,True
2017,03/12,HartfordSpringfield,2.57,109,5604,1,7680,0,0,Spring,7789,5604,1,True
2017,03/05,HartfordSpringfield,2.17,255,7325,4,6179,19,0,Spring,6434,7344,4,True
2017,02/26,HartfordSpringfield,2.18,208,7176,1,5968,120,0,Winter,6176,7296,1,True
2017,02/19,HartfordSpringfield,1.56,849,32225,0,6224,679,0,Winter,7073,32904,0,True
2017,02/12,HartfordSpringfield,2.35,45,3547,12,5751,30,0,Winter,5796,3577,12,True
2017,02/05,HartfordSpringfield,1.79,94,7579,23,6806,321,0,Winter,6900,7900,23,True
2017,01/29,HartfordSpringfield,2.43,96,3494,9,5602,209,0,Winter,5698,3703,9,True
2017,01/22,HartfordSpringfield,2.44,101,3410,9,6038,22,0,Winter,6139,3432,9,True
2017,01/15,HartfordSpringfield,2.43,119,4601,6,6277,198,0,Winter,6396,4799,6,True
2017,01/08,HartfordSpringfield,2.43,38,4063,17,5593,167,0,Winter,5631,4230,17,True
2017,01/01,HartfordSpringfield,2.44,152,7697,12,3947,167,0,Winter,4099,7864,12,True
2017,12/31,Houston,1.36,9524,114,0,15635,316,0,Winter,25159,430,0,True
2017,12/24,Houston,1.55,6743,136,0,19811,90,0,Winter,26554,226,0,True
2017,12/17,Houston,1.53,6972,66,0,20577,10,0,Winter,27549,76,0,True
2017,12/10,Houston,1.51,6333,118,0,19911,50,0,Winter,26244,168,0,True
2017,12/03,Houston,1.56,7042,178,0,18166,70,0,Winter,25208,248,0,True
2017,11/26,Houston,1.56,4935,26,0,15429,20,0,Fall,20364,46,0,True
2017,11/19,Houston,1.56,5928,75,0,18955,3,0,Fall,24883,78,0,True
2017,11/12,Houston,1.68,6158,57,0,19085,0,0,Fall,25243,57,0,True
2017,11/05,Houston,1.82,5256,49,0,14847,0,0,Fall,20103,49,0,True
2017,10/29,Houston,1.82,5552,163,0,16652,0,0,Fall,22204,163,0,True
2017,10/22,Houston,1.82,5592,28,0,17568,0,0,Fall,23160,28,0,True
2017,10/15,Houston,1.82,7026,70,0,20309,0,0,Fall,27335,70,0,True
2017,10/08,Houston,1.84,7124,56,0,16519,0,0,Fall,23643,56,0,True
2017,10/01,Houston,1.89,11150,8,0,12429,0,0,Fall,23579,8,0,True
2017,09/24,Houston,1.91,17784,43,0,10449,3,0,Fall,28233,46,0,True
2017,09/17,Houston,1.92,21890,64,0,1320,3,0,Fall,23210,67,0,True
2017,09/10,Houston,1.8,6537,20,0,6377,0,0,Fall,12914,20,0,True
2017,09/03,Houston,1.85,6566,58,0,10207,0,0,Fall,16773,58,0,True
2017,08/27,Houston,1.89,11013,67,0,20189,6,0,Summer,31202,73,0,True
2017,08/20,Houston,1.57,6268,28,0,12565,119,0,Summer,18833,147,0,True
2017,08/13,Houston,1.39,7796,22,0,18327,10,0,Summer,26123,32,0,True
2017,08/06,Houston,1.4,10486,21,0,27247,0,0,Summer,37733,21,0,True
2017,07/30,Houston,1.41,9681,11,0,24541,3,0,Summer,34222,14,0,True
2017,07/23,Houston,1.41,11852,26,0,28221,0,0,Summer,40073,26,0,True
2017,07/16,Houston,1.41,9407,87,0,24087,0,0,Summer,33494,87,0,True
2017,07/09,Houston,1.08,9747,15,0,35612,10,0,Summer,45359,25,0,True
2017,07/02,Houston,1.21,11775,189,0,34210,25,0,Summer,45985,214,0,True
2017,06/25,Houston,1.3,10016,33,0,24814,4,0,Summer,34830,37,0,True
2017,06/18,Houston,1.03,9790,82,0,32199,88,0,Summer,41989,170,0,True
2017,06/11,Houston,1.02,12374,31,0,43269,48,0,Summer,55643,79,0,True
2017,06/04,Houston,1.11,10986,40,0,39413,62,0,Summer,50399,102,0,True
2017,05/28,Houston,1.19,11166,16,0,33339,67,0,Spring,44505,83,0,True
2017,05/21,Houston,1.39,10501,12,0,26523,71,0,Spring,37024,83,0,True
2017,05/14,Houston,1.39,10106,14,0,23749,85,0,Spring,33855,99,0,True
2017,05/07,Houston,1.25,10306,14,0,25913,490,0,Spring,36219,504,0,True
2017,04/30,Houston,1.18,9703,38,0,10563,7813,0,Spring,20266,7851,0,True
2017,04/23,Houston,0.91,9114,69,0,13678,20364,0,Spring,22792,20433,0,True
2017,04/16,Houston,0.88,11936,133,0,48107,84,0,Spring,60043,217,0,True
2017,04/09,Houston,0.93,9013,1885,0,27845,1911,0,Spring,36858,3796,0,True
2017,04/02,Houston,0.92,13047,55,0,39629,141,0,Spring,52676,196,0,True
2017,03/26,Houston,0.9,14157,134,0,47189,71,0,Spring,61346,205,0,True
2017,03/19,Houston,0.87,10922,38,0,39122,802,0,Spring,50044,840,0,True
2017,03/12,Houston,0.92,13678,40,0,18616,20475,0,Spring,32294,20515,0,True
2017,03/05,Houston,0.92,9392,44,0,25806,3496,0,Spring,35198,3540,0,True
2017,02/26,Houston,0.91,10310,22,0,33637,0,0,Winter,43947,22,0,True
2017,02/19,Houston,0.89,8836,167,0,32476,0,0,Winter,41312,167,0,True
2017,02/12,Houston,0.92,8043,57,1,25880,0,0,Winter,33923,57,1,True
2017,02/05,Houston,0.93,7458,18,0,23381,0,0,Winter,30839,18,0,True
2017,01/29,Houston,0.93,7985,303,0,25640,0,0,Winter,33625,303,0,True
2017,01/22,Houston,0.94,8152,748,0,26176,0,0,Winter,34328,748,0,True
2017,01/15,Houston,0.95,8281,13,0,22397,6,0,Winter,30678,19,0,True
2017,01/08,Houston,1.07,9041,47,0,11028,0,0,Winter,20069,47,0,True
2017,01/01,Houston,1.4,7550,58,0,2499,0,0,Winter,10049,58,0,True
2017,12/31,Indianapolis,1.45,200,1231,0,5566,2438,0,Winter,5766,3669,0,True
2017,12/24,Indianapolis,1.4,184,1688,0,5043,1710,0,Winter,5227,3398,0,True
2017,12/17,Indianapolis,1.38,203,1370,0,4720,1994,0,Winter,4923,3364,0,True
2017,12/10,Indianapolis,1.42,119,1112,0,3869,1977,0,Winter,3988,3089,0,True
2017,12/03,Indianapolis,1.42,186,1155,0,5247,1644,0,Winter,5433,2799,0,True
2017,11/26,Indianapolis,1.44,138,1004,0,5150,1145,0,Fall,5288,2149,0,True
2017,11/19,Indianapolis,1.42,96,999,0,3917,1240,0,Fall,4013,2239,0,True
2017,11/12,Indianapolis,1.49,186,1175,0,4912,1949,0,Fall,5098,3124,0,True
2017,11/05,Indianapolis,1.48,141,794,0,5320,1452,0,Fall,5461,2246,0,True
2017,10/29,Indianapolis,1.54,143,1167,0,3953,1237,0,Fall,4096,2404,0,True
2017,10/22,Indianapolis,1.48,129,1196,0,5690,1991,0,Fall,5819,3187,0,True
2017,10/15,Indianapolis,1.57,166,1439,0,7466,1704,0,Fall,7632,3143,0,True
2017,10/08,Indianapolis,1.69,201,1298,0,5440,1496,0,Fall,5641,2794,0,True
2017,10/01,Indianapolis,1.68,154,1188,0,4453,1923,0,Fall,4607,3111,0,True
2017,09/24,Indianapolis,1.75,147,1288,0,3930,2529,0,Fall,4077,3817,0,True
2017,09/17,Indianapolis,1.73,125,1242,0,4410,2656,0,Fall,4535,3898,0,True
2017,09/10,Indianapolis,1.69,136,1330,0,4741,2471,0,Fall,4877,3801,0,True
2017,09/03,Indianapolis,1.73,127,1069,0,4241,3295,0,Fall,4368,4364,0,True
2017,08/27,Indianapolis,1.62,106,1378,0,4350,2392,0,Summer,4456,3770,0,True
2017,08/20,Indianapolis,1.64,101,1173,0,3982,3275,0,Summer,4083,4448,0,True
2017,08/13,Indianapolis,1.41,139,1290,0,5339,2183,0,Summer,5478,3473,0,True
2017,08/06,Indianapolis,1.45,132,1644,0,3840,2929,0,Summer,3972,4573,0,True
2017,07/30,Indianapolis,1.49,91,1707,0,3929,3988,0,Summer,4020,5695,0,True
2017,07/23,Indianapolis,1.6,102,2950,0,2825,4534,0,Summer,2927,7484,0,True
2017,07/16,Indianapolis,1.48,120,3149,0,4037,2676,0,Summer,4157,5825,0,True
2017,07/09,Indianapolis,1.38,74,1186,0,374,5262,0,Summer,448,6448,0,True
2017,07/02,Indianapolis,1.51,137,1251,0,959,5833,0,Summer,1096,7084,0,True
2017,06/25,Indianapolis,1.34,92,1210,0,415,5718,0,Summer,507,6928,0,True
2017,06/18,Indianapolis,1.27,135,1892,0,421,6758,0,Summer,556,8650,0,True
2017,06/11,Indianapolis,0.84,100,1100,0,652,13657,0,Summer,752,14757,0,True
2017,06/04,Indianapolis,1.25,152,1385,0,1178,5952,0,Summer,1330,7337,0,True
2017,05/28,Indianapolis,1.52,153,1467,0,1800,1970,0,Spring,1953,3437,0,True
2017,05/21,Indianapolis,0.92,76,1259,0,2038,5384,0,Spring,2114,6643,0,True
2017,05/14,Indianapolis,1.65,128,1389,0,1694,1019,0,Spring,1822,2408,0,True
2017,05/07,Indianapolis,1.7,137,2384,0,423,1789,0,Spring,560,4173,0,True
2017,04/30,Indianapolis,1.77,169,1505,0,851,370,0,Spring,1020,1875,0,True
2017,04/23,Indianapolis,1.62,174,1385,0,2357,673,0,Spring,2531,2058,0,True
2017,04/16,Indianapolis,1.35,226,1575,0,1685,2963,0,Spring,1911,4538,0,True
2017,04/09,Indianapolis,1.06,301,1339,0,1287,4799,0,Spring,1588,6138,0,True
2017,04/02,Indianapolis,1.37,98,1459,0,1778,2497,0,Spring,1876,3956,0,True
2017,03/26,Indianapolis,1.02,107,1489,0,1398,4710,0,Spring,1505,6199,0,True
2017,03/19,Indianapolis,1.49,131,1404,0,1463,1240,0,Spring,1594,2644,0,True
2017,03/12,Indianapolis,0.93,156,1233,0,1404,5716,0,Spring,1560,6949,0,True
2017,03/05,Indianapolis,1.35,96,1207,0,1370,1973,0,Spring,1466,3180,0,True
2017,02/26,Indianapolis,0.9,107,1165,0,972,4304,0,Winter,1079,5469,0,True
2017,02/19,Indianapolis,1.24,111,1233,0,1370,1322,0,Winter,1481,2555,0,True
2017,02/12,Indianapolis,1.15,785,1389,0,1268,869,0,Winter,2053,2258,0,True
2017,02/05,Indianapolis,1.35,568,1410,0,959,613,0,Winter,1527,2023,0,True
2017,01/29,Indianapolis,1.04,222,1495,0,1209,2644,0,Winter,1431,4139,0,True
2017,01/22,Indianapolis,0.84,139,1459,0,1493,4216,0,Winter,1632,5675,0,True
2017,01/15,Indianapolis,1.31,168,1536,0,1279,1037,0,Winter,1447,2573,0,True
2017,01/08,Indianapolis,1.6,189,1297,0,1278,151,0,Winter,1467,1448,0,True
2017,01/01,Indianapolis,1.76,147,1025,0,614,168,0,Winter,761,1193,0,True
2017,12/31,Jacksonville,1.65,44,496,5,1431,46,0,Winter,1475,542,5,True
2017,12/24,Jacksonville,1.87,80,643,3,1784,1127,0,Winter,1864,1770,3,True
2017,12/17,Jacksonville,1.61,48,519,2,1901,26,0,Winter,1949,545,2,True
2017,12/10,Jacksonville,1.59,56,439,2,2146,1,0,Winter,2202,440,2,True
2017,12/03,Jacksonville,1.8,85,576,2,1448,293,0,Winter,1533,869,2,True
2017,11/26,Jacksonville,1.87,64,550,1,1527,782,0,Fall,1591,1332,1,True
2017,11/19,Jacksonville,1.94,82,757,3,1519,1041,0,Fall,1601,1798,3,True
2017,11/12,Jacksonville,1.89,66,547,2,1792,29,0,Fall,1858,576,2,True
2017,11/05,Jacksonville,2.04,115,890,2,1938,1276,0,Fall,2053,2166,2,True
2017,10/29,Jacksonville,2.16,102,748,4,758,1112,0,Fall,860,1860,4,True
2017,10/22,Jacksonville,2.02,67,531,7,1812,178,0,Fall,1879,709,7,True
2017,10/15,Jacksonville,2.55,60,546,4,806,3,0,Fall,866,549,4,True
2017,10/08,Jacksonville,2.31,54,463,8,1314,0,0,Fall,1368,463,8,True
2017,10/01,Jacksonville,2.99,174,703,12,1736,193,0,Fall,1910,896,12,True
2017,09/24,Jacksonville,2.57,187,1310,0,1314,2228,0,Fall,1501,3538,0,True
2017,09/17,Jacksonville,2.58,226,907,0,786,2072,0,Fall,1012,2979,0,True
2017,09/10,Jacksonville,2.35,195,665,0,2181,1050,0,Fall,2376,1715,0,True
2017,09/03,Jacksonville,2.42,195,675,4,2289,34,0,Fall,2484,709,4,True
2017,08/27,Jacksonville,2.45,332,1007,0,1988,3,0,Summer,2320,1010,0,True
2017,08/20,Jacksonville,2.48,302,1483,2,1067,0,0,Summer,1369,1483,2,True
2017,08/13,Jacksonville,2.0,87,447,3,1222,3,0,Summer,1309,450,3,True
2017,08/06,Jacksonville,2.09,83,489,1,977,0,0,Summer,1060,489,1,True
2017,07/30,Jacksonville,1.78,114,511,0,1784,16,0,Summer,1898,527,0,True
2017,07/23,Jacksonville,2.04,121,583,0,1266,0,0,Summer,1387,583,0,True
2017,07/16,Jacksonville,2.11,73,553,1,1014,3,0,Summer,1087,556,1,True
2017,07/09,Jacksonville,2.06,166,1342,3,1476,0,0,Summer,1642,1342,3,True
2017,07/02,Jacksonville,2.25,435,2975,3,1357,6,0,Summer,1792,2981,3,True
2017,06/25,Jacksonville,2.25,512,2421,0,1149,3,0,Summer,1661,2424,0,True
2017,06/18,Jacksonville,2.23,551,2353,2,1269,1,0,Summer,1820,2354,2,True
2017,06/11,Jacksonville,2.12,984,251,3,1328,0,0,Summer,2312,251,3,True
2017,06/04,Jacksonville,2.2,1263,126,7,3012,0,0,Summer,4275,126,7,True
2017,05/28,Jacksonville,2.09,1322,165,6,4070,222,0,Spring,5392,387,6,True
2017,05/21,Jacksonville,2.07,1260,146,8,3252,387,0,Spring,4512,533,8,True
2017,05/14,Jacksonville,2.22,3021,242,8,1433,2,0,Spring,4454,244,8,True
2017,05/07,Jacksonville,1.75,1182,158,2,620,2023,0,Spring,1802,2181,2,True
2017,04/30,Jacksonville,2.07,1050,127,0,525,771,0,Spring,1575,898,0,True
2017,04/23,Jacksonville,1.72,2785,291,6,1023,19,0,Spring,3808,310,6,True
2017,04/16,Jacksonville,2.07,736,214,11,593,1638,0,Spring,1329,1852,11,True
2017,04/09,Jacksonville,2.07,1083,337,12,424,1084,0,Spring,1507,1421,12,True
2017,04/02,Jacksonville,1.43,780,168,7,3139,2545,0,Spring,3919,2713,7,True
2017,03/26,Jacksonville,1.47,682,192,10,1867,1703,0,Spring,2549,1895,10,True
2017,03/19,Jacksonville,1.58,581,106,5,568,2346,0,Spring,1149,2452,5,True
2017,03/12,Jacksonville,1.7,635,115,5,345,2247,0,Spring,980,2362,5,True
2017,03/05,Jacksonville,1.67,854,95,1,141,1837,0,Spring,995,1932,1,True
2017,02/26,Jacksonville,1.68,749,118,0,323,1968,0,Winter,1072,2086,0,True
2017,02/19,Jacksonville,1.74,857,147,1,1136,1036,0,Winter,1993,1183,1,True
2017,02/12,Jacksonville,1.48,757,137,0,2528,873,0,Winter,3285,1010,0,True
2017,02/05,Jacksonville,1.72,913,112,6,464,1920,0,Winter,1377,2032,6,True
2017,01/29,Jacksonville,1.39,238,58,16,432,2864,0,Winter,670,2922,16,True
2017,01/22,Jacksonville,1.23,296,67,20,1396,3183,0,Winter,1692,3250,20,True
2017,01/15,Jacksonville,1.25,338,97,14,1172,2995,0,Winter,1510,3092,14,True
2017,01/08,Jacksonville,1.26,325,108,0,1050,2595,0,Winter,1375,2703,0,True
2017,01/01,Jacksonville,1.24,245,38,2,910,2511,0,Winter,1155,2549,2,True
2017,12/31,LasVegas,1.55,1479,1733,0,6190,9,0,Winter,7669,1742,0,True
2017,12/24,LasVegas,1.89,1385,1425,0,5555,27,0,Winter,6940,1452,0,True
2017,12/17,LasVegas,1.94,1104,1479,0,4932,24,0,Winter,6036,1503,0,True
2017,12/10,LasVegas,1.68,1318,1602,0,5651,30,0,Winter,6969,1632,0,True
2017,12/03,LasVegas,1.56,1471,1226,0,5330,19,0,Winter,6801,1245,0,True
2017,11/26,LasVegas,1.95,1613,1302,0,3683,0,0,Fall,5296,1302,0,True
2017,11/19,LasVegas,1.95,1387,1452,0,4894,19,0,Fall,6281,1471,0,True
2017,11/12,LasVegas,1.79,1320,1398,0,5504,28,0,Fall,6824,1426,0,True
2017,11/05,LasVegas,1.83,1540,1637,0,3852,4,0,Fall,5392,1641,0,True
2017,10/29,LasVegas,1.93,1136,1084,0,4908,9,0,Fall,6044,1093,0,True
2017,10/22,LasVegas,1.83,1255,358,0,5486,31,0,Fall,6741,389,0,True
2017,10/15,LasVegas,1.99,1113,173,0,4780,65,0,Fall,5893,238,0,True
2017,10/08,LasVegas,2.25,1223,194,0,5038,55,0,Fall,6261,249,0,True
2017,10/01,LasVegas,2.24,1055,115,0,4037,83,0,Fall,5092,198,0,True
2017,09/24,LasVegas,2.25,1048,145,0,4281,16,0,Fall,5329,161,0,True
2017,09/17,LasVegas,2.39,1148,131,0,4200,6,0,Fall,5348,137,0,True
2017,09/10,LasVegas,2.59,1027,1970,0,3968,18,0,Fall,4995,1988,0,True
2017,09/03,LasVegas,2.64,905,1999,0,3120,66,0,Fall,4025,2065,0,True
2017,08/27,LasVegas,2.47,1804,2506,0,6061,37,0,Summer,7865,2543,0,True
2017,08/20,LasVegas,2.43,1214,2783,0,3699,19,0,Summer,4913,2802,0,True
2017,08/13,LasVegas,2.05,913,2538,0,2520,69,0,Summer,3433,2607,0,True
2017,08/06,LasVegas,1.74,1959,2514,0,5623,27,0,Summer,7582,2541,0,True
2017,07/30,LasVegas,1.72,1859,2464,0,6056,42,0,Summer,7915,2506,0,True
2017,07/23,LasVegas,1.89,1379,2862,0,4248,36,0,Summer,5627,2898,0,True
2017,07/16,LasVegas,1.89,1296,2815,0,4443,63,0,Summer,5739,2878,0,True
2017,07/09,LasVegas,1.82,1693,4245,0,4986,304,0,Summer,6679,4549,0,True
2017,07/02,LasVegas,1.73,1952,2930,0,4359,1773,0,Summer,6311,4703,0,True
2017,06/25,LasVegas,1.67,1963,3093,0,2404,3447,0,Summer,4367,6540,0,True
2017,06/18,LasVegas,1.76,1706,3322,0,1909,3414,0,Summer,3615,6736,0,True
2017,06/11,LasVegas,1.74,2058,2749,0,2823,3840,0,Summer,4881,6589,0,True
2017,06/04,LasVegas,1.72,2283,2943,0,4071,4218,0,Summer,6354,7161,0,True
2017,05/28,LasVegas,1.74,1872,2730,1,943,4240,0,Spring,2815,6970,1,True
2017,05/21,LasVegas,1.95,2887,3339,0,753,1690,0,Spring,3640,5029,0,True
2017,05/14,LasVegas,1.89,3039,2852,0,560,1638,0,Spring,3599,4490,0,True
2017,05/07,LasVegas,2.03,2767,3687,0,389,1469,0,Spring,3156,5156,0,True
2017,04/30,LasVegas,1.98,1049,4429,2,437,1626,0,Spring,1486,6055,2,True
2017,04/23,LasVegas,1.67,1121,5184,0,888,2717,0,Spring,2009,7901,0,True
2017,04/16,LasVegas,1.32,1471,3773,0,8550,610,0,Spring,10021,4383,0,True
2017,04/09,LasVegas,1.24,1623,3932,0,11935,84,0,Spring,13558,4016,0,True
2017,04/02,LasVegas,1.19,1691,3619,0,11740,133,0,Spring,13431,3752,0,True
2017,03/26,LasVegas,1.21,1879,4266,0,11468,161,0,Spring,13347,4427,0,True
2017,03/19,LasVegas,1.27,2548,4383,0,7885,2231,0,Spring,10433,6614,0,True
2017,03/12,LasVegas,1.16,2478,4691,0,13805,425,0,Spring,16283,5116,0,True
2017,03/05,LasVegas,1.01,2110,5897,0,12277,416,0,Spring,14387,6313,0,True
2017,02/26,LasVegas,1.09,2174,9684,0,13934,143,0,Winter,16108,9827,0,True
2017,02/19,LasVegas,1.15,1900,3776,0,11577,699,0,Winter,13477,4475,0,True
2017,02/12,LasVegas,1.18,2228,5528,2,14188,29,0,Winter,16416,5557,2,True
2017,02/05,LasVegas,1.23,1662,4924,0,10505,11,0,Winter,12167,4935,0,True
2017,01/29,LasVegas,1.31,1129,3211,9,7258,29,0,Winter,8387,3240,9,True
2017,01/22,LasVegas,1.34,1117,3189,0,5992,12,0,Winter,7109,3201,0,True
2017,01/15,LasVegas,1.39,941,2918,0,5582,0,0,Winter,6523,2918,0,True
2017,01/08,LasVegas,1.22,1287,2376,0,6938,39,0,Winter,8225,2415,0,True
2017,01/01,LasVegas,1.36,997,2950,0,5478,136,0,Winter,6475,3086,0,True
2017,12/31,LosAngeles,1.74,15369,20722,0,42693,86,0,Winter,58062,20808,0,True
2017,12/24,LosAngeles,1.8,8580,24465,0,36706,51,0,Winter,45286,24516,0,True
2017,12/17,LosAngeles,1.7,9069,24736,0,30852,58,0,Winter,39921,24794,0,True
2017,12/10,LosAngeles,1.78,15944,19669,0,34216,31,0,Winter,50160,19700,0,True
2017,12/03,LosAngeles,1.77,7976,23155,0,39864,14,0,Winter,47840,23169,0,True
2017,11/26,LosAngeles,2.01,6444,21218,0,31835,24,0,Fall,38279,21242,0,True
2017,11/19,LosAngeles,1.99,6477,19956,0,35003,13,0,Fall,41480,19969,0,True
2017,11/12,LosAngeles,1.98,8390,17805,0,36097,44,0,Fall,44487,17849,0,True
2017,11/05,LosAngeles,1.72,7315,31324,0,35048,35,0,Fall,42363,31359,0,True
2017,10/29,LosAngeles,1.99,8078,19540,0,39411,20,0,Fall,47489,19560,0,True
2017,10/22,LosAngeles,1.99,7845,20466,0,40286,39,0,Fall,48131,20505,0,True
2017,10/15,LosAngeles,2.12,6151,16592,0,34691,56,0,Fall,40842,16648,0,True
2017,10/08,LosAngeles,2.28,5549,22828,0,30769,45,0,Fall,36318,22873,0,True
2017,10/01,LosAngeles,2.1,8450,26774,0,30158,21,0,Fall,38608,26795,0,True
2017,09/24,LosAngeles,2.03,12051,29225,1,32377,40,0,Fall,44428,29265,1,True
2017,09/17,LosAngeles,2.32,12786,24889,0,27160,19,0,Fall,39946,24908,0,True
2017,09/10,LosAngeles,2.32,11202,25484,0,27987,5,0,Fall,39189,25489,0,True
2017,09/03,LosAngeles,2.11,10621,27740,0,32041,16,0,Fall,42662,27756,0,True
2017,08/27,LosAngeles,2.37,11685,20166,0,31337,32,0,Summer,43022,20198,0,True
2017,08/20,LosAngeles,2.16,10649,18026,0,46450,20,0,Summer,57099,18046,0,True
2017,08/13,LosAngeles,2.04,10764,16810,0,45097,145,0,Summer,55861,16955,0,True
2017,08/06,LosAngeles,2.1,9064,19027,0,38021,966,0,Summer,47085,19993,0,True
2017,07/30,LosAngeles,2.1,9903,18850,0,39001,36,0,Summer,48904,18886,0,True
2017,07/23,LosAngeles,2.07,9095,24077,0,36988,18,0,Summer,46083,24095,0,True
2017,07/16,LosAngeles,2.02,10041,24449,0,40510,20,0,Summer,50551,24469,0,True
2017,07/09,LosAngeles,1.42,11868,28851,0,79833,8,0,Summer,91701,28859,0,True
2017,07/02,LosAngeles,1.46,11056,28190,0,69737,128,0,Summer,80793,28318,0,True
2017,06/25,LosAngeles,1.37,10376,24717,0,72884,1893,0,Summer,83260,26610,0,True
2017,06/18,LosAngeles,1.37,11413,24268,0,66783,6343,0,Summer,78196,30611,0,True
2017,06/11,LosAngeles,1.35,11619,25530,0,69461,92,0,Summer,81080,25622,0,True
2017,06/04,LosAngeles,1.28,12603,37820,0,78481,17,0,Summer,91084,37837,0,True
2017,05/28,LosAngeles,1.37,11731,29593,0,81486,75,0,Spring,93217,29668,0,True
2017,05/21,LosAngeles,1.42,10947,30522,0,72518,132,0,Spring,83465,30654,0,True
2017,05/14,LosAngeles,1.4,11688,28601,0,64377,1298,0,Spring,76065,29899,0,True
2017,05/07,LosAngeles,1.31,12550,38336,0,86014,584,0,Spring,98564,38920,0,True
2017,04/30,LosAngeles,1.25,10894,29816,1,83579,2963,0,Spring,94473,32779,1,True
2017,04/23,LosAngeles,1.25,12241,29711,0,75004,10265,0,Spring,87245,39976,0,True
2017,04/16,LosAngeles,1.31,10922,28994,1,76233,6725,0,Spring,87155,35719,1,True
2017,04/09,LosAngeles,1.3,13906,29159,6,70010,5222,0,Spring,83916,34381,6,True
2017,04/02,LosAngeles,1.3,13732,30991,17,74785,2858,0,Spring,88517,33849,17,True
2017,03/26,LosAngeles,1.33,17237,32193,7,73831,2440,0,Spring,91068,34633,7,True
2017,03/19,LosAngeles,1.25,11812,38905,19,69061,15837,0,Spring,80873,54742,19,True
2017,03/12,LosAngeles,1.19,12242,37476,1,83175,10951,0,Spring,95417,48427,1,True
2017,03/05,LosAngeles,1.07,12954,28009,6,77383,27712,0,Spring,90337,55721,6,True
2017,02/26,LosAngeles,1.05,12328,30665,3,87365,13157,0,Winter,99693,43822,3,True
2017,02/19,LosAngeles,1.19,13178,33656,1,68066,831,0,Winter,81244,34487,1,True
2017,02/12,LosAngeles,1.17,12496,24567,10,56547,1605,0,Winter,69043,26172,10,True
2017,02/05,LosAngeles,1.19,15626,34864,0,40279,916,0,Winter,55905,35780,0,True
2017,01/29,LosAngeles,1.09,16192,29310,1,42914,11178,0,Winter,59106,40488,1,True
2017,01/22,LosAngeles,1.27,10912,21788,3,41824,2889,0,Winter,52736,24677,3,True
2017,01/15,LosAngeles,1.3,13881,25602,3,46301,1057,0,Winter,60182,26659,3,True
2017,01/08,LosAngeles,1.19,18961,33123,3,57800,3063,0,Winter,76761,36186,3,True
2017,01/01,LosAngeles,1.07,15830,28951,1,43159,12006,0,Winter,58989,40957,1,True
2017,12/31,Louisville,1.16,1,755,0,3623,1448,0,Winter,3624,2203,0,True
2017,12/24,Louisville,1.58,0,977,0,1340,1659,0,Winter,1340,2636,0,True
2017,12/17,Louisville,1.57,1,851,0,1284,1724,0,Winter,1285,2575,0,True
2017,12/10,Louisville,1.54,0,723,0,1109,657,0,Winter,1109,1380,0,True
2017,12/03,Louisville,1.59,0,941,0,964,691,0,Winter,964,1632,0,True
2017,11/26,Louisville,1.63,0,930,0,1182,397,0,Fall,1182,1327,0,True
2017,11/19,Louisville,1.62,9,901,0,1070,336,0,Fall,1079,1237,0,True
2017,11/12,Louisville,1.69,1,944,0,1111,660,0,Fall,1112,1604,0,True
2017,11/05,Louisville,1.7,5,756,0,1658,593,0,Fall,1663,1349,0,True
2017,10/29,Louisville,1.84,1,740,0,1739,1209,0,Fall,1740,1949,0,True
2017,10/22,Louisville,1.82,9,1048,0,1733,1404,0,Fall,1742,2452,0,True
2017,10/15,Louisville,1.88,2,1120,0,1647,894,0,Fall,1649,2014,0,True
2017,10/08,Louisville,2.15,1,1195,0,1173,726,0,Fall,1174,1921,0,True
2017,10/01,Louisville,2.29,0,999,0,1289,813,0,Fall,1289,1812,0,True
2017,09/24,Louisville,2.21,2,1074,0,1064,2015,0,Fall,1066,3089,0,True
2017,09/17,Louisville,2.12,9,993,0,713,2063,0,Fall,722,3056,0,True
2017,09/10,Louisville,2.0,2,948,0,1066,1500,0,Fall,1068,2448,0,True
2017,09/03,Louisville,1.98,7,1116,0,835,1622,0,Fall,842,2738,0,True
2017,08/27,Louisville,1.9,1,973,0,1313,1339,0,Summer,1314,2312,0,True
2017,08/20,Louisville,1.86,0,1114,0,971,1029,0,Summer,971,2143,0,True
2017,08/13,Louisville,1.67,0,1252,0,1102,386,0,Summer,1102,1638,0,True
2017,08/06,Louisville,1.73,0,1226,0,729,1600,0,Summer,729,2826,0,True
2017,07/30,Louisville,1.56,0,1153,0,1403,2109,0,Summer,1403,3262,0,True
2017,07/23,Louisville,1.6,0,1441,0,868,2750,0,Summer,868,4191,0,True
2017,07/16,Louisville,1.55,0,1527,0,924,2186,0,Summer,924,3713,0,True
2017,07/09,Louisville,1.61,0,1551,0,11,890,0,Summer,11,2441,0,True
2017,07/02,Louisville,1.26,0,1338,0,30,4144,0,Summer,30,5482,0,True
2017,06/25,Louisville,1.45,0,1490,0,10,3019,0,Summer,10,4509,0,True
2017,06/18,Louisville,1.19,0,1421,0,6,3437,0,Summer,6,4858,0,True
2017,06/11,Louisville,1.0,0,1633,0,50,4824,0,Summer,50,6457,0,True
2017,06/04,Louisville,1.34,0,1505,0,457,2454,0,Summer,457,3959,0,True
2017,05/28,Louisville,1.32,0,1185,0,763,2503,0,Spring,763,3688,0,True
2017,05/21,Louisville,1.29,0,1200,0,577,2966,0,Spring,577,4166,0,True
2017,05/14,Louisville,1.15,0,1188,0,620,3912,0,Spring,620,5100,0,True
2017,05/07,Louisville,1.48,0,1570,0,445,1499,0,Spring,445,3069,0,True
2017,04/30,Louisville,1.4,0,1639,0,234,3292,0,Spring,234,4931,0,True
2017,04/23,Louisville,1.59,0,1507,0,336,1499,0,Spring,336,3006,0,True
2017,04/16,Louisville,1.34,5,1947,0,752,2198,0,Spring,757,4145,0,True
2017,04/09,Louisville,1.91,0,1553,0,325,147,0,Spring,325,1700,0,True
2017,04/02,Louisville,1.38,0,1676,0,390,1100,0,Spring,390,2776,0,True
2017,03/26,Louisville,0.74,15,1354,0,385,4704,0,Spring,400,6058,0,True
2017,03/19,Louisville,0.95,15,1395,0,372,2649,0,Spring,387,4044,0,True
2017,03/12,Louisville,0.65,6,1361,0,273,6066,0,Spring,279,7427,0,True
2017,03/05,Louisville,0.56,9,1302,0,306,8183,0,Spring,315,9485,0,True
2017,02/26,Louisville,0.77,12,1257,0,402,3810,0,Winter,414,5067,0,True
2017,02/19,Louisville,0.56,0,1277,0,287,9005,0,Winter,287,10282,0,True
2017,02/12,Louisville,0.8,4,1259,0,313,3711,0,Winter,317,4970,0,True
2017,02/05,Louisville,1.36,0,991,0,441,675,0,Winter,441,1666,0,True
2017,01/29,Louisville,1.45,0,938,0,193,338,0,Winter,193,1276,0,True
2017,01/22,Louisville,1.31,0,1006,0,536,554,0,Winter,536,1560,0,True
2017,01/15,Louisville,1.6,13,1318,0,626,0,0,Winter,639,1318,0,True
2017,01/08,Louisville,1.55,0,1157,0,656,8,0,Winter,656,1165,0,True
2017,01/01,Louisville,1.59,5,1395,0,513,0,0,Winter,518,1395,0,True
2017,12/31,MiamiFtLauderdale,1.48,24,333,0,6147,12,0,Winter,6171,345,0,True
2017,12/24,MiamiFtLauderdale,1.59,88,720,0,6896,756,0,Winter,6984,1476,0,True
2017,12/17,MiamiFtLauderdale,1.59,232,636,0,7027,590,0,Winter,7259,1226,0,True
2017,12/10,MiamiFtLauderdale,1.48,31,265,0,5024,4,0,Winter,5055,269,0,True
2017,12/03,MiamiFtLauderdale,1.58,50,397,0,4836,17,0,Winter,4886,414,0,True
2017,11/26,MiamiFtLauderdale,1.67,96,606,0,5128,470,0,Fall,5224,1076,0,True
2017,11/19,MiamiFtLauderdale,1.63,61,490,0,5227,93,0,Fall,5288,583,0,True
2017,11/12,MiamiFtLauderdale,1.94,126,908,0,4652,876,0,Fall,4778,1784,0,True
2017,11/05,MiamiFtLauderdale,1.96,64,911,0,4226,900,0,Fall,4290,1811,0,True
2017,10/29,MiamiFtLauderdale,1.84,32,424,0,4908,229,0,Fall,4940,653,0,True
2017,10/22,MiamiFtLauderdale,2.19,139,728,0,3068,906,0,Fall,3207,1634,0,True
2017,10/15,MiamiFtLauderdale,2.62,24,384,0,657,32,0,Fall,681,416,0,True
2017,10/08,MiamiFtLauderdale,1.97,98,435,0,3221,3,0,Fall,3319,438,0,True
2017,10/01,MiamiFtLauderdale,2.09,33,445,0,2496,0,0,Fall,2529,445,0,True
2017,09/24,MiamiFtLauderdale,1.9,29,319,0,2630,0,0,Fall,2659,319,0,True
2017,09/17,MiamiFtLauderdale,1.76,44,15,0,1246,0,0,Fall,1290,15,0,True
2017,09/10,MiamiFtLauderdale,1.74,30,8,0,3257,3,0,Fall,3287,11,0,True
2017,09/03,MiamiFtLauderdale,1.67,36,2,0,2602,6,0,Fall,2638,8,0,True
2017,08/27,MiamiFtLauderdale,1.55,15,2,0,3375,0,0,Summer,3390,2,0,True
2017,08/20,MiamiFtLauderdale,1.48,25,20,0,4523,0,0,Summer,4548,20,0,True
2017,08/13,MiamiFtLauderdale,1.47,16,29,0,4087,3,0,Summer,4103,32,0,True
2017,08/06,MiamiFtLauderdale,1.5,11,44,0,4073,11,0,Summer,4084,55,0,True
2017,07/30,MiamiFtLauderdale,1.38,10,17,0,4607,0,0,Summer,4617,17,0,True
2017,07/23,MiamiFtLauderdale,1.41,22,27,0,4902,3,0,Summer,4924,30,0,True
2017,07/16,MiamiFtLauderdale,1.44,6,14,0,5448,3,0,Summer,5454,17,0,True
2017,07/09,MiamiFtLauderdale,1.76,89,521,0,3790,3,0,Summer,3879,524,0,True
2017,07/02,MiamiFtLauderdale,1.92,267,1709,0,4257,6,0,Summer,4524,1715,0,True
2017,06/25,MiamiFtLauderdale,2.02,325,1885,0,3061,3,0,Summer,3386,1888,0,True
2017,06/18,MiamiFtLauderdale,1.88,304,1510,0,4664,0,0,Summer,4968,1510,0,True
2017,06/11,MiamiFtLauderdale,1.89,837,250,0,5015,0,0,Summer,5852,250,0,True
2017,06/04,MiamiFtLauderdale,1.97,1070,139,0,4215,1,0,Summer,5285,140,0,True
2017,05/28,MiamiFtLauderdale,1.88,1096,86,0,4815,1,0,Spring,5911,87,0,True
2017,05/21,MiamiFtLauderdale,1.58,515,81,0,4806,773,0,Spring,5321,854,0,True
2017,05/14,MiamiFtLauderdale,1.42,279,84,0,3846,1671,0,Spring,4125,1755,0,True
2017,05/07,MiamiFtLauderdale,2.08,838,73,0,1937,693,0,Spring,2775,766,0,True
2017,04/30,MiamiFtLauderdale,2.4,1154,62,0,2250,11,0,Spring,3404,73,0,True
2017,04/23,MiamiFtLauderdale,2.36,1362,71,0,2540,37,0,Spring,3902,108,0,True
2017,04/16,MiamiFtLauderdale,2.81,738,69,0,1481,908,0,Spring,2219,977,0,True
2017,04/09,MiamiFtLauderdale,2.32,317,25,0,1365,2039,0,Spring,1682,2064,0,True
2017,04/02,MiamiFtLauderdale,2.03,545,36,0,1622,1955,0,Spring,2167,1991,0,True
2017,03/26,MiamiFtLauderdale,1.74,1352,124,0,4250,103,0,Spring,5602,227,0,True
2017,03/19,MiamiFtLauderdale,2.59,1223,96,0,1107,0,0,Spring,2330,96,0,True
2017,03/12,MiamiFtLauderdale,3.05,1043,77,0,926,20,0,Spring,1969,97,0,True
2017,03/05,MiamiFtLauderdale,2.47,1073,128,0,1372,1008,0,Spring,2445,1136,0,True
2017,02/26,MiamiFtLauderdale,2.43,1208,65,0,1188,638,0,Winter,2396,703,0,True
2017,02/19,MiamiFtLauderdale,1.65,846,49,0,3646,762,0,Winter,4492,811,0,True
2017,02/12,MiamiFtLauderdale,1.29,295,8,0,4157,1505,0,Winter,4452,1513,0,True
2017,02/05,MiamiFtLauderdale,1.41,398,4,0,1155,2068,0,Winter,1553,2072,0,True
2017,01/29,MiamiFtLauderdale,1.23,255,8,0,2085,2123,0,Winter,2340,2131,0,True
2017,01/22,MiamiFtLauderdale,1.19,221,12,0,3727,1926,0,Winter,3948,1938,0,True
2017,01/15,MiamiFtLauderdale,1.19,297,12,0,5116,2281,0,Winter,5413,2293,0,True
2017,01/08,MiamiFtLauderdale,1.23,421,6,0,3260,2526,0,Winter,3681,2532,0,True
2017,01/01,MiamiFtLauderdale,1.21,290,20,0,1970,2972,0,Winter,2260,2992,0,True
2017,12/31,Nashville,1.52,51,1535,0,3056,2454,0,Winter,3107,3989,0,True
2017,12/24,Nashville,1.56,70,2170,0,3146,1763,0,Winter,3216,3933,0,True
2017,12/17,Nashville,1.62,41,1898,0,2612,2153,0,Winter,2653,4051,0,True
2017,12/10,Nashville,1.59,19,1730,0,2376,1351,0,Winter,2395,3081,0,True
2017,12/03,Nashville,1.59,49,1937,0,2230,767,0,Winter,2279,2704,0,True
2017,11/26,Nashville,1.57,50,1862,0,2667,1051,0,Fall,2717,2913,0,True
2017,11/19,Nashville,1.61,51,2032,0,2376,675,0,Fall,2427,2707,0,True
2017,11/12,Nashville,1.74,58,1861,0,2233,1680,0,Fall,2291,3541,0,True
2017,11/05,Nashville,1.71,72,1957,0,3131,1167,0,Fall,3203,3124,0,True
2017,10/29,Nashville,1.76,75,2571,0,2957,1745,0,Fall,3032,4316,0,True
2017,10/22,Nashville,1.78,57,3126,0,2340,3191,0,Fall,2397,6317,0,True
2017,10/15,Nashville,1.96,67,2947,0,2567,1963,0,Fall,2634,4910,0,True
2017,10/08,Nashville,2.17,60,2903,0,2453,1654,0,Fall,2513,4557,0,True
2017,10/01,Nashville,2.22,88,2826,0,3217,2097,0,Fall,3305,4923,0,True
2017,09/24,Nashville,2.24,104,2500,0,1601,4711,0,Fall,1705,7211,0,True
2017,09/17,Nashville,2.19,117,2557,0,1778,4126,0,Fall,1895,6683,0,True
2017,09/10,Nashville,2.15,94,2782,0,2482,3744,0,Fall,2576,6526,0,True
2017,09/03,Nashville,2.04,166,2919,0,1630,3912,0,Fall,1796,6831,0,True
2017,08/27,Nashville,1.89,120,2952,0,3247,3013,0,Summer,3367,5965,0,True
2017,08/20,Nashville,1.84,80,2884,0,1925,2349,0,Summer,2005,5233,0,True
2017,08/13,Nashville,1.61,25,2387,0,1738,588,0,Summer,1763,2975,0,True
2017,08/06,Nashville,1.54,71,2677,0,2337,2990,0,Summer,2408,5667,0,True
2017,07/30,Nashville,1.5,54,2881,0,2457,3260,0,Summer,2511,6141,0,True
2017,07/23,Nashville,1.43,39,3771,0,3353,4734,0,Summer,3392,8505,0,True
2017,07/16,Nashville,1.54,52,3594,0,1707,3135,0,Summer,1759,6729,0,True
2017,07/09,Nashville,1.49,103,3658,0,1833,1282,0,Summer,1936,4940,0,True
2017,07/02,Nashville,1.2,163,3207,0,1961,7166,0,Summer,2124,10373,0,True
2017,06/25,Nashville,1.27,94,2957,0,2124,5901,0,Summer,2218,8858,0,True
2017,06/18,Nashville,1.16,146,3631,0,2083,6500,0,Summer,2229,10131,0,True
2017,06/11,Nashville,1.15,380,3321,0,1731,8395,0,Summer,2111,11716,0,True
2017,06/04,Nashville,1.14,350,3197,0,502,6528,0,Summer,852,9725,0,True
2017,05/28,Nashville,1.16,435,2257,0,341,5642,0,Spring,776,7899,0,True
2017,05/21,Nashville,1.2,358,2467,0,591,5864,0,Spring,949,8331,0,True
2017,05/14,Nashville,0.87,556,2648,0,213,12847,0,Spring,769,15495,0,True
2017,05/07,Nashville,1.22,191,2221,0,216,3587,0,Spring,407,5808,0,True
2017,04/30,Nashville,1.14,387,2926,0,192,7593,0,Spring,579,10519,0,True
2017,04/23,Nashville,1.43,582,3204,0,157,3119,0,Spring,739,6323,0,True
2017,04/16,Nashville,1.14,475,3049,0,248,4674,0,Spring,723,7723,0,True
2017,04/09,Nashville,1.53,572,2987,0,1123,657,0,Spring,1695,3644,0,True
2017,04/02,Nashville,1.17,419,2523,0,490,2903,0,Spring,909,5426,0,True
2017,03/26,Nashville,0.77,422,1987,0,218,7128,0,Spring,640,9115,0,True
2017,03/19,Nashville,0.92,340,2019,0,97,3528,0,Spring,437,5547,0,True
2017,03/12,Nashville,0.61,523,1918,0,66,9050,0,Spring,589,10968,0,True
2017,03/05,Nashville,0.51,481,1790,0,122,14740,0,Spring,603,16530,0,True
2017,02/26,Nashville,0.68,329,2415,0,115,8060,0,Winter,444,10475,0,True
2017,02/19,Nashville,0.67,284,2310,0,120,10819,0,Winter,404,13129,0,True
2017,02/12,Nashville,0.66,337,2693,0,196,10575,0,Winter,533,13268,0,True
2017,02/05,Nashville,1.16,338,2130,0,56,1780,0,Winter,394,3910,0,True
2017,01/29,Nashville,1.41,296,1977,0,78,903,0,Winter,374,2880,0,True
2017,01/22,Nashville,0.86,172,2287,0,57,4109,0,Winter,229,6396,0,True
2017,01/15,Nashville,1.54,238,2018,0,73,630,0,Winter,311,2648,0,True
2017,01/08,Nashville,1.53,209,2389,0,62,505,0,Winter,271,2894,0,True
2017,01/01,Nashville,1.53,210,3088,0,62,387,0,Winter,272,3475,0,True
2017,12/31,NewOrleansMobile,1.44,214,115,0,4876,134,0,Winter,5090,249,0,True
2017,12/24,NewOrleansMobile,1.45,123,54,0,5116,280,0,Winter,5239,334,0,True
2017,12/17,NewOrleansMobile,1.37,69,79,0,5633,6,0,Winter,5702,85,0,True
2017,12/10,NewOrleansMobile,1.4,141,47,0,5293,6,0,Winter,5434,53,0,True
2017,12/03,NewOrleansMobile,1.46,85,149,0,5225,189,0,Winter,5310,338,0,True
2017,11/26,NewOrleansMobile,1.44,87,65,0,4548,240,0,Fall,4635,305,0,True
2017,11/19,NewOrleansMobile,1.49,78,209,0,6092,301,0,Fall,6170,510,0,True
2017,11/12,NewOrleansMobile,1.64,80,111,0,5588,30,0,Fall,5668,141,0,True
2017,11/05,NewOrleansMobile,1.7,110,92,0,5123,549,0,Fall,5233,641,0,True
2017,10/29,NewOrleansMobile,1.7,89,154,0,5561,283,0,Fall,5650,437,0,True
2017,10/22,NewOrleansMobile,1.6,83,125,0,3234,13,0,Fall,3317,138,0,True
2017,10/15,NewOrleansMobile,1.55,252,100,0,1816,3,0,Fall,2068,103,0,True
2017,10/08,NewOrleansMobile,1.69,208,73,0,2111,10,0,Fall,2319,83,0,True
2017,10/01,NewOrleansMobile,1.97,207,135,0,3269,156,0,Fall,3476,291,0,True
2017,09/24,NewOrleansMobile,1.89,155,218,0,5656,821,0,Fall,5811,1039,0,True
2017,09/17,NewOrleansMobile,1.89,313,179,0,5023,796,0,Fall,5336,975,0,True
2017,09/10,NewOrleansMobile,1.63,248,125,0,5804,422,0,Fall,6052,547,0,True
2017,09/03,NewOrleansMobile,1.5,222,202,0,6707,16,0,Fall,6929,218,0,True
2017,08/27,NewOrleansMobile,1.5,162,337,0,7128,3,0,Summer,7290,340,0,True
2017,08/20,NewOrleansMobile,1.35,252,296,0,6314,3,0,Summer,6566,299,0,True
2017,08/13,NewOrleansMobile,1.2,164,93,0,7945,16,0,Summer,8109,109,0,True
2017,08/06,NewOrleansMobile,1.18,128,71,0,6781,13,0,Summer,6909,84,0,True
2017,07/30,NewOrleansMobile,1.25,228,118,0,5458,10,0,Summer,5686,128,0,True
2017,07/23,NewOrleansMobile,1.28,102,55,0,2162,6,0,Summer,2264,61,0,True
2017,07/16,NewOrleansMobile,1.23,157,128,0,5157,3,0,Summer,5314,131,0,True
2017,07/09,NewOrleansMobile,1.76,103,367,0,1461,10,0,Summer,1564,377,0,True
2017,07/02,NewOrleansMobile,1.89,183,838,0,1662,16,0,Summer,1845,854,0,True
2017,06/25,NewOrleansMobile,1.91,64,472,0,738,6,0,Summer,802,478,0,True
2017,06/18,NewOrleansMobile,2.32,103,679,0,150,3,0,Summer,253,682,0,True
2017,06/11,NewOrleansMobile,2.19,399,5,0,106,3,0,Summer,505,8,0,True
2017,06/04,NewOrleansMobile,2.12,417,0,0,762,0,0,Summer,1179,0,0,True
2017,05/28,NewOrleansMobile,1.88,367,0,0,1694,305,0,Spring,2061,305,0,True
2017,05/21,NewOrleansMobile,2.1,536,23,0,1094,178,0,Spring,1630,201,0,True
2017,05/14,NewOrleansMobile,1.96,900,0,0,744,99,0,Spring,1644,99,0,True
2017,05/07,NewOrleansMobile,1.57,353,0,0,2418,950,0,Spring,2771,950,0,True
2017,04/30,NewOrleansMobile,1.95,228,24,0,381,0,0,Spring,609,24,0,True
2017,04/23,NewOrleansMobile,1.74,295,12,0,2616,0,0,Spring,2911,12,0,True
2017,04/16,NewOrleansMobile,1.63,213,0,0,4280,500,0,Spring,4493,500,0,True
2017,04/09,NewOrleansMobile,1.63,281,0,0,4707,508,0,Spring,4988,508,0,True
2017,04/02,NewOrleansMobile,1.55,293,0,0,5484,761,0,Spring,5777,761,0,True
2017,03/26,NewOrleansMobile,1.6,233,0,0,3380,225,0,Spring,3613,225,0,True
2017,03/19,NewOrleansMobile,1.44,83,0,0,904,529,0,Spring,987,529,0,True
2017,03/12,NewOrleansMobile,1.45,369,0,0,2461,951,0,Spring,2830,951,0,True
2017,03/05,NewOrleansMobile,1.45,429,0,0,3487,432,0,Spring,3916,432,0,True
2017,02/26,NewOrleansMobile,1.33,151,6,0,5155,431,0,Winter,5306,437,0,True
2017,02/19,NewOrleansMobile,1.33,139,0,0,4830,190,0,Winter,4969,190,0,True
2017,02/12,NewOrleansMobile,1.33,254,0,0,5927,243,0,Winter,6181,243,0,True
2017,02/05,NewOrleansMobile,1.35,326,6,0,1874,1174,0,Winter,2200,1180,0,True
2017,01/29,NewOrleansMobile,1.3,129,0,0,1861,948,0,Winter,1990,948,0,True
2017,01/22,NewOrleansMobile,1.31,190,5,0,2815,1016,0,Winter,3005,1021,0,True
2017,01/15,NewOrleansMobile,1.3,101,11,0,2775,984,0,Winter,2876,995,0,True
2017,01/08,NewOrleansMobile,1.26,189,0,0,3309,1578,0,Winter,3498,1578,0,True
2017,01/01,NewOrleansMobile,1.3,125,11,0,1947,733,0,Winter,2072,744,0,True
2017,12/31,NewYork,1.83,6476,16996,134,46167,2,0,Winter,52643,16998,134,True
2017,12/24,NewYork,1.85,9007,20286,241,45130,112,0,Winter,54137,20398,241,True
2017,12/17,NewYork,1.84,7786,22015,96,44572,991,0,Winter,52358,23006,96,True
2017,12/10,NewYork,1.79,8727,19910,102,50816,371,0,Winter,59543,20281,102,True
2017,12/03,NewYork,1.81,14732,35839,73,43868,786,0,Winter,58600,36625,73,True
2017,11/26,NewYork,2.02,5280,14350,178,43299,47,0,Fall,48579,14397,178,True
2017,11/19,NewYork,2.07,5986,16315,101,46015,47,0,Fall,52001,16362,101,True
2017,11/12,NewYork,2.05,5949,17740,170,50266,186,0,Fall,56215,17926,170,True
2017,11/05,NewYork,2.05,5539,17479,118,48214,148,0,Fall,53753,17627,118,True
2017,10/29,NewYork,2.11,5301,19352,84,46069,74,0,Fall,51370,19426,84,True
2017,10/22,NewYork,2.08,5760,17860,73,46411,167,0,Fall,52171,18027,73,True
2017,10/15,NewYork,2.09,6708,14018,100,48265,147,0,Fall,54973,14165,100,True
2017,10/08,NewYork,2.06,6353,16664,133,43893,121,0,Fall,50246,16785,133,True
2017,10/01,NewYork,2.04,5060,14782,90,43667,22,0,Fall,48727,14804,90,True
2017,09/24,NewYork,2.06,5244,22378,77,42664,0,0,Fall,47908,22378,77,True
2017,09/17,NewYork,2.08,4879,23574,12,42464,0,0,Fall,47343,23574,12,True
2017,09/10,NewYork,2.07,5734,28471,57,55915,0,0,Fall,61649,28471,57,True
2017,09/03,NewYork,2.14,8610,29307,233,44024,0,0,Fall,52634,29307,233,True
2017,08/27,NewYork,2.13,4774,24947,93,44051,0,0,Summer,48825,24947,93,True
2017,08/20,NewYork,1.85,11650,43213,149,52260,0,0,Summer,63910,43213,149,True
2017,08/13,NewYork,2.07,4392,21953,234,46723,5,0,Summer,51115,21958,234,True
2017,08/06,NewYork,1.91,3899,18435,158,49486,96,0,Summer,53385,18531,158,True
2017,07/30,NewYork,1.88,3407,17677,285,49656,8,0,Summer,53063,17685,285,True
2017,07/23,NewYork,1.85,5573,20491,1314,60473,35,0,Summer,66046,20526,1314,True
2017,07/16,NewYork,1.79,7856,19545,2330,50548,0,0,Summer,58404,19545,2330,True
2017,07/09,NewYork,2.48,3895,21115,1931,32621,0,0,Summer,36516,21115,1931,True
2017,07/02,NewYork,2.44,5739,25934,1805,30319,0,0,Summer,36058,25934,1805,True
2017,06/25,NewYork,2.36,5993,27972,1229,33342,4,0,Summer,39335,27976,1229,True
2017,06/18,NewYork,1.91,32342,94247,277,38126,1315,0,Summer,70468,95562,277,True
2017,06/11,NewYork,2.39,9032,33481,685,37772,707,0,Summer,46804,34188,685,True
2017,06/04,NewYork,2.06,17822,52648,1178,39892,1270,0,Summer,57714,53918,1178,True
2017,05/28,NewYork,2.38,6137,30135,629,38971,128,0,Spring,45108,30263,629,True
2017,05/21,NewYork,2.39,6849,27571,1575,34668,0,0,Spring,41517,27571,1575,True
2017,05/14,NewYork,2.41,6758,25947,2033,36449,0,0,Spring,43207,25947,2033,True
2017,05/07,NewYork,2.34,8039,35366,1665,43553,0,0,Spring,51592,35366,1665,True
2017,04/30,NewYork,1.9,32215,82983,1917,39134,0,0,Spring,71349,82983,1917,True
2017,04/23,NewYork,2.23,6752,33878,1022,32297,24,0,Spring,39049,33902,1022,True
2017,04/16,NewYork,1.9,21906,72571,210,31327,391,0,Spring,53233,72962,210,True
2017,04/09,NewYork,2.22,8494,34731,166,25956,39,0,Spring,34450,34770,166,True
2017,04/02,NewYork,1.86,28190,80969,128,30716,34,0,Spring,58906,81003,128,True
2017,03/26,NewYork,2.18,12071,41311,90,34341,83,0,Spring,46412,41394,90,True
2017,03/19,NewYork,1.86,30270,85793,114,30832,237,0,Spring,61102,86030,114,True
2017,03/12,NewYork,2.26,9962,40186,162,43017,0,0,Spring,52979,40186,162,True
2017,03/05,NewYork,1.81,20888,66846,235,33382,188,0,Spring,54270,67034,235,True
2017,02/26,NewYork,1.77,14208,48448,164,28122,268,0,Winter,42330,48716,164,True
2017,02/19,NewYork,1.36,100285,288953,366,29223,1581,0,Winter,129508,290534,366,True
2017,02/12,NewYork,1.98,7402,22697,514,28971,253,0,Winter,36373,22950,514,True
2017,02/05,NewYork,2.03,7829,20623,197,29581,327,0,Winter,37410,20950,197,True
2017,01/29,NewYork,2.08,6492,19169,74,20510,354,0,Winter,27002,19523,74,True
2017,01/22,NewYork,2.05,6679,21232,1039,19821,282,0,Winter,26500,21514,1039,True
2017,01/15,NewYork,2.09,6002,18195,117,17791,127,0,Winter,23793,18322,117,True
2017,01/08,NewYork,2.15,6642,18205,338,17103,466,0,Winter,23745,18671,338,True
2017,01/01,NewYork,2.06,6071,20105,1025,11934,122,0,Winter,18005,20227,1025,True
2017,12/31,NorthernNewEngland,1.76,0,200,0,19925,3,0,Winter,19925,203,0,True
2017,12/24,NorthernNewEngland,1.76,0,463,0,24764,0,0,Winter,24764,463,0,True
2017,12/17,NorthernNewEngland,1.72,3,288,0,18259,0,0,Winter,18262,288,0,True
2017,12/10,NorthernNewEngland,1.67,0,285,0,23672,0,0,Winter,23672,285,0,True
2017,12/03,NorthernNewEngland,1.71,0,390,0,18273,228,0,Winter,18273,618,0,True
2017,11/26,NorthernNewEngland,1.75,1,219,0,22155,0,0,Fall,22156,219,0,True
2017,11/19,NorthernNewEngland,1.78,0,203,0,21284,57,0,Fall,21284,260,0,True
2017,11/12,NorthernNewEngland,1.8,5,317,0,18525,386,0,Fall,18530,703,0,True
2017,11/05,NorthernNewEngland,1.84,0,148,0,20317,4220,0,Fall,20317,4368,0,True
2017,10/29,NorthernNewEngland,1.57,1,177,0,32627,6241,0,Fall,32628,6418,0,True
2017,10/22,NorthernNewEngland,1.7,0,308,0,22363,0,0,Fall,22363,308,0,True
2017,10/15,NorthernNewEngland,1.64,0,202,0,23598,0,0,Fall,23598,202,0,True
2017,10/08,NorthernNewEngland,1.52,10,194,0,20879,4,0,Fall,20889,198,0,True
2017,10/01,NorthernNewEngland,1.56,10,163,0,18143,0,0,Fall,18153,163,0,True
2017,09/24,NorthernNewEngland,1.57,1,105,0,16555,0,0,Fall,16556,105,0,True
2017,09/17,NorthernNewEngland,1.54,5,147,0,15496,0,0,Fall,15501,147,0,True
2017,09/10,NorthernNewEngland,1.68,4,169,0,16278,0,0,Fall,16282,169,0,True
2017,09/03,NorthernNewEngland,1.69,2,168,0,12891,0,0,Fall,12893,168,0,True
2017,08/27,NorthernNewEngland,1.69,3,172,0,18305,0,0,Summer,18308,172,0,True
2017,08/20,NorthernNewEngland,1.68,11,258,0,17542,0,0,Summer,17553,258,0,True
2017,08/13,NorthernNewEngland,1.69,13,246,0,12958,0,0,Summer,12971,246,0,True
2017,08/06,NorthernNewEngland,1.68,6,281,0,16652,0,0,Summer,16658,281,0,True
2017,07/30,NorthernNewEngland,1.68,15,259,0,18252,0,0,Summer,18267,259,0,True
2017,07/23,NorthernNewEngland,1.59,14,254,0,20385,0,0,Summer,20399,254,0,True
2017,07/16,NorthernNewEngland,1.66,10,397,0,19846,0,0,Summer,19856,397,0,True
2017,07/09,NorthernNewEngland,1.85,3,277,0,13311,0,0,Summer,13314,277,0,True
2017,07/02,NorthernNewEngland,1.91,7,469,0,16189,0,0,Summer,16196,469,0,True
2017,06/25,NorthernNewEngland,1.93,7,428,0,20791,0,0,Summer,20798,428,0,True
2017,06/18,NorthernNewEngland,1.92,14,370,0,19618,0,0,Summer,19632,370,0,True
2017,06/11,NorthernNewEngland,1.83,2,304,0,15284,0,0,Summer,15286,304,0,True
2017,06/04,NorthernNewEngland,1.48,0,295,0,25195,0,0,Summer,25195,295,0,True
2017,05/28,NorthernNewEngland,1.67,12,299,0,17976,0,0,Spring,17988,299,0,True
2017,05/21,NorthernNewEngland,1.59,7,299,0,20264,0,0,Spring,20271,299,0,True
2017,05/14,NorthernNewEngland,1.4,10,614,0,26339,0,0,Spring,26349,614,0,True
2017,05/07,NorthernNewEngland,1.57,29,398,0,13152,0,0,Spring,13181,398,0,True
2017,04/30,NorthernNewEngland,1.62,97,229,0,13881,0,0,Spring,13978,229,0,True
2017,04/23,NorthernNewEngland,1.68,103,164,0,12907,0,0,Spring,13010,164,0,True
2017,04/16,NorthernNewEngland,1.82,87,240,0,15168,0,0,Spring,15255,240,0,True
2017,04/09,NorthernNewEngland,1.75,90,237,0,11724,0,0,Spring,11814,237,0,True
2017,04/02,NorthernNewEngland,1.82,128,364,0,13147,0,0,Spring,13275,364,0,True
2017,03/26,NorthernNewEngland,1.85,126,228,0,14124,0,0,Spring,14250,228,0,True
2017,03/19,NorthernNewEngland,1.86,168,170,0,15725,0,0,Spring,15893,170,0,True
2017,03/12,NorthernNewEngland,1.87,119,198,0,14455,0,0,Spring,14574,198,0,True
2017,03/05,NorthernNewEngland,1.66,76,269,0,14670,0,0,Spring,14746,269,0,True
2017,02/26,NorthernNewEngland,1.85,10,263,0,12003,0,0,Winter,12013,263,0,True
2017,02/19,NorthernNewEngland,1.88,2,221,0,11303,0,0,Winter,11305,221,0,True
2017,02/12,NorthernNewEngland,1.8,2,325,0,13146,0,0,Winter,13148,325,0,True
2017,02/05,NorthernNewEngland,1.6,1,304,0,10554,0,0,Winter,10555,304,0,True
2017,01/29,NorthernNewEngland,1.84,3,333,0,12452,0,0,Winter,12455,333,0,True
2017,01/22,NorthernNewEngland,1.89,2,185,0,13305,0,0,Winter,13307,185,0,True
2017,01/15,NorthernNewEngland,1.77,0,197,0,10659,0,0,Winter,10659,197,0,True
2017,01/08,NorthernNewEngland,1.86,3,254,0,12519,0,0,Winter,12522,254,0,True
2017,01/01,NorthernNewEngland,1.91,6,130,0,9076,0,0,Winter,9082,130,0,True
2017,12/31,Orlando,1.82,164,1018,0,4136,742,0,Winter,4300,1760,0,True
2017,12/24,Orlando,1.79,172,1280,0,5538,1240,0,Winter,5710,2520,0,True
2017,12/17,Orlando,1.6,111,704,0,4869,150,0,Winter,4980,854,0,True
2017,12/10,Orlando,1.6,93,721,0,4884,3,0,Winter,4977,724,0,True
2017,12/03,Orlando,1.67,133,710,0,3623,15,0,Winter,3756,725,0,True
2017,11/26,Orlando,1.65,87,727,0,3975,10,0,Fall,4062,737,0,True
2017,11/19,Orlando,1.8,231,1063,0,4072,676,0,Fall,4303,1739,0,True
2017,11/12,Orlando,1.88,147,871,0,4351,6,0,Fall,4498,877,0,True
2017,11/05,Orlando,2.01,248,1434,0,4501,1450,0,Fall,4749,2884,0,True
2017,10/29,Orlando,2.01,179,1219,0,3897,1169,0,Fall,4076,2388,0,True
2017,10/22,Orlando,2.29,318,1675,0,4053,1917,0,Fall,4371,3592,0,True
2017,10/15,Orlando,2.87,175,1228,0,1696,724,0,Fall,1871,1952,0,True
2017,10/08,Orlando,2.27,198,1046,0,3378,110,0,Fall,3576,1156,0,True
2017,10/01,Orlando,2.35,239,1618,0,5291,1368,0,Fall,5530,2986,0,True
2017,09/24,Orlando,2.31,496,1531,0,4451,1084,0,Fall,4947,2615,0,True
2017,09/17,Orlando,2.65,486,1590,0,1720,1703,0,Fall,2206,3293,0,True
2017,09/10,Orlando,2.12,250,826,0,4658,191,0,Fall,4908,1017,0,True
2017,09/03,Orlando,2.45,439,1794,0,2042,1193,0,Fall,2481,2987,0,True
2017,08/27,Orlando,2.3,589,3095,0,3196,0,0,Summer,3785,3095,0,True
2017,08/20,Orlando,2.21,807,1910,0,5739,6,0,Summer,6546,1916,0,True
2017,08/13,Orlando,2.12,767,1410,0,4008,6,0,Summer,4775,1416,0,True
2017,08/06,Orlando,1.82,115,823,0,3096,0,0,Summer,3211,823,0,True
2017,07/30,Orlando,1.69,104,712,0,3816,6,0,Summer,3920,718,0,True
2017,07/23,Orlando,1.79,89,833,0,3808,0,0,Summer,3897,833,0,True
2017,07/16,Orlando,1.86,191,1118,0,3651,6,0,Summer,3842,1124,0,True
2017,07/09,Orlando,1.9,262,1460,0,3778,3,0,Summer,4040,1463,0,True
2017,07/02,Orlando,2.17,811,4168,0,3080,0,0,Summer,3891,4168,0,True
2017,06/25,Orlando,2.18,780,3949,0,2689,3,0,Summer,3469,3952,0,True
2017,06/18,Orlando,2.15,768,3446,0,2853,3,0,Summer,3621,3449,0,True
2017,06/11,Orlando,1.97,1583,333,0,3867,0,0,Summer,5450,333,0,True
2017,06/04,Orlando,2.1,2155,172,0,4638,0,0,Summer,6793,172,0,True
2017,05/28,Orlando,1.8,1830,174,0,4830,1788,0,Spring,6660,1962,0,True
2017,05/21,Orlando,1.8,1981,258,0,5043,1517,0,Spring,7024,1775,0,True
2017,05/14,Orlando,2.06,3870,219,0,2911,138,0,Spring,6781,357,0,True
2017,05/07,Orlando,1.57,781,145,0,2633,3123,0,Spring,3414,3268,0,True
2017,04/30,Orlando,2.38,2188,289,0,1853,350,0,Spring,4041,639,0,True
2017,04/23,Orlando,1.94,3447,394,0,3364,0,0,Spring,6811,394,0,True
2017,04/16,Orlando,2.83,2090,266,0,1508,403,0,Spring,3598,669,0,True
2017,04/09,Orlando,2.31,1570,215,0,1034,1615,0,Spring,2604,1830,0,True
2017,04/02,Orlando,1.8,1901,218,0,4305,1055,0,Spring,6206,1273,0,True
2017,03/26,Orlando,1.54,1228,140,0,4407,2390,0,Spring,5635,2530,0,True
2017,03/19,Orlando,2.06,1487,118,0,1185,1591,0,Spring,2672,1709,0,True
2017,03/12,Orlando,2.2,1292,144,0,761,1542,0,Spring,2053,1686,0,True
2017,03/05,Orlando,2.28,1879,207,0,968,1265,0,Spring,2847,1472,0,True
2017,02/26,Orlando,2.08,1562,107,0,1042,2106,0,Winter,2604,2213,0,True
2017,02/19,Orlando,1.81,1560,150,0,1844,1651,0,Winter,3404,1801,0,True
2017,02/12,Orlando,1.49,1199,62,0,3905,960,0,Winter,5104,1022,0,True
2017,02/05,Orlando,1.95,1715,210,0,1271,1414,0,Winter,2986,1624,0,True
2017,01/29,Orlando,1.47,580,63,0,1900,3512,0,Winter,2480,3575,0,True
2017,01/22,Orlando,1.26,527,78,0,3583,2552,0,Winter,4110,2630,0,True
2017,01/15,Orlando,1.26,539,112,0,3426,3245,0,Winter,3965,3357,0,True
2017,01/08,Orlando,1.26,521,35,0,2883,2988,0,Winter,3404,3023,0,True
2017,01/01,Orlando,1.28,558,26,0,2530,2572,0,Winter,3088,2598,0,True
2017,12/31,Philadelphia,1.6,1822,2761,4,17347,5,0,Winter,19169,2766,4,True
2017,12/24,Philadelphia,1.6,2183,3355,8,17975,51,0,Winter,20158,3406,8,True
2017,12/17,Philadelphia,1.59,2266,3684,3,16034,14,0,Winter,18300,3698,3,True
2017,12/10,Philadelphia,1.5,3846,4443,2,20578,76,0,Winter,24424,4519,2,True
2017,12/03,Philadelphia,1.63,3952,6132,11,15814,30,0,Winter,19766,6162,11,True
2017,11/26,Philadelphia,1.72,1488,2809,10,13787,11,0,Fall,15275,2820,10,True
2017,11/19,Philadelphia,1.75,1425,2936,12,15274,14,0,Fall,16699,2950,12,True
2017,11/12,Philadelphia,1.7,1980,3165,3,21066,49,0,Fall,23046,3214,3,True
2017,11/05,Philadelphia,1.7,1836,3409,0,22517,60,0,Fall,24353,3469,0,True
2017,10/29,Philadelphia,1.73,1757,4800,5,21134,34,0,Fall,22891,4834,5,True
2017,10/22,Philadelphia,1.65,1948,4354,24,25637,38,0,Fall,27585,4392,24,True
2017,10/15,Philadelphia,1.69,2588,3517,10,25669,64,0,Fall,28257,3581,10,True
2017,10/08,Philadelphia,1.58,2204,2935,6,30809,30,0,Fall,33013,2965,6,True
2017,10/01,Philadelphia,1.61,1696,3087,0,27251,0,0,Fall,28947,3087,0,True
2017,09/24,Philadelphia,1.57,1640,3883,28,28946,0,0,Fall,30586,3883,28,True
2017,09/17,Philadelphia,1.62,1230,4224,5,25236,0,0,Fall,26466,4224,5,True
2017,09/10,Philadelphia,1.67,1551,5487,5,27232,0,0,Fall,28783,5487,5,True
2017,09/03,Philadelphia,1.85,2163,5781,4,19137,0,0,Fall,21300,5781,4,True
2017,08/27,Philadelphia,1.92,1564,4602,12,15972,0,0,Summer,17536,4602,12,True
2017,08/20,Philadelphia,1.74,4535,7007,4,17249,0,0,Summer,21784,7007,4,True
2017,08/13,Philadelphia,1.79,1014,4880,11,16455,0,0,Summer,17469,4880,11,True
2017,08/06,Philadelphia,1.78,875,4130,3,15176,10,0,Summer,16051,4140,3,True
2017,07/30,Philadelphia,1.74,689,4317,6,16411,0,0,Summer,17100,4317,6,True
2017,07/23,Philadelphia,1.59,998,5290,7,21952,5,0,Summer,22950,5295,7,True
2017,07/16,Philadelphia,1.63,2091,6078,27,17372,3,0,Summer,19463,6081,27,True
2017,07/09,Philadelphia,2.36,968,4706,5,4994,0,0,Summer,5962,4706,5,True
2017,07/02,Philadelphia,2.33,1162,6156,7,6275,41,0,Summer,7437,6197,7,True
2017,06/25,Philadelphia,2.22,1527,6647,4,6487,0,0,Summer,8014,6647,4,True
2017,06/18,Philadelphia,1.89,8254,14019,11,7014,288,0,Summer,15268,14307,11,True
2017,06/11,Philadelphia,2.24,2738,6522,41,8565,174,0,Summer,11303,6696,41,True
2017,06/04,Philadelphia,2.01,5098,8574,6,7734,238,0,Summer,12832,8812,6,True
2017,05/28,Philadelphia,2.22,2251,6632,7,7043,20,0,Spring,9294,6652,7,True
2017,05/21,Philadelphia,2.25,2303,7258,0,7339,0,0,Spring,9642,7258,0,True
2017,05/14,Philadelphia,2.29,2785,6672,19,7988,0,0,Spring,10773,6672,19,True
2017,05/07,Philadelphia,2.25,2383,6793,18,7569,0,0,Spring,9952,6793,18,True
2017,04/30,Philadelphia,1.93,6569,9746,10,7286,0,0,Spring,13855,9746,10,True
2017,04/23,Philadelphia,2.17,2318,5746,0,7535,6,0,Spring,9853,5752,0,True
2017,04/16,Philadelphia,1.9,6434,11652,11,7475,192,0,Spring,13909,11844,11,True
2017,04/09,Philadelphia,2.23,2748,6194,3,6505,47,0,Spring,9253,6241,3,True
2017,04/02,Philadelphia,1.88,7379,10469,7,6059,23,0,Spring,13438,10492,7,True
2017,03/26,Philadelphia,2.18,3649,6356,2,6681,81,0,Spring,10330,6437,2,True
2017,03/19,Philadelphia,1.82,7444,11899,5,5945,184,0,Spring,13389,12083,5,True
2017,03/12,Philadelphia,2.33,2593,5686,15,5865,0,0,Spring,8458,5686,15,True
2017,03/05,Philadelphia,1.76,6022,9870,2,6421,231,0,Spring,12443,10101,2,True
2017,02/26,Philadelphia,1.68,4201,11005,10,5678,97,0,Winter,9879,11102,10,True
2017,02/19,Philadelphia,1.38,16636,41845,6,5710,62,0,Winter,22346,41907,6,True
2017,02/12,Philadelphia,1.91,1625,4126,0,6540,91,0,Winter,8165,4217,0,True
2017,02/05,Philadelphia,1.86,1770,3440,8,6544,98,0,Winter,8314,3538,8,True
2017,01/29,Philadelphia,1.9,1374,3255,9,6844,90,0,Winter,8218,3345,9,True
2017,01/22,Philadelphia,2.0,1524,3321,13,5279,60,0,Winter,6803,3381,13,True
2017,01/15,Philadelphia,2.0,1218,3918,15,6361,24,0,Winter,7579,3942,15,True
2017,01/08,Philadelphia,2.04,1445,3282,8,5425,67,0,Winter,6870,3349,8,True
2017,01/01,Philadelphia,1.98,1221,3644,5,3703,25,0,Winter,4924,3669,5,True
2017,12/31,PhoenixTucson,1.71,3000,2311,0,9148,3,0,Winter,12148,2314,0,True
2017,12/24,PhoenixTucson,1.61,5479,2129,0,10741,13,0,Winter,16220,2142,0,True
2017,12/17,PhoenixTucson,1.45,7127,2595,0,7301,9,0,Winter,14428,2604,0,True
2017,12/10,PhoenixTucson,1.8,1884,1989,0,7076,13,0,Winter,8960,2002,0,True
2017,12/03,PhoenixTucson,1.83,1850,1949,0,6523,0,0,Winter,8373,1949,0,True
2017,11/26,PhoenixTucson,1.87,2272,2038,0,6809,0,0,Fall,9081,2038,0,True
2017,11/19,PhoenixTucson,1.9,2224,2164,0,7651,17,0,Fall,9875,2181,0,True
2017,11/12,PhoenixTucson,1.9,2436,1918,0,8096,11,0,Fall,10532,1929,0,True
2017,11/05,PhoenixTucson,1.93,2207,1811,0,6267,4,0,Fall,8474,1815,0,True
2017,10/29,PhoenixTucson,1.89,2450,1503,0,8522,6,0,Fall,10972,1509,0,True
2017,10/22,PhoenixTucson,1.79,2184,508,0,8254,5,0,Fall,10438,513,0,True
2017,10/15,PhoenixTucson,1.77,2370,101,0,7703,21,0,Fall,10073,122,0,True
2017,10/08,PhoenixTucson,1.78,2749,124,0,8921,40,0,Fall,11670,164,0,True
2017,10/01,PhoenixTucson,1.8,2624,142,0,8270,34,0,Fall,10894,176,0,True
2017,09/24,PhoenixTucson,1.81,3328,270,0,8808,3,0,Fall,12136,273,0,True
2017,09/17,PhoenixTucson,1.82,3712,307,0,7976,12,0,Fall,11688,319,0,True
2017,09/10,PhoenixTucson,1.85,3667,633,0,7554,51,0,Fall,11221,684,0,True
2017,09/03,PhoenixTucson,1.86,3334,787,0,7097,57,0,Fall,10431,844,0,True
2017,08/27,PhoenixTucson,2.0,5358,2591,0,8501,54,0,Summer,13859,2645,0,True
2017,08/20,PhoenixTucson,2.19,2571,4024,0,4373,51,0,Summer,6944,4075,0,True
2017,08/13,PhoenixTucson,2.01,1907,3464,0,4431,92,0,Summer,6338,3556,0,True
2017,08/06,PhoenixTucson,1.84,2862,2743,0,5095,37,0,Summer,7957,2780,0,True
2017,07/30,PhoenixTucson,1.9,2777,3021,0,4821,5,0,Summer,7598,3026,0,True
2017,07/23,PhoenixTucson,2.04,2881,3345,0,4090,10,0,Summer,6971,3355,0,True
2017,07/16,PhoenixTucson,2.06,1986,3845,0,3929,399,0,Summer,5915,4244,0,True
2017,07/09,PhoenixTucson,1.84,2378,4376,0,2688,2411,0,Summer,5066,6787,0,True
2017,07/02,PhoenixTucson,2.02,3244,3587,0,1813,1593,0,Summer,5057,5180,0,True
2017,06/25,PhoenixTucson,1.94,3115,3197,0,1028,2141,0,Summer,4143,5338,0,True
2017,06/18,PhoenixTucson,1.97,3206,3475,0,1052,1985,0,Summer,4258,5460,0,True
2017,06/11,PhoenixTucson,1.94,3437,3283,0,1695,1849,0,Summer,5132,5132,0,True
2017,06/04,PhoenixTucson,1.88,3852,3456,0,1035,3349,0,Summer,4887,6805,0,True
2017,05/28,PhoenixTucson,1.94,3632,3316,0,729,2298,0,Spring,4361,5614,0,True
2017,05/21,PhoenixTucson,2.06,4146,3679,0,381,918,0,Spring,4527,4597,0,True
2017,05/14,PhoenixTucson,1.78,4909,4204,0,561,1126,0,Spring,5470,5330,0,True
2017,05/07,PhoenixTucson,1.82,4943,4878,0,693,1850,0,Spring,5636,6728,0,True
2017,04/30,PhoenixTucson,1.87,2979,5256,0,700,1261,0,Spring,3679,6517,0,True
2017,04/23,PhoenixTucson,1.67,3557,6186,0,1470,2464,0,Spring,5027,8650,0,True
2017,04/16,PhoenixTucson,1.51,3513,5291,0,6768,449,0,Spring,10281,5740,0,True
2017,04/09,PhoenixTucson,1.39,3717,4797,0,8212,97,0,Spring,11929,4894,0,True
2017,04/02,PhoenixTucson,1.38,3853,4420,0,8098,139,0,Spring,11951,4559,0,True
2017,03/26,PhoenixTucson,1.37,4708,5221,0,9863,308,0,Spring,14571,5529,0,True
2017,03/19,PhoenixTucson,1.35,5590,4605,0,7775,1585,0,Spring,13365,6190,0,True
2017,03/12,PhoenixTucson,1.38,4464,4728,2,8211,249,0,Spring,12675,4977,2,True
2017,03/05,PhoenixTucson,1.42,3983,4431,0,7854,194,0,Spring,11837,4625,0,True
2017,02/26,PhoenixTucson,1.22,5457,8709,0,11557,48,0,Winter,17014,8757,0,True
2017,02/19,PhoenixTucson,1.28,4394,4602,0,8929,7,0,Winter,13323,4609,0,True
2017,02/12,PhoenixTucson,1.46,4277,8117,0,9084,36,0,Winter,13361,8153,0,True
2017,02/05,PhoenixTucson,1.23,5981,5129,0,7773,0,0,Winter,13754,5129,0,True
2017,01/29,PhoenixTucson,1.49,4218,4389,0,5789,20,0,Winter,10007,4409,0,True
2017,01/22,PhoenixTucson,1.59,2433,3905,0,3964,29,0,Winter,6397,3934,0,True
2017,01/15,PhoenixTucson,1.49,3008,3123,0,5443,7,0,Winter,8451,3130,0,True
2017,01/08,PhoenixTucson,1.4,3667,4389,0,5140,47,0,Winter,8807,4436,0,True
2017,01/01,PhoenixTucson,1.88,2155,3030,1,2547,5,0,Winter,4702,3035,1,True
2017,12/31,Pittsburgh,1.4,941,13,0,9696,0,0,Winter,10637,13,0,True
2017,12/24,Pittsburgh,1.37,851,4,0,9608,0,0,Winter,10459,4,0,True
2017,12/17,Pittsburgh,1.37,935,5,0,8378,3,0,Winter,9313,8,0,True
2017,12/10,Pittsburgh,1.39,923,34,0,8431,0,0,Winter,9354,34,0,True
2017,12/03,Pittsburgh,1.36,1017,52,0,11265,6,0,Winter,12282,58,0,True
2017,11/26,Pittsburgh,1.37,965,10,0,8596,6,0,Fall,9561,16,0,True
2017,11/19,Pittsburgh,1.44,1176,31,0,9371,0,0,Fall,10547,31,0,True
2017,11/12,Pittsburgh,1.45,1130,17,0,10217,3,0,Fall,11347,20,0,True
2017,11/05,Pittsburgh,1.43,1191,12,0,10463,12,0,Fall,11654,24,0,True
2017,10/29,Pittsburgh,1.43,1095,26,0,10309,6,0,Fall,11404,32,0,True
2017,10/22,Pittsburgh,1.43,1240,10,0,10281,6,0,Fall,11521,16,0,True
2017,10/15,Pittsburgh,1.39,1168,81,0,11748,6,0,Fall,12916,87,0,True
2017,10/08,Pittsburgh,1.35,1108,24,0,14761,6,0,Fall,15869,30,0,True
2017,10/01,Pittsburgh,1.4,969,35,0,10814,0,0,Fall,11783,35,0,True
2017,09/24,Pittsburgh,1.42,1175,44,0,10584,3,0,Fall,11759,47,0,True
2017,09/17,Pittsburgh,1.43,1124,21,0,9111,0,0,Fall,10235,21,0,True
2017,09/10,Pittsburgh,1.48,1076,21,0,8167,3,0,Fall,9243,24,0,True
2017,09/03,Pittsburgh,1.5,1233,22,0,7267,0,0,Fall,8500,22,0,True
2017,08/27,Pittsburgh,1.49,1179,24,0,7193,0,0,Summer,8372,24,0,True
2017,08/20,Pittsburgh,1.47,990,14,0,7502,3,0,Summer,8492,17,0,True
2017,08/13,Pittsburgh,1.44,833,36,0,8273,6,0,Summer,9106,42,0,True
2017,08/06,Pittsburgh,1.43,861,28,0,9289,0,0,Summer,10150,28,0,True
2017,07/30,Pittsburgh,1.43,945,16,0,9156,6,0,Summer,10101,22,0,True
2017,07/23,Pittsburgh,1.28,388,22,0,10980,0,0,Summer,11368,22,0,True
2017,07/16,Pittsburgh,1.42,533,8,0,8029,0,0,Summer,8562,8,0,True
2017,07/09,Pittsburgh,1.58,965,11,0,6974,3,0,Summer,7939,14,0,True
2017,07/02,Pittsburgh,1.58,865,36,0,7094,6,0,Summer,7959,42,0,True
2017,06/25,Pittsburgh,1.54,165,0,0,2226,13,0,Summer,2391,13,0,True
2017,06/18,Pittsburgh,1.56,225,110,0,2304,3,0,Summer,2529,113,0,True
2017,06/11,Pittsburgh,1.57,261,0,0,3228,0,0,Summer,3489,0,0,True
2017,06/04,Pittsburgh,1.55,1034,27,0,7839,0,0,Summer,8873,27,0,True
2017,05/28,Pittsburgh,1.54,963,8,0,5740,31,0,Spring,6703,39,0,True
2017,05/21,Pittsburgh,1.52,403,3,0,2372,78,0,Spring,2775,81,0,True
2017,05/14,Pittsburgh,1.49,803,5,0,2743,550,0,Spring,3546,555,0,True
2017,05/07,Pittsburgh,1.51,937,25,0,5972,603,0,Spring,6909,628,0,True
2017,04/30,Pittsburgh,1.49,902,3,0,8233,754,0,Spring,9135,757,0,True
2017,04/23,Pittsburgh,1.51,1047,9,0,10000,684,0,Spring,11047,693,0,True
2017,04/16,Pittsburgh,1.51,981,14,0,10521,656,0,Spring,11502,670,0,True
2017,04/09,Pittsburgh,1.51,923,5,0,8364,599,0,Spring,9287,604,0,True
2017,04/02,Pittsburgh,1.51,805,5,0,8410,529,0,Spring,9215,534,0,True
2017,03/26,Pittsburgh,1.5,822,3,0,8681,541,0,Spring,9503,544,0,True
2017,03/19,Pittsburgh,1.47,800,22,0,8530,573,0,Spring,9330,595,0,True
2017,03/12,Pittsburgh,1.45,783,13,3,8571,581,0,Spring,9354,594,3,True
2017,03/05,Pittsburgh,1.43,817,29,0,5282,513,0,Spring,6099,542,0,True
2017,02/26,Pittsburgh,1.41,844,9,0,2247,482,0,Winter,3091,491,0,True
2017,02/19,Pittsburgh,1.45,828,3,0,7456,517,0,Winter,8284,520,0,True
2017,02/12,Pittsburgh,1.41,719,1,0,7777,435,0,Winter,8496,436,0,True
2017,02/05,Pittsburgh,1.4,683,15,0,6350,318,0,Winter,7033,333,0,True
2017,01/29,Pittsburgh,1.43,940,19,0,7464,527,0,Winter,8404,546,0,True
2017,01/22,Pittsburgh,1.4,768,5,0,7606,448,0,Winter,8374,453,0,True
2017,01/15,Pittsburgh,1.47,935,25,0,6577,373,0,Winter,7512,398,0,True
2017,01/08,Pittsburgh,1.45,901,23,0,7578,482,0,Winter,8479,505,0,True
2017,01/01,Pittsburgh,1.5,953,23,0,8432,315,0,Winter,9385,338,0,True
2017,12/31,Portland,1.51,3639,3807,0,1265,16973,7,Winter,4904,20780,7,True
2017,12/24,Portland,1.44,3151,5172,1,2146,26439,7,Winter,5297,31611,8,True
2017,12/17,Portland,1.54,1531,4505,5,4651,15753,13,Winter,6182,20258,18,True
2017,12/10,Portland,1.42,2456,5456,13,1496,25762,9,Winter,3952,31218,22,True
2017,12/03,Portland,1.52,2244,5328,0,989,21274,22,Winter,3233,26602,22,True
2017,11/26,Portland,1.47,1191,5754,3,1640,23642,71,Fall,2831,29396,74,True
2017,11/19,Portland,1.86,1267,3948,3,1427,14258,149,Fall,2694,18206,152,True
2017,11/12,Portland,1.86,1791,2951,0,1655,12367,3,Fall,3446,15318,3,True
2017,11/05,Portland,2.45,2068,2392,0,1473,11077,11,Fall,3541,13469,11,True
2017,10/29,Portland,2.49,2011,2499,0,1483,11325,16,Fall,3494,13824,16,True
2017,10/22,Portland,2.48,1737,2304,1,1490,10277,12,Fall,3227,12581,13,True
2017,10/15,Portland,2.71,1671,2449,6,1435,11233,0,Fall,3106,13682,6,True
2017,10/08,Portland,2.85,1802,2450,1,1712,10852,0,Fall,3514,13302,1,True
2017,10/01,Portland,2.86,188,2362,1,1314,12249,9,Fall,1502,14611,10,True
2017,09/24,Portland,2.81,179,1941,0,1399,9963,30,Fall,1578,11904,30,True
2017,09/17,Portland,2.83,236,2269,9,1404,10377,23,Fall,1640,12646,32,True
2017,09/10,Portland,2.84,182,1918,6,1401,11193,77,Fall,1583,13111,83,True
2017,09/03,Portland,2.84,176,2517,0,1616,13002,105,Fall,1792,15519,105,True
2017,08/27,Portland,2.85,197,2404,22,1238,11611,0,Summer,1435,14015,22,True
2017,08/20,Portland,2.57,582,4084,13,1081,9721,7,Summer,1663,13805,20,True
2017,08/13,Portland,2.33,3505,2495,0,1686,12340,0,Summer,5191,14835,0,True
2017,08/06,Portland,2.14,8822,3672,18,2466,12336,0,Summer,11288,16008,18,True
2017,07/30,Portland,2.29,6085,8191,25,1355,12513,0,Summer,7440,20704,25,True
2017,07/23,Portland,2.35,2185,10316,8,173,15565,0,Summer,2358,25881,8,True
2017,07/16,Portland,2.33,3130,8104,5,275,16673,0,Summer,3405,24777,5,True
2017,07/09,Portland,1.66,2463,11058,0,125,26104,0,Summer,2588,37162,0,True
2017,07/02,Portland,1.93,6316,10620,5,315,17991,0,Summer,6631,28611,5,True
2017,06/25,Portland,2.34,6207,9746,3,227,8351,0,Summer,6434,18097,3,True
2017,06/18,Portland,1.77,6068,4075,8,153,20170,0,Summer,6221,24245,8,True
2017,06/11,Portland,1.28,6406,4677,10,214,43511,0,Summer,6620,48188,10,True
2017,06/04,Portland,1.23,4687,5471,38,131,44667,0,Summer,4818,50138,38,True
2017,05/28,Portland,1.14,2592,9302,31,166,49151,0,Spring,2758,58453,31,True
2017,05/21,Portland,1.18,6687,3688,8,203,39779,0,Spring,6890,43467,8,True
2017,05/14,Portland,1.3,5546,3638,8,352,38729,0,Spring,5898,42367,8,True
2017,05/07,Portland,1.11,7740,4048,23,159,40247,0,Spring,7899,44295,23,True
2017,04/30,Portland,1.11,6225,3347,97,147,34708,0,Spring,6372,38055,97,True
2017,04/23,Portland,1.16,5451,3518,150,223,35930,0,Spring,5674,39448,150,True
2017,04/16,Portland,1.15,3515,5519,13,235,36518,0,Spring,3750,42037,13,True
2017,04/09,Portland,1.19,2571,8188,20,170,36548,0,Spring,2741,44736,20,True
2017,04/02,Portland,0.78,3229,8942,13,143,54422,0,Spring,3372,63364,13,True
2017,03/26,Portland,0.68,2870,5856,18,148,68486,0,Spring,3018,74342,18,True
2017,03/19,Portland,1.28,3656,5739,4,197,20798,0,Spring,3853,26537,4,True
2017,03/12,Portland,1.19,3661,3665,4,162,27032,0,Spring,3823,30697,4,True
2017,03/05,Portland,0.76,6745,5868,3,629,49534,0,Spring,7374,55402,3,True
2017,02/26,Portland,1.23,3411,5012,25,516,21837,0,Winter,3927,26849,25,True
2017,02/19,Portland,1.45,3759,4219,26,5968,11364,0,Winter,9727,15583,26,True
2017,02/12,Portland,1.59,2363,5774,26,7610,7127,0,Winter,9973,12901,26,True
2017,02/05,Portland,0.93,3761,5756,14,960,28451,0,Winter,4721,34207,14,True
2017,01/29,Portland,0.99,3147,4138,1,849,27562,0,Winter,3996,31700,1,True
2017,01/22,Portland,0.96,2500,4287,6,321,30626,0,Winter,2821,34913,6,True
2017,01/15,Portland,0.98,3851,4314,8,310,34210,0,Winter,4161,38524,8,True
2017,01/08,Portland,1.01,3790,6998,14,279,36473,0,Winter,4069,43471,14,True
2017,01/01,Portland,0.99,4842,3008,0,173,23803,0,Winter,5015,26811,0,True
2017,12/31,RaleighGreensboro,2.06,89,5189,203,7934,114,0,Winter,8023,5303,203,True
2017,12/24,RaleighGreensboro,2.12,131,4064,144,6726,24,0,Winter,6857,4088,144,True
2017,12/17,RaleighGreensboro,2.03,77,4392,150,5862,245,0,Winter,5939,4637,150,True
2017,12/10,RaleighGreensboro,2.12,59,4370,158,6323,112,0,Winter,6382,4482,158,True
2017,12/03,RaleighGreensboro,2.11,74,5140,214,4908,95,0,Winter,4982,5235,214,True
2017,11/26,RaleighGreensboro,2.18,143,3621,107,6069,138,0,Fall,6212,3759,107,True
2017,11/19,RaleighGreensboro,2.32,131,3703,93,5306,45,0,Fall,5437,3748,93,True
2017,11/12,RaleighGreensboro,2.32,95,4252,121,6614,160,0,Fall,6709,4412,121,True
2017,11/05,RaleighGreensboro,2.29,192,4978,173,6880,79,0,Fall,7072,5057,173,True
2017,10/29,RaleighGreensboro,1.92,181,4145,133,15201,174,0,Fall,15382,4319,133,True
2017,10/22,RaleighGreensboro,2.2,196,4273,109,10586,156,0,Fall,10782,4429,109,True
2017,10/15,RaleighGreensboro,2.53,442,3627,103,8866,232,0,Fall,9308,3859,103,True
2017,10/08,RaleighGreensboro,2.85,96,4599,125,7471,73,0,Fall,7567,4672,125,True
2017,10/01,RaleighGreensboro,3.0,140,4331,147,5873,249,0,Fall,6013,4580,147,True
2017,09/24,RaleighGreensboro,2.38,130,4470,116,9603,650,0,Fall,9733,5120,116,True
2017,09/17,RaleighGreensboro,2.92,89,4298,161,5319,428,0,Fall,5408,4726,161,True
2017,09/10,RaleighGreensboro,2.89,145,4564,137,8026,598,0,Fall,8171,5162,137,True
2017,09/03,RaleighGreensboro,2.97,169,4855,148,8315,563,0,Fall,8484,5418,148,True
2017,08/27,RaleighGreensboro,3.04,419,4851,145,6960,279,0,Summer,7379,5130,145,True
2017,08/20,RaleighGreensboro,2.65,384,4690,132,6470,333,0,Summer,6854,5023,132,True
2017,08/13,RaleighGreensboro,2.29,140,4659,135,6441,10,0,Summer,6581,4669,135,True
2017,08/06,RaleighGreensboro,2.51,138,5216,174,8220,383,0,Summer,8358,5599,174,True
2017,07/30,RaleighGreensboro,2.11,269,5176,195,3277,259,0,Summer,3546,5435,195,True
2017,07/23,RaleighGreensboro,1.95,159,5194,192,4642,314,0,Summer,4801,5508,192,True
2017,07/16,RaleighGreensboro,1.99,148,5715,222,4579,162,0,Summer,4727,5877,222,True
2017,07/09,RaleighGreensboro,1.97,101,5697,240,3907,887,0,Summer,4008,6584,240,True
2017,07/02,RaleighGreensboro,2.05,139,5019,219,2841,122,0,Summer,2980,5141,219,True
2017,06/25,RaleighGreensboro,1.95,173,5355,266,3840,452,0,Summer,4013,5807,266,True
2017,06/18,RaleighGreensboro,1.91,185,5446,288,4235,670,0,Summer,4420,6116,288,True
2017,06/11,RaleighGreensboro,2.03,296,5183,293,6798,769,0,Summer,7094,5952,293,True
2017,06/04,RaleighGreensboro,2.38,278,5303,280,2204,1215,0,Summer,2482,6518,280,True
2017,05/28,RaleighGreensboro,2.55,315,5326,364,2844,1422,0,Spring,3159,6748,364,True
2017,05/21,RaleighGreensboro,2.63,311,5215,311,2169,315,0,Spring,2480,5530,311,True
2017,05/14,RaleighGreensboro,2.44,182,6859,373,2133,220,0,Spring,2315,7079,373,True
2017,05/07,RaleighGreensboro,2.61,231,5522,307,3168,450,0,Spring,3399,5972,307,True
2017,04/30,RaleighGreensboro,2.76,302,4790,293,2644,360,0,Spring,2946,5150,293,True
2017,04/23,RaleighGreensboro,2.73,298,5183,256,2649,332,0,Spring,2947,5515,256,True
2017,04/16,RaleighGreensboro,2.24,202,6574,531,2488,450,0,Spring,2690,7024,531,True
2017,04/09,RaleighGreensboro,2.07,208,6330,401,3146,2026,0,Spring,3354,8356,401,True
2017,04/02,RaleighGreensboro,2.21,231,6808,416,3442,646,0,Spring,3673,7454,416,True
2017,03/26,RaleighGreensboro,1.94,236,6075,440,2563,1960,0,Spring,2799,8035,440,True
2017,03/19,RaleighGreensboro,1.83,251,4806,342,102,976,0,Spring,353,5782,342,True
2017,03/12,RaleighGreensboro,1.9,248,4782,360,1232,233,0,Spring,1480,5015,360,True
2017,03/05,RaleighGreensboro,1.54,310,3737,220,1772,1603,0,Spring,2082,5340,220,True
2017,02/26,RaleighGreensboro,1.56,241,4059,328,2617,1360,0,Winter,2858,5419,328,True
2017,02/19,RaleighGreensboro,1.55,169,4133,283,3118,1021,0,Winter,3287,5154,283,True
2017,02/12,RaleighGreensboro,1.54,239,4073,292,4476,829,0,Winter,4715,4902,292,True
2017,02/05,RaleighGreensboro,1.77,219,3567,282,5467,131,0,Winter,5686,3698,282,True
2017,01/29,RaleighGreensboro,1.63,210,5718,367,5464,639,0,Winter,5674,6357,367,True
2017,01/22,RaleighGreensboro,1.59,224,4242,477,5420,465,0,Winter,5644,4707,477,True
2017,01/15,RaleighGreensboro,1.62,185,5492,523,3842,167,0,Winter,4027,5659,523,True
2017,01/08,RaleighGreensboro,1.52,179,4508,369,6018,200,0,Winter,6197,4708,369,True
2017,01/01,RaleighGreensboro,1.78,121,3157,299,4271,187,0,Winter,4392,3344,299,True
2017,12/31,RichmondNorfolk,1.39,496,2962,94,9802,481,0,Winter,10298,3443,94,True
2017,12/24,RichmondNorfolk,1.41,527,2640,65,9557,175,0,Winter,10084,2815,65,True
2017,12/17,RichmondNorfolk,1.43,531,2596,60,9084,564,0,Winter,9615,3160,60,True
2017,12/10,RichmondNorfolk,1.4,365,2618,68,9023,310,0,Winter,9388,2928,68,True
2017,12/03,RichmondNorfolk,1.5,591,3015,62,7481,154,0,Winter,8072,3169,62,True
2017,11/26,RichmondNorfolk,1.58,441,2360,39,7353,90,0,Fall,7794,2450,39,True
2017,11/19,RichmondNorfolk,1.62,469,2619,36,6399,47,0,Fall,6868,2666,36,True
2017,11/12,RichmondNorfolk,1.57,632,2374,63,8314,110,0,Fall,8946,2484,63,True
2017,11/05,RichmondNorfolk,1.64,1262,2499,52,6880,169,0,Fall,8142,2668,52,True
2017,10/29,RichmondNorfolk,1.67,327,2184,36,7023,586,0,Fall,7350,2770,36,True
2017,10/22,RichmondNorfolk,1.62,370,2692,53,8792,366,0,Fall,9162,3058,53,True
2017,10/15,RichmondNorfolk,1.6,323,2409,66,11870,889,0,Fall,12193,3298,66,True
2017,10/08,RichmondNorfolk,1.56,416,2475,67,13577,123,0,Fall,13993,2598,67,True
2017,10/01,RichmondNorfolk,1.6,250,2545,18,10711,748,0,Fall,10961,3293,18,True
2017,09/24,RichmondNorfolk,1.76,257,2561,53,9417,1785,0,Fall,9674,4346,53,True
2017,09/17,RichmondNorfolk,1.59,336,2732,44,10680,1031,0,Fall,11016,3763,44,True
2017,09/10,RichmondNorfolk,2.0,526,3525,42,7880,1686,0,Fall,8406,5211,42,True
2017,09/03,RichmondNorfolk,2.05,654,3231,56,6523,2006,0,Fall,7177,5237,56,True
2017,08/27,RichmondNorfolk,1.96,517,3473,114,6903,853,0,Summer,7420,4326,114,True
2017,08/20,RichmondNorfolk,1.93,573,3458,59,7254,1464,0,Summer,7827,4922,59,True
2017,08/13,RichmondNorfolk,1.79,541,3363,112,7044,66,0,Summer,7585,3429,112,True
2017,08/06,RichmondNorfolk,1.66,513,3881,71,7343,933,0,Summer,7856,4814,71,True
2017,07/30,RichmondNorfolk,1.56,623,4519,138,8250,906,0,Summer,8873,5425,138,True
2017,07/23,RichmondNorfolk,1.45,490,4973,117,11553,684,0,Summer,12043,5657,117,True
2017,07/16,RichmondNorfolk,1.71,556,4078,201,6042,641,0,Summer,6598,4719,201,True
2017,07/09,RichmondNorfolk,1.81,720,5308,142,3341,2202,0,Summer,4061,7510,142,True
2017,07/02,RichmondNorfolk,1.84,649,4909,127,3123,1297,0,Summer,3772,6206,127,True
2017,06/25,RichmondNorfolk,1.64,656,5010,83,3312,3471,0,Summer,3968,8481,83,True
2017,06/18,RichmondNorfolk,1.78,709,4861,114,3346,1375,0,Summer,4055,6236,114,True
2017,06/11,RichmondNorfolk,1.56,666,4779,149,3456,2874,0,Summer,4122,7653,149,True
2017,06/04,RichmondNorfolk,1.72,740,4505,176,3221,2991,0,Summer,3961,7496,176,True
2017,05/28,RichmondNorfolk,1.6,771,4134,160,2792,4355,0,Spring,3563,8489,160,True
2017,05/21,RichmondNorfolk,1.52,536,4072,205,3079,3169,0,Spring,3615,7241,205,True
2017,05/14,RichmondNorfolk,1.72,561,4265,195,4343,401,0,Spring,4904,4666,195,True
2017,05/07,RichmondNorfolk,1.68,514,4408,216,2347,1676,0,Spring,2861,6084,216,True
2017,04/30,RichmondNorfolk,1.77,597,5030,184,3554,994,0,Spring,4151,6024,184,True
2017,04/23,RichmondNorfolk,1.65,641,4484,159,3311,1733,0,Spring,3952,6217,159,True
2017,04/16,RichmondNorfolk,1.46,649,4688,221,4128,2378,0,Spring,4777,7066,221,True
2017,04/09,RichmondNorfolk,1.04,659,4489,247,2985,7277,0,Spring,3644,11766,247,True
2017,04/02,RichmondNorfolk,1.41,783,4621,247,3507,2399,0,Spring,4290,7020,247,True
2017,03/26,RichmondNorfolk,1.06,674,4196,197,3345,6894,0,Spring,4019,11090,197,True
2017,03/19,RichmondNorfolk,1.55,757,3820,217,5310,1508,0,Spring,6067,5328,217,True
2017,03/12,RichmondNorfolk,1.46,599,3963,189,8086,1261,0,Spring,8685,5224,189,True
2017,03/05,RichmondNorfolk,1.06,635,3287,201,4416,5956,0,Spring,5051,9243,201,True
2017,02/26,RichmondNorfolk,1.01,721,3569,221,3127,6237,0,Winter,3848,9806,221,True
2017,02/19,RichmondNorfolk,1.24,522,3373,263,2202,2736,0,Winter,2724,6109,263,True
2017,02/12,RichmondNorfolk,1.12,424,3355,236,2421,4048,0,Winter,2845,7403,236,True
2017,02/05,RichmondNorfolk,1.42,527,2515,159,2198,1111,0,Winter,2725,3626,159,True
2017,01/29,RichmondNorfolk,1.32,592,3683,230,1829,1689,0,Winter,2421,5372,230,True
2017,01/22,RichmondNorfolk,1.27,436,2878,180,2901,1671,0,Winter,3337,4549,180,True
2017,01/15,RichmondNorfolk,1.56,434,2923,197,2491,0,0,Winter,2925,2923,197,True
2017,01/08,RichmondNorfolk,1.48,490,3085,205,4290,0,0,Winter,4780,3085,205,True
2017,01/01,RichmondNorfolk,1.62,584,2230,209,1895,0,0,Winter,2479,2230,209,True
2017,12/31,Roanoke,1.5,147,1513,0,3747,348,0,Winter,3894,1861,0,True
2017,12/24,Roanoke,1.54,210,1517,0,3652,330,0,Winter,3862,1847,0,True
2017,12/17,Roanoke,1.58,141,1437,0,3559,1248,0,Winter,3700,2685,0,True
2017,12/10,Roanoke,1.47,124,1438,0,5375,863,0,Winter,5499,2301,0,True
2017,12/03,Roanoke,1.42,195,1573,0,4785,257,0,Winter,4980,1830,0,True
2017,11/26,Roanoke,1.56,247,1535,0,4892,23,0,Fall,5139,1558,0,True
2017,11/19,Roanoke,1.54,231,1669,0,4633,0,0,Fall,4864,1669,0,True
2017,11/12,Roanoke,1.46,221,1429,0,6829,27,0,Fall,7050,1456,0,True
2017,11/05,Roanoke,1.5,163,1362,0,6386,342,0,Fall,6549,1704,0,True
2017,10/29,Roanoke,1.53,151,1301,0,7140,700,0,Fall,7291,2001,0,True
2017,10/22,Roanoke,1.53,262,1702,0,8539,387,0,Fall,8801,2089,0,True
2017,10/15,Roanoke,1.64,221,1582,0,7871,1076,0,Fall,8092,2658,0,True
2017,10/08,Roanoke,1.72,228,1675,0,6206,96,0,Fall,6434,1771,0,True
2017,10/01,Roanoke,1.83,271,1683,0,4753,1063,0,Fall,5024,2746,0,True
2017,09/24,Roanoke,2.08,226,1466,0,3593,2516,0,Fall,3819,3982,0,True
2017,09/17,Roanoke,1.9,232,1598,0,4434,1582,0,Fall,4666,3180,0,True
2017,09/10,Roanoke,2.19,258,1879,0,3563,2330,0,Fall,3821,4209,0,True
2017,09/03,Roanoke,2.27,358,1952,0,3207,2501,0,Fall,3565,4453,0,True
2017,08/27,Roanoke,2.17,311,2074,0,3087,1154,0,Summer,3398,3228,0,True
2017,08/20,Roanoke,2.08,352,1992,0,4347,1347,0,Summer,4699,3339,0,True
2017,08/13,Roanoke,2.0,295,1577,0,3871,272,0,Summer,4166,1849,0,True
2017,08/06,Roanoke,1.81,282,2012,0,3799,1145,0,Summer,4081,3157,0,True
2017,07/30,Roanoke,1.59,310,2134,0,3780,1561,0,Summer,4090,3695,0,True
2017,07/23,Roanoke,1.49,365,2772,0,5244,1518,0,Summer,5609,4290,0,True
2017,07/16,Roanoke,1.64,242,2225,0,3079,790,0,Summer,3321,3015,0,True
2017,07/09,Roanoke,1.62,327,2701,0,1517,4462,0,Summer,1844,7163,0,True
2017,07/02,Roanoke,1.78,212,2696,0,1472,1583,0,Summer,1684,4279,0,True
2017,06/25,Roanoke,1.42,253,2759,0,1646,4210,0,Summer,1899,6969,0,True
2017,06/18,Roanoke,1.61,385,3385,0,1493,2291,0,Summer,1878,5676,0,True
2017,06/11,Roanoke,1.35,279,3013,0,1556,3511,0,Summer,1835,6524,0,True
2017,06/04,Roanoke,1.51,317,2674,0,1765,5301,0,Summer,2082,7975,0,True
2017,05/28,Roanoke,1.37,297,2385,0,2087,7130,0,Spring,2384,9515,0,True
2017,05/21,Roanoke,1.59,336,2483,0,2335,2421,0,Spring,2671,4904,0,True
2017,05/14,Roanoke,1.81,230,2146,0,2915,545,0,Spring,3145,2691,0,True
2017,05/07,Roanoke,1.72,343,2428,0,2137,2600,0,Spring,2480,5028,0,True
2017,04/30,Roanoke,1.87,353,2775,0,2372,1296,0,Spring,2725,4071,0,True
2017,04/23,Roanoke,1.58,339,2413,0,2203,2570,0,Spring,2542,4983,0,True
2017,04/16,Roanoke,1.24,382,2457,0,2881,5177,0,Spring,3263,7634,0,True
2017,04/09,Roanoke,0.89,382,2930,0,2331,9557,0,Spring,2713,12487,0,True
2017,04/02,Roanoke,1.19,309,3031,0,2514,5044,0,Spring,2823,8075,0,True
2017,03/26,Roanoke,0.84,258,2811,0,2142,10117,0,Spring,2400,12928,0,True
2017,03/19,Roanoke,1.2,222,2146,0,2557,3057,0,Spring,2779,5203,0,True
2017,03/12,Roanoke,1.13,297,2537,0,2334,3797,0,Spring,2631,6334,0,True
2017,03/05,Roanoke,0.7,337,2105,0,2068,11275,0,Spring,2405,13380,0,True
2017,02/26,Roanoke,0.77,246,2759,0,2299,9418,0,Winter,2545,12177,0,True
2017,02/19,Roanoke,0.94,231,2672,0,1894,5225,0,Winter,2125,7897,0,True
2017,02/12,Roanoke,0.88,212,3013,0,1869,6319,0,Winter,2081,9332,0,True
2017,02/05,Roanoke,1.14,224,5303,0,1977,2237,0,Winter,2201,7540,0,True
2017,01/29,Roanoke,1.18,339,3824,0,1293,2475,0,Winter,1632,6299,0,True
2017,01/22,Roanoke,1.16,234,2584,0,2177,2529,0,Winter,2411,5113,0,True
2017,01/15,Roanoke,1.6,194,3113,0,2091,0,0,Winter,2285,3113,0,True
2017,01/08,Roanoke,1.61,263,2764,0,2213,0,0,Winter,2476,2764,0,True
2017,01/01,Roanoke,1.51,212,2337,0,1257,162,0,Winter,1469,2499,0,True
2017,12/31,Sacramento,1.61,3891,3759,0,2004,0,0,Winter,5895,3759,0,True
2017,12/24,Sacramento,1.68,2716,3016,0,2431,13,0,Winter,5147,3029,0,True
2017,12/17,Sacramento,1.72,1965,2423,0,2645,0,0,Winter,4610,2423,0,True
2017,12/10,Sacramento,1.75,1703,2659,0,2395,6,0,Winter,4098,2665,0,True
2017,12/03,Sacramento,1.69,2066,2100,0,2105,16,0,Winter,4171,2116,0,True
2017,11/26,Sacramento,1.72,2309,2494,0,2047,0,0,Fall,4356,2494,0,True
2017,11/19,Sacramento,1.69,2684,2463,0,2577,0,0,Fall,5261,2463,0,True
2017,11/12,Sacramento,1.81,2473,2399,0,1708,0,0,Fall,4181,2399,0,True
2017,11/05,Sacramento,1.74,2535,2818,0,3101,0,0,Fall,5636,2818,0,True
2017,10/29,Sacramento,1.86,2787,2909,0,1644,0,0,Fall,4431,2909,0,True
2017,10/22,Sacramento,1.81,2679,2828,0,2548,3,0,Fall,5227,2831,0,True
2017,10/15,Sacramento,1.92,2439,3012,0,1237,0,0,Fall,3676,3012,0,True
2017,10/08,Sacramento,1.84,2487,2762,0,2551,3,0,Fall,5038,2765,0,True
2017,10/01,Sacramento,1.86,2464,2785,0,2077,6,0,Fall,4541,2791,0,True
2017,09/24,Sacramento,1.89,2672,3111,0,1557,3,0,Fall,4229,3114,0,True
2017,09/17,Sacramento,1.92,3470,3797,0,1907,0,0,Fall,5377,3797,0,True
2017,09/10,Sacramento,1.96,3074,3484,0,1476,0,0,Fall,4550,3484,0,True
2017,09/03,Sacramento,2.15,2654,3298,0,2277,0,0,Fall,4931,3298,0,True
2017,08/27,Sacramento,2.49,2222,2802,0,2172,0,0,Summer,4394,2802,0,True
2017,08/20,Sacramento,2.33,2354,2815,1,3013,3,0,Summer,5367,2818,1,True
2017,08/13,Sacramento,2.09,2079,3059,0,3565,3,0,Summer,5644,3062,0,True
2017,08/06,Sacramento,1.99,1620,2516,0,2741,8,0,Summer,4361,2524,0,True
2017,07/30,Sacramento,1.86,811,2096,0,2755,11,0,Summer,3566,2107,0,True
2017,07/23,Sacramento,1.97,1474,2451,0,3115,0,0,Summer,4589,2451,0,True
2017,07/16,Sacramento,2.19,1251,2443,0,1408,0,0,Summer,2659,2443,0,True
2017,07/09,Sacramento,2.36,1253,1982,0,322,5,0,Summer,1575,1987,0,True
2017,07/02,Sacramento,2.32,1472,2437,2,656,3,0,Summer,2128,2440,2,True
2017,06/25,Sacramento,2.37,2005,2820,0,796,3,0,Summer,2801,2823,0,True
2017,06/18,Sacramento,2.48,2609,3616,0,824,7,0,Summer,3433,3623,0,True
2017,06/11,Sacramento,2.5,2177,3527,0,796,1,0,Summer,2973,3528,0,True
2017,06/04,Sacramento,2.43,2184,3605,0,1029,1,0,Summer,3213,3606,0,True
2017,05/28,Sacramento,2.46,2305,3465,0,882,9,0,Spring,3187,3474,0,True
2017,05/21,Sacramento,2.4,2135,2881,1,896,40,0,Spring,3031,2921,1,True
2017,05/14,Sacramento,2.43,1982,2481,2,785,3,0,Spring,2767,2484,2,True
2017,05/07,Sacramento,2.52,1861,3058,0,401,0,0,Spring,2262,3058,0,True
2017,04/30,Sacramento,2.39,2222,3238,1,865,3,0,Spring,3087,3241,1,True
2017,04/23,Sacramento,2.29,1967,3979,0,817,0,0,Spring,2784,3979,0,True
2017,04/16,Sacramento,2.35,2025,3501,0,743,3,0,Spring,2768,3504,0,True
2017,04/09,Sacramento,2.37,2155,3467,0,653,6,0,Spring,2808,3473,0,True
2017,04/02,Sacramento,2.31,2073,3328,0,841,0,0,Spring,2914,3328,0,True
2017,03/26,Sacramento,2.44,2084,3599,0,824,0,0,Spring,2908,3599,0,True
2017,03/19,Sacramento,2.46,1795,3449,0,726,0,0,Spring,2521,3449,0,True
2017,03/12,Sacramento,2.36,1643,3655,2,720,0,0,Spring,2363,3655,2,True
2017,03/05,Sacramento,2.5,1736,3853,0,466,0,0,Spring,2202,3853,0,True
2017,02/26,Sacramento,2.06,1808,4379,0,428,0,0,Winter,2236,4379,0,True
2017,02/19,Sacramento,2.32,1718,3242,1,413,0,0,Winter,2131,3242,1,True
2017,02/12,Sacramento,2.25,1708,3229,0,621,0,0,Winter,2329,3229,0,True
2017,02/05,Sacramento,1.6,2241,5057,0,413,0,0,Winter,2654,5057,0,True
2017,01/29,Sacramento,2.02,1652,4786,12,296,0,0,Winter,1948,4786,12,True
2017,01/22,Sacramento,1.89,1800,3930,0,283,0,0,Winter,2083,3930,0,True
2017,01/15,Sacramento,2.31,1502,3492,0,265,6,0,Winter,1767,3498,0,True
2017,01/08,Sacramento,2.15,1630,3665,0,396,0,0,Winter,2026,3665,0,True
2017,01/01,Sacramento,2.24,1906,3364,0,364,0,0,Winter,2270,3364,0,True
2017,12/31,SanDiego,2.0,2721,7973,0,3455,0,0,Winter,6176,7973,0,True
2017,12/24,SanDiego,1.82,849,9042,0,5384,0,0,Winter,6233,9042,0,True
2017,12/17,SanDiego,1.54,1020,8775,0,4251,0,0,Winter,5271,8775,0,True
2017,12/10,SanDiego,2.05,2436,6895,0,3952,0,0,Winter,6388,6895,0,True
2017,12/03,SanDiego,1.79,761,7500,0,5211,3,0,Winter,5972,7503,0,True
2017,11/26,SanDiego,2.17,468,7239,0,3852,0,0,Fall,4320,7239,0,True
2017,11/19,SanDiego,2.17,692,7420,0,4236,0,0,Fall,4928,7420,0,True
2017,11/12,SanDiego,2.13,770,6108,0,4618,0,0,Fall,5388,6108,0,True
2017,11/05,SanDiego,1.6,761,10819,0,4870,0,0,Fall,5631,10819,0,True
2017,10/29,SanDiego,2.13,863,6224,0,5092,0,0,Fall,5955,6224,0,True
2017,10/22,SanDiego,2.15,951,6964,0,5096,0,0,Fall,6047,6964,0,True
2017,10/15,SanDiego,2.25,713,6513,0,4234,11,0,Fall,4947,6524,0,True
2017,10/08,SanDiego,2.33,754,8162,0,4096,0,0,Fall,4850,8162,0,True
2017,10/01,SanDiego,2.27,1595,8857,0,3056,0,0,Fall,4651,8857,0,True
2017,09/24,SanDiego,2.23,2804,10041,0,1327,0,0,Fall,4131,10041,0,True
2017,09/17,SanDiego,2.39,2229,9322,0,1121,0,0,Fall,3350,9322,0,True
2017,09/10,SanDiego,2.37,1925,9140,0,1705,0,0,Fall,3630,9140,0,True
2017,09/03,SanDiego,2.01,1139,10923,0,3102,0,0,Fall,4241,10923,0,True
2017,08/27,SanDiego,2.57,1397,7309,0,2427,3,0,Summer,3824,7312,0,True
2017,08/20,SanDiego,2.42,1007,7203,0,5871,30,0,Summer,6878,7233,0,True
2017,08/13,SanDiego,2.32,930,6082,0,5495,3,0,Summer,6425,6085,0,True
2017,08/06,SanDiego,2.37,1047,6973,0,4960,0,0,Summer,6007,6973,0,True
2017,07/30,SanDiego,2.37,819,6870,0,4871,33,0,Summer,5690,6903,0,True
2017,07/23,SanDiego,2.31,784,8530,0,4310,3,0,Summer,5094,8533,0,True
2017,07/16,SanDiego,2.3,693,9183,0,4179,3,0,Summer,4872,9186,0,True
2017,07/09,SanDiego,1.91,1037,10325,0,7885,0,0,Summer,8922,10325,0,True
2017,07/02,SanDiego,2.0,1108,11656,0,7124,24,0,Summer,8232,11680,0,True
2017,06/25,SanDiego,1.73,975,8290,0,8478,0,0,Summer,9453,8290,0,True
2017,06/18,SanDiego,1.8,1067,8361,0,7400,32,0,Summer,8467,8393,0,True
2017,06/11,SanDiego,2.06,1163,8506,1,2849,29,0,Summer,4012,8535,1,True
2017,06/04,SanDiego,1.71,1135,12172,1,5392,0,0,Summer,6527,12172,1,True
2017,05/28,SanDiego,1.91,843,9946,1,6629,0,0,Spring,7472,9946,1,True
2017,05/21,SanDiego,2.05,853,9892,1,4700,3,0,Spring,5553,9895,1,True
2017,05/14,SanDiego,2.22,1455,9485,1,1621,30,0,Spring,3076,9515,1,True
2017,05/07,SanDiego,1.72,1347,14683,1,5703,61,0,Spring,7050,14744,1,True
2017,04/30,SanDiego,1.83,1461,10052,1,5252,1058,0,Spring,6713,11110,1,True
2017,04/23,SanDiego,1.97,1088,9477,1,719,3253,0,Spring,1807,12730,1,True
2017,04/16,SanDiego,2.08,940,9921,0,560,2620,0,Spring,1500,12541,0,True
2017,04/09,SanDiego,1.94,1208,9538,1,915,2122,0,Spring,2123,11660,1,True
2017,04/02,SanDiego,1.88,1779,10473,0,2792,1128,0,Spring,4571,11601,0,True
2017,03/26,SanDiego,2.06,2883,10030,0,686,787,0,Spring,3569,10817,0,True
2017,03/19,SanDiego,1.59,927,13605,4,1083,6548,0,Spring,2010,20153,4,True
2017,03/12,SanDiego,1.72,991,9806,4,2359,4063,0,Spring,3350,13869,4,True
2017,03/05,SanDiego,1.42,1137,8737,0,736,10005,0,Spring,1873,18742,0,True
2017,02/26,SanDiego,1.42,1099,10427,0,3657,4871,0,Winter,4756,15298,0,True
2017,02/19,SanDiego,1.4,1266,10960,0,7393,161,0,Winter,8659,11121,0,True
2017,02/12,SanDiego,1.66,1014,7049,0,856,162,0,Winter,1870,7211,0,True
2017,02/05,SanDiego,1.55,1784,10882,0,1270,157,0,Winter,3054,11039,0,True
2017,01/29,SanDiego,1.21,1477,8949,4,3304,4454,0,Winter,4781,13403,4,True
2017,01/22,SanDiego,1.73,2019,6869,0,626,1326,0,Winter,2645,8195,0,True
2017,01/15,SanDiego,1.82,2529,7637,0,993,418,0,Winter,3522,8055,0,True
2017,01/08,SanDiego,1.52,2363,9429,0,3266,1717,0,Winter,5629,11146,0,True
2017,01/01,SanDiego,1.45,1385,8618,0,957,4791,0,Winter,2342,13409,0,True
2017,12/31,SanFrancisco,1.52,14037,8786,0,1871,3,0,Winter,15908,8789,0,True
2017,12/24,SanFrancisco,2.01,7759,8376,0,2404,0,0,Winter,10163,8376,0,True
2017,12/17,SanFrancisco,2.1,7411,8344,0,2094,0,0,Winter,9505,8344,0,True
2017,12/10,SanFrancisco,2.27,7080,7071,0,990,0,0,Winter,8070,7071,0,True
2017,12/03,SanFrancisco,2.07,8275,5745,0,712,4,0,Winter,8987,5749,0,True
2017,11/26,SanFrancisco,2.06,8640,6277,0,783,0,0,Fall,9423,6277,0,True
2017,11/19,SanFrancisco,2.06,9956,6931,0,734,0,0,Fall,10690,6931,0,True
2017,11/12,SanFrancisco,2.07,10941,7789,0,608,4,0,Fall,11549,7793,0,True
2017,11/05,SanFrancisco,2.05,10983,8063,0,1161,4,0,Fall,12144,8067,0,True
2017,10/29,SanFrancisco,2.09,11099,8152,0,694,4,0,Fall,11793,8156,0,True
2017,10/22,SanFrancisco,2.08,9739,7981,0,1132,0,0,Fall,10871,7981,0,True
2017,10/15,SanFrancisco,2.09,10237,8211,0,577,0,0,Fall,10814,8211,0,True
2017,10/08,SanFrancisco,2.07,10832,8426,0,1077,0,0,Fall,11909,8426,0,True
2017,10/01,SanFrancisco,2.04,11899,9824,0,978,0,0,Fall,12877,9824,0,True
2017,09/24,SanFrancisco,2.06,10381,8026,0,688,0,0,Fall,11069,8026,0,True
2017,09/17,SanFrancisco,2.04,18705,12704,0,781,0,0,Fall,19486,12704,0,True
2017,09/10,SanFrancisco,2.05,16389,11491,0,454,0,0,Fall,16843,11491,0,True
2017,09/03,SanFrancisco,2.08,12620,9443,0,767,4,0,Fall,13387,9447,0,True
2017,08/27,SanFrancisco,3.0,10517,7907,0,900,3,0,Summer,11417,7910,0,True
2017,08/20,SanFrancisco,2.93,9571,7792,0,4161,0,0,Summer,13732,7792,0,True
2017,08/13,SanFrancisco,2.57,8857,8680,0,4758,0,0,Summer,13615,8680,0,True
2017,08/06,SanFrancisco,2.33,3753,5234,0,4356,6,0,Summer,8109,5240,0,True
2017,07/30,SanFrancisco,2.14,1825,3948,0,4326,9,0,Summer,6151,3957,0,True
2017,07/23,SanFrancisco,2.44,5952,6286,0,4577,15,0,Summer,10529,6301,0,True
2017,07/16,SanFrancisco,2.4,4163,5797,0,4137,1,0,Summer,8300,5798,0,True
2017,07/09,SanFrancisco,2.45,2009,3654,2,2622,22,0,Summer,4631,3676,2,True
2017,07/02,SanFrancisco,2.59,4003,5495,0,2765,15,0,Summer,6768,5510,0,True
2017,06/25,SanFrancisco,2.66,5755,6914,0,3010,10,0,Summer,8765,6924,0,True
2017,06/18,SanFrancisco,2.76,10701,10234,0,3069,31,0,Summer,13770,10265,0,True
2017,06/11,SanFrancisco,2.77,10768,11690,4,3338,4,0,Summer,14106,11694,4,True
2017,06/04,SanFrancisco,2.72,9678,10552,2,3609,53,0,Summer,13287,10605,2,True
2017,05/28,SanFrancisco,2.73,10640,10979,8,3201,22,0,Spring,13841,11001,8,True
2017,05/21,SanFrancisco,2.65,9604,10281,4,2642,25,0,Spring,12246,10306,4,True
2017,05/14,SanFrancisco,2.64,8772,8839,2,3204,22,0,Spring,11976,8861,2,True
2017,05/07,SanFrancisco,2.54,7404,8501,0,3475,19,0,Spring,10879,8520,0,True
2017,04/30,SanFrancisco,2.58,9036,10350,2,3391,10,0,Spring,12427,10360,2,True
2017,04/23,SanFrancisco,2.56,7818,10178,2,3322,8,0,Spring,11140,10186,2,True
2017,04/16,SanFrancisco,2.59,9013,10581,5,3388,43,0,Spring,12401,10624,5,True
2017,04/09,SanFrancisco,2.54,7773,9709,0,3727,21,0,Spring,11500,9730,0,True
2017,04/02,SanFrancisco,2.59,8314,9720,0,3268,0,0,Spring,11582,9720,0,True
2017,03/26,SanFrancisco,2.83,7369,9827,0,2974,0,0,Spring,10343,9827,0,True
2017,03/19,SanFrancisco,2.88,6332,9140,11,3202,0,0,Spring,9534,9140,11,True
2017,03/12,SanFrancisco,2.9,6727,7914,0,3043,0,0,Spring,9770,7914,0,True
2017,03/05,SanFrancisco,2.92,8013,10054,0,3150,0,0,Spring,11163,10054,0,True
2017,02/26,SanFrancisco,2.52,6707,8785,0,3260,0,0,Winter,9967,8785,0,True
2017,02/19,SanFrancisco,2.58,7333,8809,0,3060,0,0,Winter,10393,8809,0,True
2017,02/12,SanFrancisco,2.59,7271,8960,2,3198,0,0,Winter,10469,8960,2,True
2017,02/05,SanFrancisco,1.61,10715,12410,8,2635,0,0,Winter,13350,12410,8,True
2017,01/29,SanFrancisco,2.7,7224,7671,2,2809,0,0,Winter,10033,7671,2,True
2017,01/22,SanFrancisco,2.03,8435,9045,2,2957,0,0,Winter,11392,9045,2,True
2017,01/15,SanFrancisco,2.7,5875,8476,0,2841,9,0,Winter,8716,8485,0,True
2017,01/08,SanFrancisco,2.58,6273,8466,0,3347,9,0,Winter,9620,8475,0,True
2017,01/01,SanFrancisco,2.54,7268,10452,0,2189,0,0,Winter,9457,10452,0,True
2017,12/31,Seattle,1.24,1450,29692,23,1469,50019,94,Winter,2919,79711,117,True
2017,12/24,Seattle,1.75,928,13694,26,3377,24684,95,Winter,4305,38378,121,True
2017,12/17,Seattle,1.25,872,24764,28,22511,32512,54,Winter,23383,57276,82,True
2017,12/10,Seattle,1.07,1035,39167,43,4627,99798,190,Winter,5662,138965,233,True
2017,12/03,Seattle,1.19,1019,29524,55,1978,65389,62,Winter,2997,94913,117,True
2017,11/26,Seattle,1.76,582,11806,46,1202,21536,129,Fall,1784,33342,175,True
2017,11/19,Seattle,2.03,792,10568,38,985,15159,27,Fall,1777,25727,65,True
2017,11/12,Seattle,2.06,932,10692,23,1219,13948,11,Fall,2151,24640,34,True
2017,11/05,Seattle,2.34,788,8753,7,1001,12312,9,Fall,1789,21065,16,True
2017,10/29,Seattle,2.43,1118,11280,16,1095,13069,11,Fall,2213,24349,27,True
2017,10/22,Seattle,2.3,1276,12683,15,1354,13871,29,Fall,2630,26554,44,True
2017,10/15,Seattle,2.69,1121,9881,25,1049,13434,0,Fall,2170,23315,25,True
2017,10/08,Seattle,2.8,1079,11176,7,1402,14045,7,Fall,2481,25221,14,True
2017,10/01,Seattle,2.86,770,9708,7,1062,14155,14,Fall,1832,23863,21,True
2017,09/24,Seattle,2.83,846,8040,18,1385,12885,61,Fall,2231,20925,79,True
2017,09/17,Seattle,2.86,883,8062,7,1109,11692,16,Fall,1992,19754,23,True
2017,09/10,Seattle,2.87,1051,10952,8,1109,14018,64,Fall,2160,24970,72,True
2017,09/03,Seattle,2.89,1289,12808,8,938,15793,15,Fall,2227,28601,23,True
2017,08/27,Seattle,2.96,1134,11055,12,1079,13563,0,Summer,2213,24618,12,True
2017,08/20,Seattle,2.87,1189,11984,16,1107,10370,2,Summer,2296,22354,18,True
2017,08/13,Seattle,2.65,1215,11028,7,1580,13312,4,Summer,2795,24340,11,True
2017,08/06,Seattle,2.58,1335,13120,36,1685,13800,0,Summer,3020,26920,36,True
2017,07/30,Seattle,2.6,1131,13395,76,1377,12605,0,Summer,2508,26000,76,True
2017,07/23,Seattle,2.61,729,12909,11,484,11167,0,Summer,1213,24076,11,True
2017,07/16,Seattle,2.61,1003,12855,20,611,13543,0,Summer,1614,26398,20,True
2017,07/09,Seattle,2.12,1411,16587,24,281,21753,0,Summer,1692,38340,24,True
2017,07/02,Seattle,2.35,1634,18664,43,262,13664,0,Summer,1896,32328,43,True
2017,06/25,Seattle,2.65,1739,21572,46,290,8246,0,Summer,2029,29818,46,True
2017,06/18,Seattle,1.83,1540,14636,33,302,27973,0,Summer,1842,42609,33,True
2017,06/11,Seattle,1.6,1631,14860,0,433,43084,0,Summer,2064,57944,0,True
2017,06/04,Seattle,1.45,2133,15783,0,263,45961,0,Summer,2396,61744,0,True
2017,05/28,Seattle,1.46,2231,12440,0,335,44370,0,Spring,2566,56810,0,True
2017,05/21,Seattle,1.53,3074,11527,7,795,39622,0,Spring,3869,51149,7,True
2017,05/14,Seattle,1.62,1601,13061,41,1325,33262,0,Spring,2926,46323,41,True
2017,05/07,Seattle,1.51,1762,16113,10,497,38193,0,Spring,2259,54306,10,True
2017,04/30,Seattle,1.39,1574,12759,4,698,40883,0,Spring,2272,53642,4,True
2017,04/23,Seattle,1.39,1787,12544,4,495,41411,0,Spring,2282,53955,4,True
2017,04/16,Seattle,1.45,1647,14021,10,502,38581,0,Spring,2149,52602,10,True
2017,04/09,Seattle,1.44,1602,13738,4,514,36788,0,Spring,2116,50526,4,True
2017,04/02,Seattle,1.02,1334,18147,45,349,56979,0,Spring,1683,75126,45,True
2017,03/26,Seattle,0.7,1221,13622,6,456,102073,0,Spring,1677,115695,6,True
2017,03/19,Seattle,1.52,1575,14762,4,787,28507,0,Spring,2362,43269,4,True
2017,03/12,Seattle,1.18,1547,19478,16,1126,42936,0,Spring,2673,62414,16,True
2017,03/05,Seattle,0.99,959,14930,15,601,51572,0,Spring,1560,66502,15,True
2017,02/26,Seattle,1.58,821,12370,13,1732,23348,0,Winter,2553,35718,13,True
2017,02/19,Seattle,2.26,800,14582,12,9407,4222,0,Winter,10207,18804,12,True
2017,02/12,Seattle,1.79,684,16188,25,9270,11927,0,Winter,9954,28115,25,True
2017,02/05,Seattle,0.98,906,10333,18,541,39661,0,Winter,1447,49994,18,True
2017,01/29,Seattle,1.22,636,10502,58,1544,33002,0,Winter,2180,43504,58,True
2017,01/22,Seattle,1.32,654,10318,9,557,28239,0,Winter,1211,38557,9,True
2017,01/15,Seattle,1.25,447,11513,1,690,35661,0,Winter,1137,47174,1,True
2017,01/08,Seattle,1.23,537,11503,6,583,38311,0,Winter,1120,49814,6,True
2017,01/01,Seattle,1.23,486,11213,2,510,29168,0,Winter,996,40381,2,True
2017,12/31,SouthCarolina,1.36,72,4072,116,11889,354,0,Winter,11961,4426,116,True
2017,12/24,SouthCarolina,1.48,118,3514,79,8708,341,0,Winter,8826,3855,79,True
2017,12/17,SouthCarolina,1.44,69,3091,78,9296,653,0,Winter,9365,3744,78,True
2017,12/10,SouthCarolina,1.42,84,2990,70,9440,497,0,Winter,9524,3487,70,True
2017,12/03,SouthCarolina,1.49,79,3753,98,8449,288,0,Winter,8528,4041,98,True
2017,11/26,SouthCarolina,1.54,81,3171,45,8877,482,0,Fall,8958,3653,45,True
2017,11/19,SouthCarolina,1.56,89,3201,85,8899,286,0,Fall,8988,3487,85,True
2017,11/12,SouthCarolina,1.64,75,3360,39,10426,473,0,Fall,10501,3833,39,True
2017,11/05,SouthCarolina,1.68,125,3697,112,9239,561,0,Fall,9364,4258,112,True
2017,10/29,SouthCarolina,1.69,132,2891,66,10955,1216,0,Fall,11087,4107,66,True
2017,10/22,SouthCarolina,1.7,183,3156,87,11103,483,0,Fall,11286,3639,87,True
2017,10/15,SouthCarolina,1.78,231,3011,76,11628,201,0,Fall,11859,3212,76,True
2017,10/08,SouthCarolina,2.04,136,3139,60,10838,227,0,Fall,10974,3366,60,True
2017,10/01,SouthCarolina,2.15,182,3400,81,8506,751,0,Fall,8688,4151,81,True
2017,09/24,SouthCarolina,2.1,138,3523,102,8975,1975,0,Fall,9113,5498,102,True
2017,09/17,SouthCarolina,2.21,184,3603,86,6711,1264,0,Fall,6895,4867,86,True
2017,09/10,SouthCarolina,2.02,178,2712,113,11246,467,0,Fall,11424,3179,113,True
2017,09/03,SouthCarolina,2.11,207,3882,127,8988,1128,0,Fall,9195,5010,127,True
2017,08/27,SouthCarolina,2.03,225,3924,86,9260,574,0,Summer,9485,4498,86,True
2017,08/20,SouthCarolina,1.88,322,3927,88,10329,195,0,Summer,10651,4122,88,True
2017,08/13,SouthCarolina,1.78,195,3482,140,9842,17,0,Summer,10037,3499,140,True
2017,08/06,SouthCarolina,1.74,205,3665,135,7694,263,0,Summer,7899,3928,135,True
2017,07/30,SouthCarolina,1.57,178,3739,83,9811,662,0,Summer,9989,4401,83,True
2017,07/23,SouthCarolina,1.81,92,4559,113,7206,879,0,Summer,7298,5438,113,True
2017,07/16,SouthCarolina,1.83,69,4666,116,6789,445,0,Summer,6858,5111,116,True
2017,07/09,SouthCarolina,1.76,116,5293,155,7728,1695,0,Summer,7844,6988,155,True
2017,07/02,SouthCarolina,1.82,218,5553,171,7340,1539,0,Summer,7558,7092,171,True
2017,06/25,SouthCarolina,1.67,191,5205,117,9122,2639,0,Summer,9313,7844,117,True
2017,06/18,SouthCarolina,1.72,235,5136,132,6835,1476,0,Summer,7070,6612,132,True
2017,06/11,SouthCarolina,1.61,567,4048,139,7496,2645,0,Summer,8063,6693,139,True
2017,06/04,SouthCarolina,1.89,761,4252,128,2476,1925,0,Summer,3237,6177,128,True
2017,05/28,SouthCarolina,1.97,790,4574,201,953,2417,0,Spring,1743,6991,201,True
2017,05/21,SouthCarolina,1.86,744,4624,193,916,2298,0,Spring,1660,6922,193,True
2017,05/14,SouthCarolina,1.91,998,5280,259,277,1111,0,Spring,1275,6391,259,True
2017,05/07,SouthCarolina,1.8,352,4779,119,270,1526,0,Spring,622,6305,119,True
2017,04/30,SouthCarolina,1.87,600,4505,112,194,1658,0,Spring,794,6163,112,True
2017,04/23,SouthCarolina,1.97,964,4213,200,173,1035,0,Spring,1137,5248,200,True
2017,04/16,SouthCarolina,1.69,645,5275,253,255,1332,0,Spring,900,6607,253,True
2017,04/09,SouthCarolina,1.4,669,5400,283,1361,4566,0,Spring,2030,9966,283,True
2017,04/02,SouthCarolina,1.5,502,5423,218,964,3176,0,Spring,1466,8599,218,True
2017,03/26,SouthCarolina,1.7,709,4844,260,220,1777,0,Spring,929,6621,260,True
2017,03/19,SouthCarolina,1.34,483,4025,205,169,3886,0,Spring,652,7911,205,True
2017,03/12,SouthCarolina,1.38,758,3866,203,3672,3050,0,Spring,4430,6916,203,True
2017,03/05,SouthCarolina,0.99,796,3353,211,4300,8551,0,Spring,5096,11904,211,True
2017,02/26,SouthCarolina,1.13,580,3513,228,4931,5649,0,Winter,5511,9162,228,True
2017,02/19,SouthCarolina,1.4,627,3342,139,4986,2087,0,Winter,5613,5429,139,True
2017,02/12,SouthCarolina,1.38,430,3098,152,4690,1490,0,Winter,5120,4588,152,True
2017,02/05,SouthCarolina,1.45,488,3011,182,4162,1272,0,Winter,4650,4283,182,True
2017,01/29,SouthCarolina,1.43,332,3466,214,4009,1184,0,Winter,4341,4650,214,True
2017,01/22,SouthCarolina,1.44,321,3190,234,3826,945,0,Winter,4147,4135,234,True
2017,01/15,SouthCarolina,1.45,344,3697,253,4430,967,0,Winter,4774,4664,253,True
2017,01/08,SouthCarolina,1.48,304,3669,222,4469,887,0,Winter,4773,4556,222,True
2017,01/01,SouthCarolina,1.67,296,2833,185,2687,862,0,Winter,2983,3695,185,True
2017,12/31,Spokane,1.82,251,692,0,426,1097,0,Winter,677,1789,0,True
2017,12/24,Spokane,1.77,148,1445,0,762,2106,4,Winter,910,3551,4,True
2017,12/17,Spokane,2.14,181,1028,0,911,552,0,Winter,1092,1580,0,True
2017,12/10,Spokane,2.06,256,832,0,612,1020,0,Winter,868,1852,0,True
2017,12/03,Spokane,1.92,120,813,0,398,1240,2,Winter,518,2053,2,True
2017,11/26,Spokane,2.04,156,1186,8,560,1358,14,Fall,716,2544,22,True
2017,11/19,Spokane,2.2,184,1208,0,367,1034,42,Fall,551,2242,42,True
2017,11/12,Spokane,2.17,276,1165,0,506,1165,0,Fall,782,2330,0,True
2017,11/05,Spokane,2.54,215,1023,0,380,977,0,Fall,595,2000,0,True
2017,10/29,Spokane,2.48,272,946,0,520,1058,0,Fall,792,2004,0,True
2017,10/22,Spokane,2.11,368,1504,0,598,1156,0,Fall,966,2660,0,True
2017,10/15,Spokane,2.55,103,1021,2,566,1125,0,Fall,669,2146,2,True
2017,10/08,Spokane,2.74,236,946,0,624,996,0,Fall,860,1942,0,True
2017,10/01,Spokane,2.88,148,825,0,391,1043,4,Fall,539,1868,4,True
2017,09/24,Spokane,2.95,168,1025,0,370,849,4,Fall,538,1874,4,True
2017,09/17,Spokane,2.94,181,861,0,312,1020,0,Fall,493,1881,0,True
2017,09/10,Spokane,2.86,254,1032,0,478,1148,0,Fall,732,2180,0,True
2017,09/03,Spokane,2.93,181,1194,0,452,1218,0,Fall,633,2412,0,True
2017,08/27,Spokane,2.84,122,586,0,308,1060,0,Summer,430,1646,0,True
2017,08/20,Spokane,2.76,214,1025,0,303,689,0,Summer,517,1714,0,True
2017,08/13,Spokane,2.55,290,1531,0,563,1118,0,Summer,853,2649,0,True
2017,08/06,Spokane,2.45,272,1678,0,572,1104,0,Summer,844,2782,0,True
2017,07/30,Spokane,2.38,127,1619,0,587,1040,0,Summer,714,2659,0,True
2017,07/23,Spokane,2.66,145,2076,20,31,737,0,Summer,176,2813,20,True
2017,07/16,Spokane,2.55,324,1828,4,105,1273,0,Summer,429,3101,4,True
2017,07/09,Spokane,2.2,358,1807,16,37,2016,0,Summer,395,3823,16,True
2017,07/02,Spokane,2.56,305,2579,0,83,990,0,Summer,388,3569,0,True
2017,06/25,Spokane,2.5,417,1868,0,71,1010,0,Summer,488,2878,0,True
2017,06/18,Spokane,1.71,323,1545,0,51,2606,0,Summer,374,4151,0,True
2017,06/11,Spokane,1.45,231,1649,0,54,4129,0,Summer,285,5778,0,True
2017,06/04,Spokane,1.56,458,1976,0,46,3237,0,Summer,504,5213,0,True
2017,05/28,Spokane,1.48,349,1639,16,66,3798,0,Spring,415,5437,16,True
2017,05/21,Spokane,1.53,319,1148,68,91,3084,0,Spring,410,4232,68,True
2017,05/14,Spokane,1.56,430,1195,25,103,3469,0,Spring,533,4664,25,True
2017,05/07,Spokane,1.58,269,1452,18,20,3262,0,Spring,289,4714,18,True
2017,04/30,Spokane,1.72,219,1582,27,20,2728,0,Spring,239,4310,27,True
2017,04/23,Spokane,1.77,322,1586,8,30,2531,0,Spring,352,4117,8,True
2017,04/16,Spokane,1.57,292,1306,5,33,3246,0,Spring,325,4552,5,True
2017,04/09,Spokane,1.76,258,1820,0,30,2747,0,Spring,288,4567,0,True
2017,04/02,Spokane,1.32,234,1746,0,36,3905,0,Spring,270,5651,0,True
2017,03/26,Spokane,1.02,347,1704,0,23,6272,0,Spring,370,7976,0,True
2017,03/19,Spokane,1.91,240,1487,0,23,1568,0,Spring,263,3055,0,True
2017,03/12,Spokane,1.19,169,1599,11,30,3209,0,Spring,199,4808,11,True
2017,03/05,Spokane,1.38,116,1156,13,23,2479,0,Spring,139,3635,13,True
2017,02/26,Spokane,1.64,152,1154,1,84,2288,0,Winter,236,3442,1,True
2017,02/19,Spokane,2.34,121,1042,0,784,326,0,Winter,905,1368,0,True
2017,02/12,Spokane,1.66,79,1229,0,578,1785,0,Winter,657,3014,0,True
2017,02/05,Spokane,1.09,52,789,0,53,2343,0,Winter,105,3132,0,True
2017,01/29,Spokane,1.26,71,1070,0,123,3041,0,Winter,194,4111,0,True
2017,01/22,Spokane,1.28,99,928,0,63,2658,0,Winter,162,3586,0,True
2017,01/15,Spokane,1.17,24,1016,0,35,3395,0,Winter,59,4411,0,True
2017,01/08,Spokane,1.16,14,914,0,168,3016,0,Winter,182,3930,0,True
2017,01/01,Spokane,1.21,69,745,0,7,2047,0,Winter,76,2792,0,True
2017,12/31,StLouis,1.54,1689,1140,0,6613,2830,0,Winter,8302,3970,0,True
2017,12/24,StLouis,1.67,1106,841,0,1584,1591,0,Winter,2690,2432,0,True
2017,12/17,StLouis,1.63,949,979,0,2095,1930,0,Winter,3044,2909,0,True
2017,12/10,StLouis,1.72,745,1060,0,1241,2676,0,Winter,1986,3736,0,True
2017,12/03,StLouis,1.81,804,1175,0,1492,2630,0,Winter,2296,3805,0,True
2017,11/26,StLouis,2.0,654,764,0,1751,2166,0,Fall,2405,2930,0,True
2017,11/19,StLouis,1.64,1329,678,0,2116,1696,0,Fall,3445,2374,0,True
2017,11/12,StLouis,1.96,10,1238,0,2041,2429,0,Fall,2051,3667,0,True
2017,11/05,StLouis,1.77,1,1255,0,3920,1665,0,Fall,3921,2920,0,True
2017,10/29,StLouis,1.8,14,924,0,3222,1937,0,Fall,3236,2861,0,True
2017,10/22,StLouis,2.02,44,1254,0,1960,3319,0,Fall,2004,4573,0,True
2017,10/15,StLouis,2.14,27,1200,0,2020,4178,0,Fall,2047,5378,0,True
2017,10/08,StLouis,2.27,19,733,0,2024,3308,0,Fall,2043,4041,0,True
2017,10/01,StLouis,2.36,26,913,0,1750,3892,0,Fall,1776,4805,0,True
2017,09/24,StLouis,2.49,8,475,0,516,1935,0,Fall,524,2410,0,True
2017,09/17,StLouis,2.71,31,1053,0,57,4126,0,Fall,88,5179,0,True
2017,09/10,StLouis,2.69,101,1107,0,101,3847,0,Fall,202,4954,0,True
2017,09/03,StLouis,2.81,22,2396,19,71,1601,0,Fall,93,3997,19,True
2017,08/27,StLouis,2.84,44,2900,10,190,446,0,Summer,234,3346,10,True
2017,08/20,StLouis,2.64,149,2885,18,697,964,0,Summer,846,3849,18,True
2017,08/13,StLouis,2.28,238,1946,3,1704,1536,0,Summer,1942,3482,3,True
2017,08/06,StLouis,2.15,1494,1378,8,1875,4090,0,Summer,3369,5468,8,True
2017,07/30,StLouis,2.11,557,2534,16,2144,1605,0,Summer,2701,4139,16,True
2017,07/23,StLouis,2.22,656,3501,0,1491,1350,0,Summer,2147,4851,0,True
2017,07/16,StLouis,2.22,1987,2314,1,1541,1928,0,Summer,3528,4242,1,True
2017,07/09,StLouis,1.79,1623,2739,0,5323,6,0,Summer,6946,2745,0,True
2017,07/02,StLouis,1.55,136,2340,3,6630,162,0,Summer,6766,2502,3,True
2017,06/25,StLouis,1.54,67,1553,5,3648,2965,0,Summer,3715,4518,5,True
2017,06/18,StLouis,1.63,797,1738,10,3648,3132,0,Summer,4445,4870,10,True
2017,06/11,StLouis,2.05,2393,2139,12,2034,1394,0,Summer,4427,3533,12,True
2017,06/04,StLouis,1.95,2373,2106,0,2621,2550,0,Summer,4994,4656,0,True
2017,05/28,StLouis,1.9,1901,1675,1,1672,2001,0,Spring,3573,3676,1,True
2017,05/21,StLouis,1.94,1450,2164,3,1618,1985,0,Spring,3068,4149,3,True
2017,05/14,StLouis,1.59,229,1400,0,1150,2913,0,Spring,1379,4313,0,True
2017,05/07,StLouis,1.7,19,2127,1,1556,2269,0,Spring,1575,4396,1,True
2017,04/30,StLouis,2.25,60,3435,6,1037,11,0,Spring,1097,3446,6,True
2017,04/23,StLouis,1.93,305,2629,12,2685,14,0,Spring,2990,2643,12,True
2017,04/16,StLouis,2.03,1059,2846,0,2400,163,0,Spring,3459,3009,0,True
2017,04/09,StLouis,1.42,1802,1023,3,1400,5924,0,Spring,3202,6947,3,True
2017,04/02,StLouis,1.23,1692,637,0,1363,9854,0,Spring,3055,10491,0,True
2017,03/26,StLouis,1.24,1579,513,0,903,8296,0,Spring,2482,8809,0,True
2017,03/19,StLouis,1.19,1187,489,0,1218,7525,0,Spring,2405,8014,0,True
2017,03/12,StLouis,1.16,840,599,0,1055,8054,0,Spring,1895,8653,0,True
2017,03/05,StLouis,1.23,1233,462,0,382,6071,0,Spring,1615,6533,0,True
2017,02/26,StLouis,1.18,919,517,0,1393,4309,0,Winter,2312,4826,0,True
2017,02/19,StLouis,1.1,990,539,0,828,5674,0,Winter,1818,6213,0,True
2017,02/12,StLouis,1.04,1444,562,0,1576,7241,0,Winter,3020,7803,0,True
2017,02/05,StLouis,1.32,822,547,0,890,3369,0,Winter,1712,3916,0,True
2017,01/29,StLouis,1.36,1315,514,0,811,3629,0,Winter,2126,4143,0,True
2017,01/22,StLouis,1.4,1189,791,0,1287,3266,0,Winter,2476,4057,0,True
2017,01/15,StLouis,1.45,1997,657,0,1305,3628,0,Winter,3302,4285,0,True
2017,01/08,StLouis,1.67,1559,325,0,1381,799,0,Winter,2940,1124,0,True
2017,01/01,StLouis,1.46,1662,413,0,716,3057,0,Winter,2378,3470,0,True
2017,12/31,Syracuse,1.2,51,54,0,3051,1715,0,Winter,3102,1769,0,True
2017,12/24,Syracuse,1.21,77,65,0,4664,348,0,Winter,4741,413,0,True
2017,12/17,Syracuse,1.18,53,45,0,2210,2358,0,Winter,2263,2403,0,True
2017,12/10,Syracuse,1.13,19,76,0,3246,3089,0,Winter,3265,3165,0,True
2017,12/03,Syracuse,1.23,21,134,0,2945,1385,0,Winter,2966,1519,0,True
2017,11/26,Syracuse,1.28,54,44,0,3072,250,0,Fall,3126,294,0,True
2017,11/19,Syracuse,1.45,61,82,0,1751,1679,0,Fall,1812,1761,0,True
2017,11/12,Syracuse,1.42,52,115,0,2912,1965,0,Fall,2964,2080,0,True
2017,11/05,Syracuse,1.38,76,38,0,5041,173,0,Fall,5117,211,0,True
2017,10/29,Syracuse,1.35,78,61,0,6933,0,0,Fall,7011,61,0,True
2017,10/22,Syracuse,1.35,74,74,0,5039,0,0,Fall,5113,74,0,True
2017,10/15,Syracuse,1.34,86,66,0,5811,0,0,Fall,5897,66,0,True
2017,10/08,Syracuse,1.32,54,124,0,7312,0,0,Fall,7366,124,0,True
2017,10/01,Syracuse,1.41,127,61,0,6169,0,0,Fall,6296,61,0,True
2017,09/24,Syracuse,1.4,95,88,0,6229,3,0,Fall,6324,91,0,True
2017,09/17,Syracuse,1.43,120,66,0,4247,240,0,Fall,4367,306,0,True
2017,09/10,Syracuse,1.8,85,65,0,1118,826,0,Fall,1203,891,0,True
2017,09/03,Syracuse,1.51,130,87,0,2644,936,0,Fall,2774,1023,0,True
2017,08/27,Syracuse,1.4,76,61,0,4669,493,0,Summer,4745,554,0,True
2017,08/20,Syracuse,1.51,65,101,0,1606,2205,0,Summer,1671,2306,0,True
2017,08/13,Syracuse,1.39,0,169,0,2080,1767,0,Summer,2080,1936,0,True
2017,08/06,Syracuse,1.37,0,114,0,2087,3539,0,Summer,2087,3653,0,True
2017,07/30,Syracuse,1.44,0,136,0,1060,3370,0,Summer,1060,3506,0,True
2017,07/23,Syracuse,1.25,0,164,0,3009,3414,0,Summer,3009,3578,0,True
2017,07/16,Syracuse,1.35,0,165,0,3013,1962,0,Summer,3013,2127,0,True
2017,07/09,Syracuse,2.4,0,148,0,861,1779,0,Summer,861,1927,0,True
2017,07/02,Syracuse,2.44,0,263,0,745,1499,0,Summer,745,1762,0,True
2017,06/25,Syracuse,2.43,1,137,0,894,1631,0,Summer,895,1768,0,True
2017,06/18,Syracuse,2.42,0,144,0,1100,2160,0,Summer,1100,2304,0,True
2017,06/11,Syracuse,2.37,0,164,0,1093,1798,0,Summer,1093,1962,0,True
2017,06/04,Syracuse,2.23,0,143,0,1266,1743,0,Summer,1266,1886,0,True
2017,05/28,Syracuse,2.09,0,198,0,1083,2017,0,Spring,1083,2215,0,True
2017,05/21,Syracuse,2.07,0,262,0,1109,1604,0,Spring,1109,1866,0,True
2017,05/14,Syracuse,2.0,0,349,0,1435,2288,0,Spring,1435,2637,0,True
2017,05/07,Syracuse,2.11,0,260,0,1018,2902,0,Spring,1018,3162,0,True
2017,04/30,Syracuse,1.88,0,160,0,1061,481,0,Spring,1061,641,0,True
2017,04/23,Syracuse,2.08,0,109,0,958,2155,0,Spring,958,2264,0,True
2017,04/16,Syracuse,2.05,0,177,0,1159,1863,0,Spring,1159,2040,0,True
2017,04/09,Syracuse,2.09,0,172,0,923,1761,0,Spring,923,1933,0,True
2017,04/02,Syracuse,1.96,0,326,0,961,341,0,Spring,961,667,0,True
2017,03/26,Syracuse,2.12,0,137,0,753,1722,0,Spring,753,1859,0,True
2017,03/19,Syracuse,2.04,0,111,0,917,1431,0,Spring,917,1542,0,True
2017,03/12,Syracuse,2.05,0,128,0,711,1224,0,Spring,711,1352,0,True
2017,03/05,Syracuse,1.84,0,380,0,887,549,0,Spring,887,929,0,True
2017,02/26,Syracuse,1.79,0,207,0,868,259,0,Winter,868,466,0,True
2017,02/19,Syracuse,1.84,0,257,0,1021,751,0,Winter,1021,1008,0,True
2017,02/12,Syracuse,1.66,2,102,0,1989,375,0,Winter,1991,477,0,True
2017,02/05,Syracuse,1.8,5,81,0,1892,1202,0,Winter,1897,1283,0,True
2017,01/29,Syracuse,1.67,0,106,0,1473,169,0,Winter,1473,275,0,True
2017,01/22,Syracuse,1.57,19,65,0,1795,0,0,Winter,1814,65,0,True
2017,01/15,Syracuse,1.53,2,156,0,3000,19,0,Winter,3002,175,0,True
2017,01/08,Syracuse,1.7,0,113,0,1777,552,0,Winter,1777,665,0,True
2017,01/01,Syracuse,1.7,6,42,0,1263,498,0,Winter,1269,540,0,True
2017,12/31,Tampa,1.59,76,474,0,4716,261,0,Winter,4792,735,0,True
2017,12/24,Tampa,1.64,107,672,0,5882,707,0,Winter,5989,1379,0,True
2017,12/17,Tampa,1.58,65,564,0,4912,67,0,Winter,4977,631,0,True
2017,12/10,Tampa,1.56,27,438,0,5111,3,0,Winter,5138,441,0,True
2017,12/03,Tampa,1.61,40,534,0,4091,11,0,Winter,4131,545,0,True
2017,11/26,Tampa,1.58,46,383,0,4567,10,0,Fall,4613,393,0,True
2017,11/19,Tampa,1.74,101,789,0,5031,816,0,Fall,5132,1605,0,True
2017,11/12,Tampa,1.82,50,533,0,4800,57,0,Fall,4850,590,0,True
2017,11/05,Tampa,1.95,117,949,0,4451,1047,0,Fall,4568,1996,0,True
2017,10/29,Tampa,1.94,92,741,0,4392,1093,0,Fall,4484,1834,0,True
2017,10/22,Tampa,2.18,108,1003,0,3874,1413,0,Fall,3982,2416,0,True
2017,10/15,Tampa,2.7,125,659,0,1736,766,0,Fall,1861,1425,0,True
2017,10/08,Tampa,1.89,103,527,0,4750,119,0,Fall,4853,646,0,True
2017,10/01,Tampa,2.14,174,928,0,5080,968,0,Fall,5254,1896,0,True
2017,09/24,Tampa,1.85,96,399,0,3827,309,0,Fall,3923,708,0,True
2017,09/17,Tampa,1.78,23,40,0,1185,0,0,Fall,1208,40,0,True
2017,09/10,Tampa,1.76,33,2,0,3505,6,0,Fall,3538,8,0,True
2017,09/03,Tampa,1.74,38,27,0,2408,3,0,Fall,2446,30,0,True
2017,08/27,Tampa,1.6,31,23,0,3225,6,0,Summer,3256,29,0,True
2017,08/20,Tampa,1.55,31,57,0,3952,6,0,Summer,3983,63,0,True
2017,08/13,Tampa,1.57,11,52,0,4059,0,0,Summer,4070,52,0,True
2017,08/06,Tampa,1.6,31,64,0,2951,6,0,Summer,2982,70,0,True
2017,07/30,Tampa,1.57,41,43,0,3628,10,0,Summer,3669,53,0,True
2017,07/23,Tampa,1.55,19,14,0,3494,0,0,Summer,3513,14,0,True
2017,07/16,Tampa,1.56,22,39,0,3459,3,0,Summer,3481,42,0,True
2017,07/09,Tampa,1.68,44,188,0,3703,6,0,Summer,3747,194,0,True
2017,07/02,Tampa,2.08,451,2906,0,3209,3,0,Summer,3660,2909,0,True
2017,06/25,Tampa,2.09,488,2780,0,2923,6,0,Summer,3411,2786,0,True
2017,06/18,Tampa,2.07,475,2787,0,3217,0,0,Summer,3692,2787,0,True
2017,06/11,Tampa,1.86,933,206,0,3434,3,0,Summer,4367,209,0,True
2017,06/04,Tampa,1.99,1368,156,0,4050,0,0,Summer,5418,156,0,True
2017,05/28,Tampa,1.79,1104,125,0,4797,1074,0,Spring,5901,1199,0,True
2017,05/21,Tampa,1.76,1257,124,0,5223,909,0,Spring,6480,1033,0,True
2017,05/14,Tampa,1.96,2198,104,0,2528,114,0,Spring,4726,218,0,True
2017,05/07,Tampa,1.64,811,37,0,2881,1833,0,Spring,3692,1870,0,True
2017,04/30,Tampa,2.18,1053,82,0,2041,538,0,Spring,3094,620,0,True
2017,04/23,Tampa,1.94,2020,169,0,3093,0,0,Spring,5113,169,0,True
2017,04/16,Tampa,3.17,1255,82,0,1542,138,0,Spring,2797,220,0,True
2017,04/09,Tampa,2.27,957,54,0,1275,1867,0,Spring,2232,1921,0,True
2017,04/02,Tampa,1.93,1493,74,0,3517,778,0,Spring,5010,852,0,True
2017,03/26,Tampa,1.52,1009,102,0,5803,1338,0,Spring,6812,1440,0,True
2017,03/19,Tampa,1.97,985,41,0,1333,1621,0,Spring,2318,1662,0,True
2017,03/12,Tampa,2.56,1233,97,0,853,671,0,Spring,2086,768,0,True
2017,03/05,Tampa,2.61,1712,127,0,1367,498,0,Spring,3079,625,0,True
2017,02/26,Tampa,2.14,969,74,0,1234,1824,0,Winter,2203,1898,0,True
2017,02/19,Tampa,1.81,1110,42,0,2205,878,0,Winter,3315,920,0,True
2017,02/12,Tampa,1.44,742,89,0,4682,897,0,Winter,5424,986,0,True
2017,02/05,Tampa,1.93,1500,70,0,1728,1292,0,Winter,3228,1362,0,True
2017,01/29,Tampa,1.43,263,46,0,2496,2445,0,Winter,2759,2491,0,True
2017,01/22,Tampa,1.2,252,33,0,4266,2387,0,Winter,4518,2420,0,True
2017,01/15,Tampa,1.21,320,60,0,4763,2381,0,Winter,5083,2441,0,True
2017,01/08,Tampa,1.21,285,50,0,3836,2348,0,Winter,4121,2398,0,True
2017,01/01,Tampa,1.22,287,36,0,3530,2051,0,Winter,3817,2087,0,True
2017,12/31,WestTexNewMexico,1.62,1909,3538,60,10821,222,0,Winter,12730,3760,60,True
2017,12/24,WestTexNewMexico,1.85,1904,2246,0,12235,354,0,Winter,14139,2600,0,True
2017,12/17,WestTexNewMexico,1.78,1314,2079,0,11964,51,0,Winter,13278,2130,0,True
2017,12/10,WestTexNewMexico,1.65,1220,2293,0,10928,187,0,Winter,12148,2480,0,True
2017,12/03,WestTexNewMexico,1.55,1768,2732,0,9002,225,0,Winter,10770,2957,0,True
2017,11/26,WestTexNewMexico,1.91,2030,2072,0,7049,38,0,Fall,9079,2110,0,True
2017,11/19,WestTexNewMexico,1.88,1771,2580,0,9649,227,0,Fall,11420,2807,0,True
2017,11/12,WestTexNewMexico,1.8,1743,2795,0,10827,303,0,Fall,12570,3098,0,True
2017,11/05,WestTexNewMexico,1.74,2012,1503,0,8566,86,0,Fall,10578,1589,0,True
2017,10/29,WestTexNewMexico,1.89,1424,1259,0,9071,168,28,Fall,10495,1427,28,True
2017,10/22,WestTexNewMexico,1.81,2207,3361,14,9703,137,0,Fall,11910,3498,14,True
2017,10/15,WestTexNewMexico,2.07,1785,935,0,6717,137,0,Fall,8502,1072,0,True
2017,10/08,WestTexNewMexico,2.39,1952,2235,0,6542,234,0,Fall,8494,2469,0,True
2017,10/01,WestTexNewMexico,2.37,1474,1689,0,5639,69,0,Fall,7113,1758,0,True
2017,09/24,WestTexNewMexico,2.26,1545,2234,0,5722,26,0,Fall,7267,2260,0,True
2017,09/17,WestTexNewMexico,2.36,1845,2819,0,5796,3,0,Fall,7641,2822,0,True
2017,09/10,WestTexNewMexico,2.38,1562,4565,0,5719,9,0,Fall,7281,4574,0,True
2017,09/03,WestTexNewMexico,2.39,927,4056,0,2629,44,0,Fall,3556,4100,0,True
2017,08/27,WestTexNewMexico,2.5,2616,3672,0,9816,31,0,Summer,12432,3703,0,True
2017,08/20,WestTexNewMexico,2.43,1665,3993,0,5010,119,0,Summer,6675,4112,0,True
2017,08/13,WestTexNewMexico,2.01,1182,3688,11,3403,149,0,Summer,4585,3837,11,True
2017,08/06,WestTexNewMexico,1.78,2134,4592,331,8171,12,0,Summer,10305,4604,331,True
2017,07/30,WestTexNewMexico,1.67,2618,3169,1056,10733,55,0,Summer,13351,3224,1056,True
2017,07/23,WestTexNewMexico,1.6,1832,4752,1914,10577,68,0,Summer,12409,4820,1914,True
2017,07/16,WestTexNewMexico,1.6,1763,4382,2211,10652,116,0,Summer,12415,4498,2211,True
2017,07/09,WestTexNewMexico,1.65,2295,3701,38,11637,571,0,Summer,13932,4272,38,True
2017,07/02,WestTexNewMexico,1.59,2454,3470,0,10390,4170,0,Summer,12844,7640,0,True
2017,06/11,WestTexNewMexico,1.66,3042,3588,0,7757,6782,0,Summer,10799,10370,0,True
2017,06/04,WestTexNewMexico,1.59,3305,3706,0,8654,10219,0,Summer,11959,13925,0,True
2017,05/28,WestTexNewMexico,1.65,2703,4148,11,5244,6690,0,Spring,7947,10838,11,True
2017,05/21,WestTexNewMexico,1.73,3988,5269,16,4373,3251,0,Spring,8361,8520,16,True
2017,05/14,WestTexNewMexico,1.77,5410,5406,0,4198,3116,0,Spring,9608,8522,0,True
2017,05/07,WestTexNewMexico,1.74,3986,4485,22,5333,2868,0,Spring,9319,7353,22,True
2017,04/30,WestTexNewMexico,1.76,1763,5824,2,4515,3580,0,Spring,6278,9404,2,True
2017,04/23,WestTexNewMexico,1.63,1758,7535,16,5530,4393,0,Spring,7288,11928,16,True
2017,04/16,WestTexNewMexico,1.23,2233,4805,17,21441,1267,0,Spring,23674,6072,17,True
2017,04/09,WestTexNewMexico,1.19,2386,3749,34,24193,135,0,Spring,26579,3884,34,True
2017,04/02,WestTexNewMexico,1.04,2551,2586,11,23267,387,0,Spring,25818,2973,11,True
2017,03/26,WestTexNewMexico,1.11,3041,3451,66,25191,322,0,Spring,28232,3773,66,True
2017,03/19,WestTexNewMexico,1.11,4255,3855,11,13278,5366,0,Spring,17533,9221,11,True
2017,03/12,WestTexNewMexico,1.15,3289,3877,26,17880,1449,0,Spring,21169,5326,26,True
2017,03/05,WestTexNewMexico,1.23,2292,4876,52,17114,632,0,Spring,19406,5508,52,True
2017,02/26,WestTexNewMexico,1.16,3021,15568,11,20299,153,0,Winter,23320,15721,11,True
2017,02/19,WestTexNewMexico,1.24,2208,5671,35,17821,40,0,Winter,20029,5711,35,True
2017,02/12,WestTexNewMexico,1.4,2248,9177,37,16570,156,0,Winter,18818,9333,37,True
2017,02/05,WestTexNewMexico,1.31,2161,5646,11,13372,184,0,Winter,15533,5830,11,True
2017,01/29,WestTexNewMexico,1.3,1486,4498,26,11821,6,0,Winter,13307,4504,26,True
2017,01/22,WestTexNewMexico,1.21,1413,2820,20,12073,102,0,Winter,13486,2922,20,True
2017,01/15,WestTexNewMexico,1.19,1203,2904,23,12476,406,0,Winter,13679,3310,23,True
2017,01/08,WestTexNewMexico,1.18,1327,2617,5,10283,140,0,Winter,11610,2757,5,True
2017,01/01,WestTexNewMexico,1.28,867,3434,37,10815,153,0,Winter,11682,3587,37,True
2018,03/25,Albany,1.71,42,272,0,1996,10,0,Spring,2038,282,0,True
2018,03/18,Albany,1.66,275,297,0,2577,3,0,Spring,2852,300,0,True
2018,03/11,Albany,1.68,131,229,0,2209,0,0,Spring,2340,229,0,True
2018,03/04,Albany,1.48,311,296,0,3239,3,0,Spring,3550,299,0,True
2018,02/25,Albany,1.56,816,532,0,4007,0,0,Winter,4823,532,0,True
2018,02/18,Albany,1.43,4314,251,0,3000,0,0,Winter,7314,251,0,True
2018,02/11,Albany,1.43,59,289,0,3468,0,0,Winter,3527,289,0,True
2018,02/04,Albany,1.52,118,420,0,3586,0,0,Winter,3704,420,0,True
2018,01/28,Albany,1.32,433,374,0,6178,0,0,Winter,6611,374,0,True
2018,01/21,Albany,1.54,14,253,0,3078,0,0,Winter,3092,253,0,True
2018,01/14,Albany,1.47,7,301,0,3831,0,0,Winter,3838,301,0,True
2018,01/07,Albany,1.54,43,412,0,4357,3,0,Winter,4400,415,0,True
2018,03/25,Atlanta,1.56,469,3942,0,9398,4906,0,Spring,9867,8848,0,True
2018,03/18,Atlanta,1.48,626,5411,0,9134,3841,0,Spring,9760,9252,0,True
2018,03/11,Atlanta,1.43,590,5224,0,16438,789,0,Spring,17028,6013,0,True
2018,03/04,Atlanta,1.66,597,5315,0,9691,1477,0,Spring,10288,6792,0,True
2018,02/25,Atlanta,1.55,530,5122,0,9065,630,0,Winter,9595,5752,0,True
2018,02/18,Atlanta,1.56,429,4037,0,5920,777,0,Winter,6349,4814,0,True
2018,02/11,Atlanta,1.55,384,3957,0,7478,3022,0,Winter,7862,6979,0,True
2018,02/04,Atlanta,1.62,384,4042,0,5731,1741,0,Winter,6115,5783,0,True
2018,01/28,Atlanta,1.67,390,5130,0,5602,3323,0,Winter,5992,8453,0,True
2018,01/21,Atlanta,1.64,349,3967,0,6204,8033,0,Winter,6553,12000,0,True
2018,01/14,Atlanta,1.56,291,3583,0,7227,5048,0,Winter,7518,8631,0,True
2018,01/07,Atlanta,1.53,405,4195,0,7883,3229,0,Winter,8288,7424,0,True
2018,03/25,BaltimoreWashington,1.33,2002,5548,82,49957,15,0,Spring,51959,5563,82,True
2018,03/18,BaltimoreWashington,1.41,2132,6130,76,37157,8,0,Spring,39289,6138,76,True
2018,03/11,BaltimoreWashington,1.44,1885,6874,96,39177,10,0,Spring,41062,6884,96,True
2018,03/04,BaltimoreWashington,1.43,2360,6371,93,34475,0,0,Spring,36835,6371,93,True
2018,02/25,BaltimoreWashington,1.47,1626,7913,49,37822,10,0,Winter,39448,7923,49,True
2018,02/18,BaltimoreWashington,1.52,2125,12402,79,36927,28,0,Winter,39052,12430,79,True
2018,02/11,BaltimoreWashington,1.53,1457,9060,68,35769,0,0,Winter,37226,9060,68,True
2018,02/04,BaltimoreWashington,1.59,1201,7408,85,32904,15,0,Winter,34105,7423,85,True
2018,01/28,BaltimoreWashington,1.55,1236,8807,147,33859,8,0,Winter,35095,8815,147,True
2018,01/21,BaltimoreWashington,1.66,1450,9262,65,27315,4,0,Winter,28765,9266,65,True
2018,01/14,BaltimoreWashington,1.39,1264,10025,105,54746,6,0,Winter,56010,10031,105,True
2018,01/07,BaltimoreWashington,1.15,1315,9962,134,70863,6,0,Winter,72178,9968,134,True
2018,03/25,Boise,1.81,76,1006,0,618,1418,0,Spring,694,2424,0,True
2018,03/18,Boise,1.85,89,898,0,287,1258,17,Spring,376,2156,17,True
2018,03/11,Boise,1.8,98,926,0,664,1758,0,Spring,762,2684,0,True
2018,03/04,Boise,1.79,109,904,0,526,1440,0,Spring,635,2344,0,True
2018,02/25,Boise,1.82,69,745,0,472,1141,0,Winter,541,1886,0,True
2018,02/18,Boise,1.82,72,810,0,725,667,0,Winter,797,1477,0,True
2018,02/11,Boise,1.8,46,791,0,666,1351,0,Winter,712,2142,0,True
2018,02/04,Boise,1.8,76,590,0,492,1376,58,Winter,568,1966,58,True
2018,01/28,Boise,1.78,52,580,0,294,1490,1,Winter,346,2070,1,True
2018,01/21,Boise,1.81,41,577,0,284,1541,1,Winter,325,2118,1,True
2018,01/14,Boise,1.81,51,802,0,350,925,0,Winter,401,1727,0,True
2018,01/07,Boise,1.77,42,949,0,552,1010,0,Winter,594,1959,0,True
2018,03/25,Boston,1.74,27,2031,0,29466,6915,0,Spring,29493,8946,0,True
2018,03/18,Boston,1.83,20,2456,0,25094,7238,0,Spring,25114,9694,0,True
2018,03/11,Boston,1.85,8,2114,0,22732,5620,0,Spring,22740,7734,0,True
2018,03/04,Boston,1.92,7,2254,0,18636,2992,0,Spring,18643,5246,0,True
2018,02/25,Boston,1.79,34,2390,0,25069,4072,0,Winter,25103,6462,0,True
2018,02/18,Boston,1.83,11,1603,0,22938,3407,0,Winter,22949,5010,0,True
2018,02/11,Boston,1.85,3,1795,3,19367,3557,0,Winter,19370,5352,3,True
2018,02/04,Boston,1.83,9,2504,3,20660,5756,0,Winter,20669,8260,3,True
2018,01/28,Boston,1.72,14,1628,0,27876,1327,0,Winter,27890,2955,0,True
2018,01/21,Boston,1.82,60,2647,0,21985,2011,0,Winter,22045,4658,0,True
2018,01/14,Boston,1.73,12,2380,0,23926,3148,0,Winter,23938,5528,0,True
2018,01/07,Boston,1.91,14,2704,0,25121,2255,0,Winter,25135,4959,0,True
2018,03/25,BuffaloRochester,1.03,241,425,0,25743,11793,0,Spring,25984,12218,0,True
2018,03/18,BuffaloRochester,1.17,558,106,0,4270,11177,0,Spring,4828,11283,0,True
2018,03/11,BuffaloRochester,1.24,763,91,0,1124,10765,0,Spring,1887,10856,0,True
2018,03/04,BuffaloRochester,1.38,1197,159,0,894,6329,0,Spring,2091,6488,0,True
2018,02/25,BuffaloRochester,1.27,761,168,0,2567,7900,0,Winter,3328,8068,0,True
2018,02/18,BuffaloRochester,1.23,542,103,0,5283,6201,0,Winter,5825,6304,0,True
2018,02/11,BuffaloRochester,1.21,169,138,0,2907,6530,0,Winter,3076,6668,0,True
2018,02/04,BuffaloRochester,1.18,204,181,0,4203,9717,0,Winter,4407,9898,0,True
2018,01/28,BuffaloRochester,1.17,232,150,0,11059,1963,0,Winter,11291,2113,0,True
2018,01/21,BuffaloRochester,1.23,309,119,0,3581,3277,0,Winter,3890,3396,0,True
2018,01/14,BuffaloRochester,1.19,318,133,0,3248,7164,0,Winter,3566,7297,0,True
2018,01/07,BuffaloRochester,1.17,283,90,0,4250,4492,0,Winter,4533,4582,0,True
2018,03/25,Charlotte,1.77,17,5964,161,5792,95,0,Spring,5809,6059,161,True
2018,03/18,Charlotte,1.75,30,5808,205,5801,140,0,Spring,5831,5948,205,True
2018,03/11,Charlotte,1.73,29,6861,222,6511,72,0,Spring,6540,6933,222,True
2018,03/04,Charlotte,1.88,31,6586,268,4621,374,0,Spring,4652,6960,268,True
2018,02/25,Charlotte,1.91,36,5987,190,5667,64,0,Winter,5703,6051,190,True
2018,02/18,Charlotte,1.83,22,5878,232,5981,303,0,Winter,6003,6181,232,True
2018,02/11,Charlotte,1.92,7,5645,238,5176,148,0,Winter,5183,5793,238,True
2018,02/04,Charlotte,1.89,26,5187,201,7613,244,0,Winter,7639,5431,201,True
2018,01/28,Charlotte,1.76,21,6626,271,5080,432,0,Winter,5101,7058,271,True
2018,01/21,Charlotte,1.62,8,5461,246,6703,2,0,Winter,6711,5463,246,True
2018,01/14,Charlotte,1.45,17,7132,241,12116,13,0,Winter,12133,7145,241,True
2018,01/07,Charlotte,1.08,22,6254,225,22132,107,0,Winter,22154,6361,225,True
2018,03/25,Chicago,1.69,324,27550,0,7176,36,0,Spring,7500,27586,0,True
2018,03/18,Chicago,1.66,184,26955,0,8398,3,0,Spring,8582,26958,0,True
2018,03/11,Chicago,1.66,583,32382,0,8990,13,0,Spring,9573,32395,0,True
2018,03/04,Chicago,1.62,1107,35255,0,9654,10,0,Spring,10761,35265,0,True
2018,02/25,Chicago,1.68,246,29263,0,6908,13,0,Winter,7154,29276,0,True
2018,02/18,Chicago,1.66,259,24314,0,9095,10,0,Winter,9354,24324,0,True
2018,02/11,Chicago,1.65,409,26524,0,11261,6,0,Winter,11670,26530,0,True
2018,02/04,Chicago,1.62,313,32668,0,13975,0,0,Winter,14288,32668,0,True
2018,01/28,Chicago,1.72,215,31318,0,9236,0,0,Winter,9451,31318,0,True
2018,01/21,Chicago,1.82,83,28134,0,8470,0,0,Winter,8553,28134,0,True
2018,01/14,Chicago,1.79,133,31177,0,13635,10,0,Winter,13768,31187,0,True
2018,01/07,Chicago,1.83,118,29600,0,11850,3,0,Winter,11968,29603,0,True
2018,03/25,CincinnatiDayton,1.66,728,4308,0,7398,3065,0,Spring,8126,7373,0,True
2018,03/18,CincinnatiDayton,1.31,932,10505,0,8746,8538,0,Spring,9678,19043,0,True
2018,03/11,CincinnatiDayton,1.27,1080,12488,0,15617,5330,0,Spring,16697,17818,0,True
2018,03/04,CincinnatiDayton,1.68,810,4420,0,4449,1569,0,Spring,5259,5989,0,True
2018,02/25,CincinnatiDayton,1.78,736,4538,0,2275,7546,0,Winter,3011,12084,0,True
2018,02/18,CincinnatiDayton,1.64,680,4321,0,4698,111,0,Winter,5378,4432,0,True
2018,02/11,CincinnatiDayton,1.59,535,3567,0,5192,1458,0,Winter,5727,5025,0,True
2018,02/04,CincinnatiDayton,1.69,628,4438,0,4339,1790,0,Winter,4967,6228,0,True
2018,01/28,CincinnatiDayton,1.51,702,4805,0,3133,6386,0,Winter,3835,11191,0,True
2018,01/21,CincinnatiDayton,1.6,678,5179,0,2688,9817,0,Winter,3366,14996,0,True
2018,01/14,CincinnatiDayton,1.71,610,5917,0,4369,8536,0,Winter,4979,14453,0,True
2018,01/07,CincinnatiDayton,1.71,710,5212,0,3380,3838,0,Winter,4090,9050,0,True
2018,03/25,Columbus,1.31,533,1113,0,7760,1717,0,Spring,8293,2830,0,True
2018,03/18,Columbus,1.2,723,8582,0,11776,11551,0,Spring,12499,20133,0,True
2018,03/11,Columbus,1.26,820,10737,0,12641,2420,0,Spring,13461,13157,0,True
2018,03/04,Columbus,1.48,531,1246,0,5689,149,0,Spring,6220,1395,0,True
2018,02/25,Columbus,1.57,470,1510,0,4640,749,0,Winter,5110,2259,0,True
2018,02/18,Columbus,1.44,434,1521,0,5850,0,0,Winter,6284,1521,0,True
2018,02/11,Columbus,1.42,445,1117,0,7086,321,0,Winter,7531,1438,0,True
2018,02/04,Columbus,1.47,587,1186,0,5453,195,0,Winter,6040,1381,0,True
2018,01/28,Columbus,1.43,564,1557,0,4090,1457,0,Winter,4654,3014,0,True
2018,01/21,Columbus,1.5,613,1852,0,4083,2428,0,Winter,4696,4280,0,True
2018,01/14,Columbus,1.3,977,1620,0,7350,476,0,Winter,8327,2096,0,True
2018,01/07,Columbus,1.15,1639,1133,0,9106,710,0,Winter,10745,1843,0,True
2018,03/25,DallasFtWorth,1.46,5372,1047,0,23054,2014,0,Spring,28426,3061,0,True
2018,03/18,DallasFtWorth,1.32,5570,1317,0,22630,1604,0,Spring,28200,2921,0,True
2018,03/11,DallasFtWorth,1.3,6067,810,0,25669,1809,0,Spring,31736,2619,0,True
2018,03/04,DallasFtWorth,1.38,5610,618,0,20545,1632,0,Spring,26155,2250,0,True
2018,02/25,DallasFtWorth,1.34,3998,635,0,17839,1046,0,Winter,21837,1681,0,True
2018,02/18,DallasFtWorth,1.36,4546,787,0,19653,393,0,Winter,24199,1180,0,True
2018,02/11,DallasFtWorth,1.34,4681,437,0,22690,269,0,Winter,27371,706,0,True
2018,02/04,DallasFtWorth,1.37,4977,561,0,22281,250,0,Winter,27258,811,0,True
2018,01/28,DallasFtWorth,1.45,4936,476,0,19613,1043,0,Winter,24549,1519,0,True
2018,01/21,DallasFtWorth,1.5,4244,360,0,17607,1820,0,Winter,21851,2180,0,True
2018,01/14,DallasFtWorth,1.54,5179,577,0,16878,2993,0,Winter,22057,3570,0,True
2018,01/07,DallasFtWorth,1.45,4020,454,0,14157,2654,0,Winter,18177,3108,0,True
2018,03/25,Denver,1.6,6516,685,44,16514,1064,0,Spring,23030,1749,44,True
2018,03/18,Denver,1.67,10539,797,33,9087,895,0,Spring,19626,1692,33,True
2018,03/11,Denver,1.59,7032,640,52,23032,833,0,Spring,30064,1473,52,True
2018,03/04,Denver,1.55,5776,588,10,17177,747,0,Spring,22953,1335,10,True
2018,02/25,Denver,1.39,8387,751,24,26783,876,0,Winter,35170,1627,24,True
2018,02/18,Denver,1.35,8065,597,49,27804,165,0,Winter,35869,762,49,True
2018,02/11,Denver,1.55,5261,639,35,16367,85,0,Winter,21628,724,35,True
2018,02/04,Denver,1.51,3746,496,23,12101,89,0,Winter,15847,585,23,True
2018,01/28,Denver,1.51,6132,550,36,20366,427,0,Winter,26498,977,36,True
2018,01/21,Denver,1.55,7841,687,32,20613,968,0,Winter,28454,1655,32,True
2018,01/14,Denver,1.53,8395,839,53,25789,1423,0,Winter,34184,2262,53,True
2018,01/07,Denver,1.38,8896,939,22,28597,1250,0,Winter,37493,2189,22,True
2018,03/25,Detroit,1.43,687,2729,0,13920,2966,0,Spring,14607,5695,0,True
2018,03/18,Detroit,1.2,1452,18641,0,22871,20339,0,Spring,24323,38980,0,True
2018,03/11,Detroit,1.23,1549,20242,0,27074,3612,0,Spring,28623,23854,0,True
2018,03/04,Detroit,1.16,676,2624,0,20853,379,0,Spring,21529,3003,0,True
2018,02/25,Detroit,1.45,601,2864,0,10325,2084,0,Winter,10926,4948,0,True
2018,02/18,Detroit,1.34,577,2469,1,11571,7,0,Winter,12148,2476,1,True
2018,02/11,Detroit,1.36,606,2464,0,12740,807,0,Winter,13346,3271,0,True
2018,02/04,Detroit,1.32,580,2434,0,13820,660,0,Winter,14400,3094,0,True
2018,01/28,Detroit,1.29,738,3026,0,12972,3326,0,Winter,13710,6352,0,True
2018,01/21,Detroit,1.41,826,3379,0,11215,6675,0,Winter,12041,10054,0,True
2018,01/14,Detroit,1.32,750,3266,0,15422,1176,0,Winter,16172,4442,0,True
2018,01/07,Detroit,1.22,1649,3006,0,16829,1622,0,Winter,18478,4628,0,True
2018,03/25,GrandRapids,1.34,73,1301,0,7162,1,0,Spring,7235,1302,0,True
2018,03/18,GrandRapids,1.33,4,1362,0,7815,28,0,Spring,7819,1390,0,True
2018,03/11,GrandRapids,1.32,35,1201,0,7143,0,0,Spring,7178,1201,0,True
2018,03/04,GrandRapids,1.01,78,7765,0,10144,0,0,Spring,10222,7765,0,True
2018,02/25,GrandRapids,1.34,10,1084,0,6007,13,0,Winter,6017,1097,0,True
2018,02/18,GrandRapids,1.29,5,858,0,6794,0,0,Winter,6799,858,0,True
2018,02/11,GrandRapids,1.25,11,2034,0,6813,0,0,Winter,6824,2034,0,True
2018,02/04,GrandRapids,1.21,15,626,0,7677,0,0,Winter,7692,626,0,True
2018,01/28,GrandRapids,1.26,45,737,0,7468,0,0,Winter,7513,737,0,True
2018,01/21,GrandRapids,1.31,4,1118,0,7418,25,0,Winter,7422,1143,0,True
2018,01/14,GrandRapids,1.32,14,1519,0,8744,29,0,Winter,8758,1548,0,True
2018,01/07,GrandRapids,1.25,12,3013,0,8423,0,0,Winter,8435,3013,0,True
2018,03/25,HarrisburgScranton,1.36,371,239,9,22545,3,0,Spring,22916,242,9,True
2018,03/18,HarrisburgScranton,1.47,791,428,6,16589,0,0,Spring,17380,428,6,True
2018,03/11,HarrisburgScranton,1.47,393,267,22,19811,10,0,Spring,20204,277,22,True
2018,03/04,HarrisburgScranton,1.43,659,396,20,17889,3,0,Spring,18548,399,20,True
2018,02/25,HarrisburgScranton,1.42,330,369,5,17706,3,0,Winter,18036,372,5,True
2018,02/18,HarrisburgScranton,1.43,3948,2895,15,20134,3,0,Winter,24082,2898,15,True
2018,02/11,HarrisburgScranton,1.53,217,254,20,17798,22,0,Winter,18015,276,20,True
2018,02/04,HarrisburgScranton,1.5,322,300,6,20329,97,0,Winter,20651,397,6,True
2018,01/28,HarrisburgScranton,1.49,409,280,19,21137,3,0,Winter,21546,283,19,True
2018,01/21,HarrisburgScranton,1.59,225,166,19,15410,6,0,Winter,15635,172,19,True
2018,01/14,HarrisburgScranton,1.45,175,199,5,23446,0,0,Winter,23621,199,5,True
2018,01/07,HarrisburgScranton,1.51,208,312,13,20550,10,0,Winter,20758,322,13,True
2018,03/25,HartfordSpringfield,2.09,144,10949,0,9137,10,0,Spring,9281,10959,0,True
2018,03/18,HartfordSpringfield,1.88,537,22724,0,8472,1,0,Spring,9009,22725,0,True
2018,03/11,HartfordSpringfield,2.15,147,8428,2,9143,0,0,Spring,9290,8428,2,True
2018,03/04,HartfordSpringfield,1.9,622,19631,0,7354,0,0,Spring,7976,19631,0,True
2018,02/25,HartfordSpringfield,2.05,213,7229,0,8278,0,0,Winter,8491,7229,0,True
2018,02/18,HartfordSpringfield,1.48,1201,40277,8,7566,295,0,Winter,8767,40572,8,True
2018,02/11,HartfordSpringfield,2.1,23,4455,8,7389,6,0,Winter,7412,4461,8,True
2018,02/04,HartfordSpringfield,1.94,142,8510,15,8736,0,0,Winter,8878,8510,15,True
2018,01/28,HartfordSpringfield,1.9,468,10161,2,8340,0,0,Winter,8808,10161,2,True
2018,01/21,HartfordSpringfield,2.12,97,4096,1,8079,34,0,Winter,8176,4130,1,True
2018,01/14,HartfordSpringfield,2.02,122,4410,0,9911,4,0,Winter,10033,4414,0,True
2018,01/07,HartfordSpringfield,2.03,76,4721,1,10405,0,0,Winter,10481,4721,1,True
2018,03/25,Houston,1.31,8247,67,0,28094,590,0,Spring,36341,657,0,True
2018,03/18,Houston,1.07,7515,138,0,22467,443,0,Spring,29982,581,0,True
2018,03/11,Houston,1.26,8456,165,0,31440,443,0,Spring,39896,608,0,True
2018,03/04,Houston,1.37,6442,67,0,21933,256,0,Spring,28375,323,0,True
2018,02/25,Houston,1.41,5721,68,0,19544,256,0,Winter,25265,324,0,True
2018,02/18,Houston,1.41,6697,149,0,24082,100,0,Winter,30779,249,0,True
2018,02/11,Houston,1.4,5208,60,0,19029,86,0,Winter,24237,146,0,True
2018,02/04,Houston,1.43,10163,216,0,16644,129,0,Winter,26807,345,0,True
2018,01/28,Houston,1.45,10288,114,0,16394,56,0,Winter,26682,170,0,True
2018,01/21,Houston,1.41,7335,43,0,25100,243,0,Winter,32435,286,0,True
2018,01/14,Houston,1.49,11013,108,0,23953,446,0,Winter,34966,554,0,True
2018,01/07,Houston,1.38,9238,61,0,20778,350,0,Winter,30016,411,0,True
2018,03/25,Indianapolis,1.28,319,1427,0,3437,4247,0,Spring,3756,5674,0,True
2018,03/18,Indianapolis,1.2,384,3856,0,7412,5709,0,Spring,7796,9565,0,True
2018,03/11,Indianapolis,1.22,341,3553,0,8448,2849,0,Spring,8789,6402,0,True
2018,03/04,Indianapolis,1.23,283,1481,0,6217,2489,0,Spring,6500,3970,0,True
2018,02/25,Indianapolis,1.45,256,1278,0,4655,3105,0,Winter,4911,4383,0,True
2018,02/18,Indianapolis,1.34,230,1110,0,3988,2096,0,Winter,4218,3206,0,True
2018,02/11,Indianapolis,1.34,280,939,0,5468,1637,0,Winter,5748,2576,0,True
2018,02/04,Indianapolis,1.36,275,1302,0,5633,2510,0,Winter,5908,3812,0,True
2018,01/28,Indianapolis,1.4,205,1254,0,4711,2743,0,Winter,4916,3997,0,True
2018,01/21,Indianapolis,1.48,281,1266,0,4149,3734,0,Winter,4430,5000,0,True
2018,01/14,Indianapolis,1.46,221,1861,0,8183,3360,0,Winter,8404,5221,0,True
2018,01/07,Indianapolis,1.46,205,1460,0,5889,2314,0,Winter,6094,3774,0,True
2018,03/25,Jacksonville,1.75,171,806,3,2944,1592,0,Spring,3115,2398,3,True
2018,03/18,Jacksonville,1.6,87,667,3,2769,549,0,Spring,2856,1216,3,True
2018,03/11,Jacksonville,1.53,92,616,3,2561,100,0,Spring,2653,716,3,True
2018,03/04,Jacksonville,1.92,176,1177,0,2442,2766,0,Spring,2618,3943,0,True
2018,02/25,Jacksonville,1.73,106,915,0,2877,1089,0,Winter,2983,2004,0,True
2018,02/18,Jacksonville,1.89,149,1094,2,2283,1858,0,Winter,2432,2952,2,True
2018,02/11,Jacksonville,1.83,165,836,6,2420,1787,0,Winter,2585,2623,6,True
2018,02/04,Jacksonville,1.62,57,465,0,2008,306,0,Winter,2065,771,0,True
2018,01/28,Jacksonville,2.01,160,1076,6,1776,2683,0,Winter,1936,3759,6,True
2018,01/21,Jacksonville,1.77,67,597,6,2105,733,0,Winter,2172,1330,6,True
2018,01/14,Jacksonville,1.57,44,587,5,2171,0,0,Winter,2215,587,5,True
2018,01/07,Jacksonville,1.43,43,531,0,2400,14,0,Winter,2443,545,0,True
2018,03/25,LasVegas,1.65,1541,1842,0,7283,54,0,Spring,8824,1896,0,True
2018,03/18,LasVegas,1.66,1458,2174,0,7545,20,0,Spring,9003,2194,0,True
2018,03/11,LasVegas,1.62,1966,2132,0,9686,6,0,Spring,11652,2138,0,True
2018,03/04,LasVegas,1.66,1575,2190,0,7763,0,0,Spring,9338,2190,0,True
2018,02/25,LasVegas,1.66,1407,1898,0,6957,38,0,Winter,8364,1936,0,True
2018,02/18,LasVegas,1.64,1473,1915,0,7665,23,0,Winter,9138,1938,0,True
2018,02/11,LasVegas,1.7,1244,1641,0,6503,9,0,Winter,7747,1650,0,True
2018,02/04,LasVegas,1.79,1479,1512,0,6465,45,0,Winter,7944,1557,0,True
2018,01/28,LasVegas,1.78,1005,2110,0,5538,17,0,Winter,6543,2127,0,True
2018,01/21,LasVegas,1.91,1096,1280,0,5115,0,0,Winter,6211,1280,0,True
2018,01/14,LasVegas,1.98,1497,2199,0,6180,6,0,Winter,7677,2205,0,True
2018,01/07,LasVegas,1.73,1701,2012,0,6553,26,0,Winter,8254,2038,0,True
2018,03/25,LosAngeles,1.74,11197,29959,0,50420,162,0,Spring,61617,30121,0,True
2018,03/18,LosAngeles,1.72,10829,30437,0,52187,112,0,Spring,63016,30549,0,True
2018,03/11,LosAngeles,1.39,12839,36894,0,92190,8,0,Spring,105029,36902,0,True
2018,03/04,LosAngeles,1.4,14856,27596,0,103108,47,0,Spring,117964,27643,0,True
2018,02/25,LosAngeles,1.74,10382,35406,0,45169,26,0,Winter,55551,35432,0,True
2018,02/18,LosAngeles,1.88,9009,35316,0,44519,8,0,Winter,53528,35324,0,True
2018,02/11,LosAngeles,1.74,11627,23735,0,57577,28,0,Winter,69204,23763,0,True
2018,02/04,LosAngeles,1.6,12267,21472,0,66486,49,0,Winter,78753,21521,0,True
2018,01/28,LosAngeles,1.73,11366,25056,0,60596,7,0,Winter,71962,25063,0,True
2018,01/21,LosAngeles,1.75,9239,24527,0,60647,27,0,Winter,69886,24554,0,True
2018,01/14,LosAngeles,1.68,15769,39738,0,51104,12,0,Winter,66873,39750,0,True
2018,01/07,LosAngeles,1.8,20189,24193,0,43077,57,0,Winter,63266,24250,0,True
2018,03/25,Louisville,1.46,8,988,0,2031,1145,0,Spring,2039,2133,0,True
2018,03/18,Louisville,1.38,0,1367,0,1470,1734,0,Spring,1470,3101,0,True
2018,03/11,Louisville,1.35,1,1528,0,2099,2276,0,Spring,2100,3804,0,True
2018,03/04,Louisville,1.43,13,1011,0,1959,2092,0,Spring,1972,3103,0,True
2018,02/25,Louisville,1.59,1,1293,0,1487,891,0,Winter,1488,2184,0,True
2018,02/18,Louisville,1.59,0,1076,0,975,12,0,Winter,975,1088,0,True
2018,02/11,Louisville,1.56,6,883,0,1027,258,0,Winter,1033,1141,0,True
2018,02/04,Louisville,1.48,0,950,0,1736,314,0,Winter,1736,1264,0,True
2018,01/28,Louisville,1.48,1,1036,0,1853,355,0,Winter,1854,1391,0,True
2018,01/21,Louisville,1.6,1,1008,0,1596,1564,0,Winter,1597,2572,0,True
2018,01/14,Louisville,1.54,0,1199,0,1769,768,0,Winter,1769,1967,0,True
2018,01/07,Louisville,1.38,4,1207,0,2226,1184,0,Winter,2230,2391,0,True
2018,03/25,MiamiFtLauderdale,1.34,111,296,0,8212,0,0,Spring,8323,296,0,True
2018,03/18,MiamiFtLauderdale,1.37,351,439,0,9656,11,0,Spring,10007,450,0,True
2018,03/11,MiamiFtLauderdale,1.35,71,283,0,7573,20,0,Spring,7644,303,0,True
2018,03/04,MiamiFtLauderdale,1.56,420,893,0,8935,1300,0,Spring,9355,2193,0,True
2018,02/25,MiamiFtLauderdale,1.6,652,894,0,7767,1506,0,Winter,8419,2400,0,True
2018,02/18,MiamiFtLauderdale,1.52,138,772,0,7794,968,0,Winter,7932,1740,0,True
2018,02/11,MiamiFtLauderdale,1.4,139,429,0,8423,328,0,Winter,8562,757,0,True
2018,02/04,MiamiFtLauderdale,1.5,261,589,0,7622,720,0,Winter,7883,1309,0,True
2018,01/28,MiamiFtLauderdale,1.43,162,272,0,7448,0,0,Winter,7610,272,0,True
2018,01/21,MiamiFtLauderdale,1.46,127,285,0,7143,0,0,Winter,7270,285,0,True
2018,01/14,MiamiFtLauderdale,1.44,50,203,0,7700,3,0,Winter,7750,206,0,True
2018,01/07,MiamiFtLauderdale,1.47,52,293,0,7135,13,0,Winter,7187,306,0,True
2018,03/25,Nashville,1.48,43,1759,0,4834,612,0,Spring,4877,2371,0,True
2018,03/18,Nashville,1.27,20,2115,0,4797,3487,0,Spring,4817,5602,0,True
2018,03/11,Nashville,1.32,38,2553,0,5132,2437,0,Spring,5170,4990,0,True
2018,03/04,Nashville,1.5,41,2211,0,6653,1658,0,Spring,6694,3869,0,True
2018,02/25,Nashville,1.48,43,2258,0,3862,4196,0,Winter,3905,6454,0,True
2018,02/18,Nashville,1.38,23,2027,0,3424,334,0,Winter,3447,2361,0,True
2018,02/11,Nashville,1.36,43,1629,0,3117,403,0,Winter,3160,2032,0,True
2018,02/04,Nashville,1.58,54,2042,0,2310,702,0,Winter,2364,2744,0,True
2018,01/28,Nashville,1.63,41,2301,0,2704,1561,0,Winter,2745,3862,0,True
2018,01/21,Nashville,1.68,59,2081,0,2314,4090,0,Winter,2373,6171,0,True
2018,01/14,Nashville,1.58,47,2392,0,3581,1597,0,Winter,3628,3989,0,True
2018,01/07,Nashville,1.57,41,2384,0,3330,1944,0,Winter,3371,4328,0,True
2018,03/25,NewOrleansMobile,1.36,275,94,0,7288,365,0,Spring,7563,459,0,True
2018,03/18,NewOrleansMobile,1.35,695,129,0,5755,41,0,Spring,6450,170,0,True
2018,03/11,NewOrleansMobile,1.36,605,123,0,6237,182,0,Spring,6842,305,0,True
2018,03/04,NewOrleansMobile,1.39,521,142,0,6275,527,0,Spring,6796,669,0,True
2018,02/25,NewOrleansMobile,1.35,230,237,0,7169,150,0,Winter,7399,387,0,True
2018,02/18,NewOrleansMobile,1.39,290,188,0,8156,603,0,Winter,8446,791,0,True
2018,02/11,NewOrleansMobile,1.36,183,130,0,7163,324,0,Winter,7346,454,0,True
2018,02/04,NewOrleansMobile,1.35,196,121,0,7856,170,0,Winter,8052,291,0,True
2018,01/28,NewOrleansMobile,1.43,258,212,0,7341,432,0,Winter,7599,644,0,True
2018,01/21,NewOrleansMobile,1.42,259,123,0,5035,90,0,Winter,5294,213,0,True
2018,01/14,NewOrleansMobile,1.42,158,101,0,6847,23,0,Winter,7005,124,0,True
2018,01/07,NewOrleansMobile,1.43,122,161,0,6528,47,0,Winter,6650,208,0,True
2018,03/25,NewYork,1.86,12695,35094,205,70377,130,0,Spring,83072,35224,205,True
2018,03/18,NewYork,1.7,44234,80052,53,64851,242,0,Spring,109085,80294,53,True
2018,03/11,NewYork,1.92,10655,33419,144,63842,52,0,Spring,74497,33471,144,True
2018,03/04,NewYork,1.69,20987,52637,92,59997,53,0,Spring,80984,52690,92,True
2018,02/25,NewYork,1.72,12369,43197,217,56343,0,0,Winter,68712,43197,217,True
2018,02/18,NewYork,1.36,107369,329956,956,55583,1218,0,Winter,162952,331174,956,True
2018,02/11,NewYork,1.92,6604,15647,863,55116,1645,0,Winter,61720,17292,863,True
2018,02/04,NewYork,1.83,9300,21428,814,61516,144,0,Winter,70816,21572,814,True
2018,01/28,NewYork,1.75,13196,24933,128,56090,2032,0,Winter,69286,26965,128,True
2018,01/21,NewYork,1.91,5732,13124,157,52130,615,0,Winter,57862,13739,157,True
2018,01/14,NewYork,1.91,7433,17885,49,60763,500,0,Winter,68196,18385,49,True
2018,01/07,NewYork,1.97,6158,19251,47,57180,0,0,Winter,63338,19251,47,True
2018,03/25,NorthernNewEngland,1.63,9,257,0,22329,0,0,Spring,22338,257,0,True
2018,03/18,NorthernNewEngland,1.62,6,243,0,22126,0,0,Spring,22132,243,0,True
2018,03/11,NorthernNewEngland,1.64,3,342,0,17807,50,0,Spring,17810,392,0,True
2018,03/04,NorthernNewEngland,1.54,24,760,0,13328,43,0,Spring,13352,803,0,True
2018,02/25,NorthernNewEngland,1.5,12,779,0,29761,0,0,Winter,29773,779,0,True
2018,02/18,NorthernNewEngland,1.58,0,195,0,29504,0,0,Winter,29504,195,0,True
2018,02/11,NorthernNewEngland,1.39,0,176,0,22319,0,0,Winter,22319,176,0,True
2018,02/04,NorthernNewEngland,1.57,5,268,0,18834,0,0,Winter,18839,268,0,True
2018,01/28,NorthernNewEngland,1.29,0,383,0,49904,0,0,Winter,49904,383,0,True
2018,01/21,NorthernNewEngland,1.59,4,664,0,21432,0,0,Winter,21436,664,0,True
2018,01/14,NorthernNewEngland,1.46,6,211,0,22419,0,0,Winter,22425,211,0,True
2018,01/07,NorthernNewEngland,1.75,0,551,0,25633,3,0,Winter,25633,554,0,True
2018,03/25,Orlando,1.45,209,1106,0,8756,967,0,Spring,8965,2073,0,True
2018,03/18,Orlando,1.58,335,1385,0,8351,2088,0,Spring,8686,3473,0,True
2018,03/11,Orlando,1.38,202,688,0,7614,181,0,Spring,7816,869,0,True
2018,03/04,Orlando,1.58,361,1244,0,7341,1652,0,Spring,7702,2896,0,True
2018,02/25,Orlando,1.41,230,806,0,8597,457,0,Winter,8827,1263,0,True
2018,02/18,Orlando,1.57,281,1239,0,6697,1246,0,Winter,6978,2485,0,True
2018,02/11,Orlando,1.48,228,909,0,7405,944,0,Winter,7633,1853,0,True
2018,02/04,Orlando,1.36,126,542,0,7081,14,0,Winter,7207,556,0,True
2018,01/28,Orlando,1.67,197,1131,0,5671,1402,0,Winter,5868,2533,0,True
2018,01/21,Orlando,1.53,113,598,0,6278,3,0,Winter,6391,601,0,True
2018,01/14,Orlando,1.55,86,639,0,5926,6,0,Winter,6012,645,0,True
2018,01/07,Orlando,1.56,79,649,0,6335,9,0,Winter,6414,658,0,True
2018,03/25,Philadelphia,1.49,3464,5737,9,28637,44,0,Spring,32101,5781,9,True
2018,03/18,Philadelphia,1.58,6924,13914,0,19760,32,0,Spring,26684,13946,0,True
2018,03/11,Philadelphia,1.72,4358,4695,0,20459,0,0,Spring,24817,4695,0,True
2018,03/04,Philadelphia,1.51,6525,6294,5,20498,4,0,Spring,27023,6298,5,True
2018,02/25,Philadelphia,1.56,4302,8227,4,19011,3,0,Winter,23313,8230,4,True
2018,02/18,Philadelphia,1.37,13696,42602,16,19085,16,0,Winter,32781,42618,16,True
2018,02/11,Philadelphia,1.68,1481,2510,13,16333,11,0,Winter,17814,2521,13,True
2018,02/04,Philadelphia,1.63,2687,3164,20,21162,1,0,Winter,23849,3165,20,True
2018,01/28,Philadelphia,1.61,3878,3721,7,20602,47,0,Winter,24480,3768,7,True
2018,01/21,Philadelphia,1.73,2121,2654,3,18326,9,0,Winter,20447,2663,3,True
2018,01/14,Philadelphia,1.63,2315,3563,8,24402,49,0,Winter,26717,3612,8,True
2018,01/07,Philadelphia,1.69,1954,3857,0,22155,4,0,Winter,24109,3861,0,True
2018,03/25,PhoenixTucson,1.52,2399,3164,0,9789,18,0,Spring,12188,3182,0,True
2018,03/18,PhoenixTucson,1.54,2130,3421,0,10065,23,0,Spring,12195,3444,0,True
2018,03/11,PhoenixTucson,1.62,2335,3082,0,12278,31,0,Spring,14613,3113,0,True
2018,03/04,PhoenixTucson,1.69,2467,3004,0,9871,5,0,Spring,12338,3009,0,True
2018,02/25,PhoenixTucson,1.6,4845,3196,0,11031,14,0,Winter,15876,3210,0,True
2018,02/18,PhoenixTucson,1.51,2832,3012,0,12509,32,0,Winter,15341,3044,0,True
2018,02/11,PhoenixTucson,1.43,2657,2889,0,13442,36,0,Winter,16099,2925,0,True
2018,02/04,PhoenixTucson,1.62,2260,2011,0,10169,14,0,Winter,12429,2025,0,True
2018,01/28,PhoenixTucson,1.69,1802,2243,0,9073,6,0,Winter,10875,2249,0,True
2018,01/21,PhoenixTucson,1.78,2178,1901,0,8031,1,0,Winter,10209,1902,0,True
2018,01/14,PhoenixTucson,1.77,3618,2795,0,7086,13,0,Winter,10704,2808,0,True
2018,01/07,PhoenixTucson,1.76,3822,2695,0,10364,43,0,Winter,14186,2738,0,True
2018,03/25,Pittsburgh,1.38,956,10,0,15430,13,0,Spring,16386,23,0,True
2018,03/18,Pittsburgh,1.36,991,30,0,12827,6,0,Spring,13818,36,0,True
2018,03/11,Pittsburgh,1.41,986,19,0,13476,3,0,Spring,14462,22,0,True
2018,03/04,Pittsburgh,1.41,1054,10,0,12153,0,0,Spring,13207,10,0,True
2018,02/25,Pittsburgh,1.38,880,33,0,11933,6,0,Winter,12813,39,0,True
2018,02/18,Pittsburgh,1.36,963,32,0,14124,3,0,Winter,15087,35,0,True
2018,02/11,Pittsburgh,1.34,919,20,0,13683,6,0,Winter,14602,26,0,True
2018,02/04,Pittsburgh,1.4,1053,25,0,9999,0,0,Winter,11052,25,0,True
2018,01/28,Pittsburgh,1.38,1259,10,0,11867,0,0,Winter,13126,10,0,True
2018,01/21,Pittsburgh,1.47,1296,18,0,6519,0,0,Winter,7815,18,0,True
2018,01/14,Pittsburgh,1.39,1422,38,0,11880,3,0,Winter,13302,41,0,True
2018,01/07,Pittsburgh,1.38,1016,6,0,12855,0,0,Winter,13871,6,0,True
2018,03/25,Portland,1.66,1746,8110,0,1712,19700,5,Spring,3458,27810,5,True
2018,03/18,Portland,1.78,1433,7055,3,1880,16587,7,Spring,3313,23642,10,True
2018,03/11,Portland,1.72,1338,7520,0,1900,16164,0,Spring,3238,23684,0,True
2018,03/04,Portland,1.57,1772,6857,1,1752,24882,30,Spring,3524,31739,31,True
2018,02/25,Portland,1.59,2777,3529,0,1870,20468,150,Winter,4647,23997,150,True
2018,02/18,Portland,1.8,2304,4614,0,3448,10232,9,Winter,5752,14846,9,True
2018,02/11,Portland,1.56,2598,7330,8,1415,22087,53,Winter,4013,29417,61,True
2018,02/04,Portland,1.46,2697,4591,0,1185,26586,62,Winter,3882,31177,62,True
2018,01/28,Portland,1.8,2550,2656,0,1006,15459,5,Winter,3556,18115,5,True
2018,01/21,Portland,1.8,3170,3086,10,1279,17489,72,Winter,4449,20575,82,True
2018,01/14,Portland,1.82,3966,4441,0,1364,11187,5,Winter,5330,15628,5,True
2018,01/07,Portland,1.59,3740,6593,0,1579,15382,0,Winter,5319,21975,0,True
2018,03/25,RaleighGreensboro,2.02,86,5923,98,6881,389,0,Spring,6967,6312,98,True
2018,03/18,RaleighGreensboro,1.93,74,5983,135,7330,504,0,Spring,7404,6487,135,True
2018,03/11,RaleighGreensboro,2.02,93,6501,224,6823,226,0,Spring,6916,6727,224,True
2018,03/04,RaleighGreensboro,1.98,119,6357,154,8147,229,0,Spring,8266,6586,154,True
2018,02/25,RaleighGreensboro,1.97,161,5650,151,7736,516,0,Winter,7897,6166,151,True
2018,02/18,RaleighGreensboro,1.99,140,5695,122,8197,84,0,Winter,8337,5779,122,True
2018,02/11,RaleighGreensboro,2.04,72,4806,140,6660,125,0,Winter,6732,4931,140,True
2018,02/04,RaleighGreensboro,2.25,82,5175,151,9000,226,0,Winter,9082,5401,151,True
2018,01/28,RaleighGreensboro,1.9,145,6494,156,6924,275,0,Winter,7069,6769,156,True
2018,01/21,RaleighGreensboro,1.86,167,5921,176,8026,336,0,Winter,8193,6257,176,True
2018,01/14,RaleighGreensboro,1.53,119,6900,219,15798,320,0,Winter,15917,7220,219,True
2018,01/07,RaleighGreensboro,1.02,123,6416,209,41246,280,0,Winter,41369,6696,209,True
2018,03/25,RichmondNorfolk,1.42,295,3478,81,12149,1335,0,Spring,12444,4813,81,True
2018,03/18,RichmondNorfolk,1.32,459,3325,86,10904,1164,0,Spring,11363,4489,86,True
2018,03/11,RichmondNorfolk,1.35,363,3680,79,11655,433,0,Spring,12018,4113,79,True
2018,03/04,RichmondNorfolk,1.43,397,3653,119,9479,523,0,Spring,9876,4176,119,True
2018,02/25,RichmondNorfolk,1.42,485,3316,59,11982,2179,0,Winter,12467,5495,59,True
2018,02/18,RichmondNorfolk,1.45,468,3416,60,10254,213,0,Winter,10722,3629,60,True
2018,02/11,RichmondNorfolk,1.36,365,2906,44,13970,763,0,Winter,14335,3669,44,True
2018,02/04,RichmondNorfolk,1.41,352,3254,50,12581,351,0,Winter,12933,3605,50,True
2018,01/28,RichmondNorfolk,1.44,422,3934,93,9656,893,0,Winter,10078,4827,93,True
2018,01/21,RichmondNorfolk,1.58,521,3808,90,6246,1790,0,Winter,6767,5598,90,True
2018,01/14,RichmondNorfolk,1.33,354,3471,78,13243,1104,0,Winter,13597,4575,78,True
2018,01/07,RichmondNorfolk,1.18,563,3382,112,19899,677,0,Winter,20462,4059,112,True
2018,03/25,Roanoke,1.6,82,1984,0,6152,879,0,Spring,6234,2863,0,True
2018,03/18,Roanoke,1.57,110,2580,0,4667,1737,0,Spring,4777,4317,0,True
2018,03/11,Roanoke,1.54,168,2237,0,5479,495,0,Spring,5647,2732,0,True
2018,03/04,Roanoke,1.78,164,2155,0,3393,391,0,Spring,3557,2546,0,True
2018,02/25,Roanoke,1.56,194,2044,0,5548,2381,0,Winter,5742,4425,0,True
2018,02/18,Roanoke,1.49,154,2182,0,5021,158,0,Winter,5175,2340,0,True
2018,02/11,Roanoke,1.44,115,1767,0,5962,1018,0,Winter,6077,2785,0,True
2018,02/04,Roanoke,1.53,205,1857,0,5345,674,0,Winter,5550,2531,0,True
2018,01/28,Roanoke,1.63,221,2293,0,4884,843,0,Winter,5105,3136,0,True
2018,01/21,Roanoke,1.67,219,1633,0,3524,2557,0,Winter,3743,4190,0,True
2018,01/14,Roanoke,1.55,187,2080,0,5644,1686,0,Winter,5831,3766,0,True
2018,01/07,Roanoke,1.48,258,1976,0,6089,568,0,Winter,6347,2544,0,True
2018,03/25,Sacramento,1.63,1902,3572,0,4124,10,0,Spring,6026,3582,0,True
2018,03/18,Sacramento,1.68,1954,3597,0,6270,6,0,Spring,8224,3603,0,True
2018,03/11,Sacramento,1.9,2317,3561,0,2752,3,0,Spring,5069,3564,0,True
2018,03/04,Sacramento,1.83,2391,3880,0,3340,0,0,Spring,5731,3880,0,True
2018,02/25,Sacramento,1.78,2169,4285,0,3036,6,0,Winter,5205,4291,0,True
2018,02/18,Sacramento,1.88,2140,3537,0,2818,3,0,Winter,4958,3540,0,True
2018,02/11,Sacramento,1.87,2208,3192,0,2401,0,0,Winter,4609,3192,0,True
2018,02/04,Sacramento,1.5,2722,4194,0,1796,0,0,Winter,4518,4194,0,True
2018,01/28,Sacramento,1.99,2280,3098,0,2253,0,0,Winter,4533,3098,0,True
2018,01/21,Sacramento,1.62,3017,3954,0,1961,0,0,Winter,4978,3954,0,True
2018,01/14,Sacramento,1.6,3653,4484,0,1802,0,0,Winter,5455,4484,0,True
2018,01/07,Sacramento,2.18,2187,2577,0,1746,0,0,Winter,3933,2577,0,True
2018,03/25,SanDiego,1.75,865,10936,0,7284,0,0,Spring,8149,10936,0,True
2018,03/18,SanDiego,1.75,836,10877,0,6657,0,0,Spring,7493,10877,0,True
2018,03/11,SanDiego,1.59,1328,14303,0,9692,0,0,Spring,11020,14303,0,True
2018,03/04,SanDiego,1.65,1558,10118,0,12934,3,0,Spring,14492,10121,0,True
2018,02/25,SanDiego,1.83,1274,13035,0,5858,3,0,Winter,7132,13038,0,True
2018,02/18,SanDiego,2.05,946,10002,0,6917,10,0,Winter,7863,10012,0,True
2018,02/11,SanDiego,1.88,1101,8243,0,9172,0,0,Winter,10273,8243,0,True
2018,02/04,SanDiego,1.81,1158,7388,0,8908,0,0,Winter,10066,7388,0,True
2018,01/28,SanDiego,1.91,1145,8284,0,8149,0,0,Winter,9294,8284,0,True
2018,01/21,SanDiego,1.95,1088,9282,0,8305,0,0,Winter,9393,9282,0,True
2018,01/14,SanDiego,1.81,3285,14338,0,4145,0,0,Winter,7430,14338,0,True
2018,01/07,SanDiego,2.06,5150,9366,0,2229,0,0,Winter,7379,9366,0,True
2018,03/25,SanFrancisco,1.64,10102,10778,0,13802,3,0,Spring,23904,10781,0,True
2018,03/18,SanFrancisco,1.86,10129,10074,0,18639,3,0,Spring,28768,10077,0,True
2018,03/11,SanFrancisco,2.16,10368,10850,0,4523,0,0,Spring,14891,10850,0,True
2018,03/04,SanFrancisco,2.07,9521,10818,0,4715,0,0,Spring,14236,10818,0,True
2018,02/25,SanFrancisco,2.11,9731,11686,0,3057,0,0,Winter,12788,11686,0,True
2018,02/18,SanFrancisco,2.25,9721,9543,0,2283,3,0,Winter,12004,9546,0,True
2018,02/11,SanFrancisco,2.22,9960,9215,0,2533,0,0,Winter,12493,9215,0,True
2018,02/04,SanFrancisco,1.34,13610,12257,0,2202,0,0,Winter,15812,12257,0,True
2018,01/28,SanFrancisco,2.27,9368,8808,0,2148,0,0,Winter,11516,8808,0,True
2018,01/21,SanFrancisco,1.36,13037,11998,0,2883,0,0,Winter,15920,11998,0,True
2018,01/14,SanFrancisco,1.32,19301,14957,0,3089,0,0,Winter,22390,14957,0,True
2018,01/07,SanFrancisco,2.3,10165,8042,0,1943,0,0,Winter,12108,8042,0,True
2018,03/25,Seattle,1.48,1753,41364,40,8496,44278,114,Spring,10249,85642,154,True
2018,03/18,Seattle,1.83,1490,15816,32,2763,25662,128,Spring,4253,41478,160,True
2018,03/11,Seattle,1.54,1542,26198,139,2974,38160,0,Spring,4516,64358,139,True
2018,03/04,Seattle,1.27,1999,37762,24,2489,114116,133,Spring,4488,151878,157,True
2018,02/25,Seattle,1.36,1285,23264,41,2511,78344,98,Winter,3796,101608,139,True
2018,02/18,Seattle,1.86,1033,12852,33,11523,14950,31,Winter,12556,27802,64,True
2018,02/11,Seattle,1.22,1318,31821,175,4818,62844,132,Winter,6136,94665,307,True
2018,02/04,Seattle,1.14,1345,32088,85,1998,88880,260,Winter,3343,120968,345,True
2018,01/28,Seattle,1.99,954,11558,32,1487,21867,87,Winter,2441,33425,119,True
2018,01/21,Seattle,2.02,928,12632,23,1469,18905,27,Winter,2397,31537,50,True
2018,01/14,Seattle,2.03,1147,18370,9,1630,15063,7,Winter,2777,33433,16,True
2018,01/07,Seattle,1.26,1404,33170,11,2054,62104,18,Winter,3458,95274,29,True
2018,03/25,SouthCarolina,1.38,163,4234,81,9882,1663,0,Spring,10045,5897,81,True
2018,03/18,SouthCarolina,1.35,135,4345,111,10661,1043,0,Spring,10796,5388,111,True
2018,03/11,SouthCarolina,1.36,181,4942,99,11957,380,0,Spring,12138,5322,99,True
2018,03/04,SouthCarolina,1.44,206,5412,71,9893,883,0,Spring,10099,6295,71,True
2018,02/25,SouthCarolina,1.41,212,4438,95,12088,357,0,Winter,12300,4795,95,True
2018,02/18,SouthCarolina,1.43,145,4665,78,9900,653,0,Winter,10045,5318,78,True
2018,02/11,SouthCarolina,1.47,70,4206,84,8754,1173,0,Winter,8824,5379,84,True
2018,02/04,SouthCarolina,1.42,132,4063,102,11819,546,0,Winter,11951,4609,102,True
2018,01/28,SouthCarolina,1.46,110,5096,94,8443,1193,0,Winter,8553,6289,94,True
2018,01/21,SouthCarolina,1.4,105,4280,73,11152,1954,0,Winter,11257,6234,73,True
2018,01/14,SouthCarolina,1.31,67,4372,114,13152,971,0,Winter,13219,5343,114,True
2018,01/07,SouthCarolina,1.26,257,4243,151,14269,780,0,Winter,14526,5023,151,True
2018,03/25,Spokane,1.59,266,1707,2,638,3105,29,Spring,904,4812,31,True
2018,03/18,Spokane,1.6,242,1753,0,837,2947,12,Spring,1079,4700,12,True
2018,03/11,Spokane,1.72,307,1845,0,1042,1594,0,Spring,1349,3439,0,True
2018,03/04,Spokane,1.6,461,2076,0,755,2010,0,Spring,1216,4086,0,True
2018,02/25,Spokane,1.64,269,1496,0,747,2207,0,Winter,1016,3703,0,True
2018,02/18,Spokane,1.64,271,1421,0,1301,1751,0,Winter,1572,3172,0,True
2018,02/11,Spokane,1.66,243,1330,0,583,1941,0,Winter,826,3271,0,True
2018,02/04,Spokane,1.7,277,1722,0,593,1948,19,Winter,870,3670,19,True
2018,01/28,Spokane,1.7,195,1169,0,535,2400,0,Winter,730,3569,0,True
2018,01/21,Spokane,1.76,227,1340,0,745,2216,2,Winter,972,3556,2,True
2018,01/14,Spokane,1.85,150,1948,0,564,1749,0,Winter,714,3697,0,True
2018,01/07,Spokane,1.74,212,1413,0,600,1562,0,Winter,812,2975,0,True
2018,03/25,StLouis,1.82,1426,2452,0,3427,903,0,Spring,4853,3355,0,True
2018,03/18,StLouis,1.8,1052,2821,7,3207,16,0,Spring,4259,2837,7,True
2018,03/11,StLouis,1.71,1127,2916,0,4022,26,0,Spring,5149,2942,0,True
2018,03/04,StLouis,1.76,982,2294,0,3054,526,0,Spring,4036,2820,0,True
2018,02/25,StLouis,1.69,1546,774,0,3548,2100,0,Winter,5094,2874,0,True
2018,02/18,StLouis,1.76,1253,756,3,2970,2024,0,Winter,4223,2780,3,True
2018,02/11,StLouis,1.75,1448,752,1,3018,2510,0,Winter,4466,3262,1,True
2018,02/04,StLouis,1.69,1328,666,0,2696,1802,0,Winter,4024,2468,0,True
2018,01/28,StLouis,1.76,1399,649,0,2360,1888,0,Winter,3759,2537,0,True
2018,01/21,StLouis,1.77,1559,823,0,2868,1635,0,Winter,4427,2458,0,True
2018,01/14,StLouis,1.97,2054,1185,0,2004,2893,0,Winter,4058,4078,0,True
2018,01/07,StLouis,1.49,842,815,0,7538,1951,0,Winter,8380,2766,0,True
2018,03/25,Syracuse,1.04,78,148,0,9992,4283,0,Spring,10070,4431,0,True
2018,03/18,Syracuse,1.19,162,87,0,2782,3948,0,Spring,2944,4035,0,True
2018,03/11,Syracuse,1.25,168,61,0,775,3679,0,Spring,943,3740,0,True
2018,03/04,Syracuse,1.42,395,89,0,721,1855,0,Spring,1116,1944,0,True
2018,02/25,Syracuse,1.3,154,133,0,1645,2229,0,Winter,1799,2362,0,True
2018,02/18,Syracuse,1.3,310,84,0,2136,2561,0,Winter,2446,2645,0,True
2018,02/11,Syracuse,1.23,69,56,0,1972,2716,0,Winter,2041,2772,0,True
2018,02/04,Syracuse,1.22,85,152,0,2847,3209,0,Winter,2932,3361,0,True
2018,01/28,Syracuse,1.19,30,128,0,5670,564,0,Winter,5700,692,0,True
2018,01/21,Syracuse,1.27,92,73,0,2117,876,0,Winter,2209,949,0,True
2018,01/14,Syracuse,1.25,116,64,0,1986,2176,0,Winter,2102,2240,0,True
2018,01/07,Syracuse,1.25,59,133,0,3125,1445,0,Winter,3184,1578,0,True
2018,03/25,Tampa,1.41,138,773,0,8208,908,0,Spring,8346,1681,0,True
2018,03/18,Tampa,1.5,190,901,0,7687,1532,0,Spring,7877,2433,0,True
2018,03/11,Tampa,1.31,101,392,0,7494,127,0,Spring,7595,519,0,True
2018,03/04,Tampa,1.51,223,839,0,7327,1460,0,Spring,7550,2299,0,True
2018,02/25,Tampa,1.37,206,542,0,7895,499,0,Winter,8101,1041,0,True
2018,02/18,Tampa,1.5,131,781,0,6452,1169,0,Winter,6583,1950,0,True
2018,02/11,Tampa,1.34,40,486,0,7499,440,0,Winter,7539,926,0,True
2018,02/04,Tampa,1.32,89,440,0,6827,5,0,Winter,6916,445,0,True
2018,01/28,Tampa,1.61,156,859,0,5567,1113,0,Winter,5723,1972,0,True
2018,01/21,Tampa,1.52,76,407,0,6375,11,0,Winter,6451,418,0,True
2018,01/14,Tampa,1.53,106,496,0,6634,0,0,Winter,6740,496,0,True
2018,01/07,Tampa,1.51,42,400,0,6921,6,0,Winter,6963,406,0,True
2018,03/25,WestTexNewMexico,1.62,2325,2171,0,10569,236,0,Spring,12894,2407,0,True
2018,03/18,WestTexNewMexico,1.56,2055,1499,0,12114,226,0,Spring,14169,1725,0,True
2018,03/11,WestTexNewMexico,1.56,2162,3194,8,16510,252,0,Spring,18672,3446,8,True
2018,03/04,WestTexNewMexico,1.54,1832,1905,0,13401,253,0,Spring,15233,2158,0,True
2018,02/25,WestTexNewMexico,1.57,1974,2482,0,13698,266,0,Winter,15672,2748,0,True
2018,02/18,WestTexNewMexico,1.56,1892,1928,0,13553,223,0,Winter,15445,2151,0,True
2018,02/11,WestTexNewMexico,1.57,1924,1368,0,12437,256,0,Winter,14361,1624,0,True
2018,02/04,WestTexNewMexico,1.63,2046,1529,0,13066,431,0,Winter,15112,1960,0,True
2018,01/28,WestTexNewMexico,1.71,1191,3431,0,8940,324,0,Winter,10131,3755,0,True
2018,01/21,WestTexNewMexico,1.87,1191,2452,727,9351,42,0,Winter,10542,2494,727,True
2018,01/14,WestTexNewMexico,1.93,1527,2981,727,10919,50,0,Winter,12446,3031,727,True
2018,01/07,WestTexNewMexico,1.62,2894,2356,224,11988,26,0,Winter,14882,2382,224,True
